"Borough","Hour","Date","Cars_And_Taxis","Motorbikes","Buses_and_Coaches","LGVs","HGVs","All_Vehicles"
"Croydon","07:00:00","2018-03-16",16,0,0,7,0,23
"Ealing","07:00:00","2018-03-16",612,18,39,153,19,841
"Greenwich","07:00:00","2018-03-16",23,2,0,0,2,27
"Hillingdon","07:00:00","2018-03-16",25,1,0,4,0,30
"Hounslow","07:00:00","2018-03-16",2034,66,20,577,115,2812
"Lambeth","07:00:00","2018-03-16",673,139,54,424,46,1336
"Newham","07:00:00","2018-03-16",21,0,0,3,1,25
"Southwark","07:00:00","2018-03-16",335,117,20,325,45,842
"Croydon","08:00:00","2018-03-16",32,0,0,4,1,37
"Ealing","08:00:00","2018-03-16",705,14,37,116,14,886
"Greenwich","08:00:00","2018-03-16",47,0,0,1,0,48
"Hillingdon","08:00:00","2018-03-16",45,1,0,10,0,56
"Hounslow","08:00:00","2018-03-16",2101,54,25,396,116,2692
"Lambeth","08:00:00","2018-03-16",682,216,76,364,56,1394
"Newham","08:00:00","2018-03-16",81,3,0,11,1,96
"Southwark","08:00:00","2018-03-16",334,117,20,263,39,773
"Bexley","09:00:00","2018-03-16",4640,55,44,1030,504,6273
"Croydon","09:00:00","2018-03-16",20,0,0,9,0,29
"Ealing","09:00:00","2018-03-16",557,13,42,132,12,756
"Greenwich","09:00:00","2018-03-16",22,0,0,3,0,25
"Hillingdon","09:00:00","2018-03-16",21,0,0,6,0,27
"Hounslow","09:00:00","2018-03-16",2215,52,36,446,149,2898
"Lambeth","09:00:00","2018-03-16",643,107,71,413,43,1277
"Newham","09:00:00","2018-03-16",22,0,0,6,0,28
"Southwark","09:00:00","2018-03-16",413,92,24,288,48,865
"Bexley","10:00:00","2018-03-16",4009,39,23,1004,458,5533
"Croydon","10:00:00","2018-03-16",17,0,0,2,0,19
"Ealing","10:00:00","2018-03-16",550,10,39,149,24,772
"Greenwich","10:00:00","2018-03-16",12,0,0,5,0,17
"Hillingdon","10:00:00","2018-03-16",22,0,0,5,0,27
"Hounslow","10:00:00","2018-03-16",1932,74,31,503,144,2684
"Lambeth","10:00:00","2018-03-16",676,52,55,338,47,1168
"Newham","10:00:00","2018-03-16",21,1,0,6,0,28
"Southwark","10:00:00","2018-03-16",366,69,24,199,62,720
"Bexley","11:00:00","2018-03-16",4160,28,10,1076,478,5752
"Croydon","11:00:00","2018-03-16",17,0,0,1,0,18
"Ealing","11:00:00","2018-03-16",527,8,39,123,15,712
"Greenwich","11:00:00","2018-03-16",5,0,0,2,0,7
"Hillingdon","11:00:00","2018-03-16",22,0,0,6,0,28
"Hounslow","11:00:00","2018-03-16",2059,47,22,467,130,2725
"Lambeth","11:00:00","2018-03-16",660,67,59,405,58,1249
"Newham","11:00:00","2018-03-16",37,0,0,5,1,43
"Southwark","11:00:00","2018-03-16",320,43,19,198,44,624
"Bexley","12:00:00","2018-03-16",4472,43,21,1106,515,6157
"Croydon","12:00:00","2018-03-16",22,1,0,2,1,26
"Ealing","12:00:00","2018-03-16",604,11,40,151,14,820
"Greenwich","12:00:00","2018-03-16",7,1,0,6,0,14
"Hillingdon","12:00:00","2018-03-16",35,1,0,4,0,40
"Hounslow","12:00:00","2018-03-16",2028,49,25,455,134,2691
"Lambeth","12:00:00","2018-03-16",631,66,59,360,48,1164
"Newham","12:00:00","2018-03-16",16,5,0,4,0,25
"Southwark","12:00:00","2018-03-16",307,31,19,193,39,589
"Bexley","13:00:00","2018-03-16",4703,45,20,1186,458,6412
"Croydon","13:00:00","2018-03-16",16,0,0,5,0,21
"Ealing","13:00:00","2018-03-16",566,13,34,119,10,742
"Greenwich","13:00:00","2018-03-16",34,3,0,9,0,46
"Hillingdon","13:00:00","2018-03-16",34,0,0,1,0,35
"Hounslow","13:00:00","2018-03-16",2194,48,25,480,134,2881
"Lambeth","13:00:00","2018-03-16",649,72,49,340,49,1159
"Newham","13:00:00","2018-03-16",28,3,0,5,0,36
"Southwark","13:00:00","2018-03-16",291,59,21,215,23,609
"Croydon","14:00:00","2018-03-16",18,0,0,2,1,21
"Ealing","14:00:00","2018-03-16",616,17,38,141,6,818
"Greenwich","14:00:00","2018-03-16",23,0,0,5,0,28
"Hillingdon","14:00:00","2018-03-16",29,0,0,5,1,35
"Hounslow","14:00:00","2018-03-16",2383,38,29,496,121,3067
"Lambeth","14:00:00","2018-03-16",776,93,63,417,45,1394
"Newham","14:00:00","2018-03-16",22,0,0,5,0,27
"Southwark","14:00:00","2018-03-16",358,71,17,193,29,668
"Croydon","15:00:00","2018-03-16",44,1,0,5,0,50
"Ealing","15:00:00","2018-03-16",694,9,42,111,7,863
"Greenwich","15:00:00","2018-03-16",10,0,0,4,0,14
"Hillingdon","15:00:00","2018-03-16",47,0,0,3,0,50
"Hounslow","15:00:00","2018-03-16",2440,60,29,445,88,3062
"Lambeth","15:00:00","2018-03-16",786,104,56,353,31,1330
"Newham","15:00:00","2018-03-16",54,4,0,8,0,66
"Southwark","15:00:00","2018-03-16",384,77,21,206,28,716
"Croydon","16:00:00","2018-03-16",34,0,0,6,0,40
"Ealing","16:00:00","2018-03-16",764,25,40,95,6,930
"Greenwich","16:00:00","2018-03-16",14,0,0,6,0,20
"Hillingdon","16:00:00","2018-03-16",47,0,0,6,0,53
"Hounslow","16:00:00","2018-03-16",2550,69,30,387,70,3106
"Lambeth","16:00:00","2018-03-16",860,141,68,318,11,1398
"Newham","16:00:00","2018-03-16",22,2,0,2,0,26
"Southwark","16:00:00","2018-03-16",427,94,24,228,18,791
"Croydon","17:00:00","2018-03-16",35,2,0,10,0,47
"Ealing","17:00:00","2018-03-16",705,31,35,74,3,848
"Greenwich","17:00:00","2018-03-16",24,0,0,1,0,25
"Hillingdon","17:00:00","2018-03-16",46,2,0,4,0,52
"Hounslow","17:00:00","2018-03-16",2613,80,25,291,51,3060
"Lambeth","17:00:00","2018-03-16",852,241,62,250,8,1413
"Newham","17:00:00","2018-03-16",39,2,0,14,0,55
"Southwark","17:00:00","2018-03-16",389,107,20,122,13,651
"Croydon","18:00:00","2018-03-16",44,0,0,8,0,52
"Ealing","18:00:00","2018-03-16",700,22,38,60,1,821
"Greenwich","18:00:00","2018-03-16",12,0,0,0,0,12
"Hillingdon","18:00:00","2018-03-16",33,1,0,2,0,36
"Hounslow","18:00:00","2018-03-16",3165,70,24,229,30,3518
"Lambeth","18:00:00","2018-03-16",948,214,53,178,4,1397
"Newham","18:00:00","2018-03-16",32,0,0,2,0,34
"Southwark","18:00:00","2018-03-16",782,118,29,96,14,1039
"Bexley","07:00:00","2018-03-19",308,0,26,58,4,396
"Enfield","07:00:00","2018-03-19",709,1,2,119,9,840
"Haringey","07:00:00","2018-03-19",38,0,0,9,6,53
"Harrow","07:00:00","2018-03-19",51,0,0,1,0,52
"Bexley","08:00:00","2018-03-19",392,3,20,55,0,470
"Enfield","08:00:00","2018-03-19",1121,3,2,96,9,1231
"Haringey","08:00:00","2018-03-19",77,0,0,17,10,104
"Harrow","08:00:00","2018-03-19",165,0,0,9,0,174
"Bexley","09:00:00","2018-03-19",285,0,29,50,4,368
"Enfield","09:00:00","2018-03-19",607,1,1,110,20,739
"Haringey","09:00:00","2018-03-19",41,0,0,15,10,66
"Harrow","09:00:00","2018-03-19",68,0,0,7,1,76
"Bexley","10:00:00","2018-03-19",272,0,22,48,6,348
"Enfield","10:00:00","2018-03-19",468,1,0,79,20,568
"Haringey","10:00:00","2018-03-19",36,0,0,13,7,56
"Harrow","10:00:00","2018-03-19",52,1,0,3,0,56
"Bexley","11:00:00","2018-03-19",297,3,23,54,3,380
"Enfield","11:00:00","2018-03-19",482,2,1,78,16,579
"Haringey","11:00:00","2018-03-19",36,0,0,14,11,61
"Harrow","11:00:00","2018-03-19",70,0,0,6,0,76
"Bexley","12:00:00","2018-03-19",330,2,20,66,8,426
"Enfield","12:00:00","2018-03-19",499,2,3,77,14,595
"Haringey","12:00:00","2018-03-19",32,0,0,16,11,59
"Harrow","12:00:00","2018-03-19",55,1,0,7,0,63
"Bexley","13:00:00","2018-03-19",348,5,20,43,7,423
"Enfield","13:00:00","2018-03-19",442,2,1,88,10,543
"Haringey","13:00:00","2018-03-19",46,0,1,15,8,70
"Harrow","13:00:00","2018-03-19",53,0,0,15,0,68
"Bexley","14:00:00","2018-03-19",356,5,23,71,4,459
"Enfield","14:00:00","2018-03-19",612,2,4,77,6,701
"Haringey","14:00:00","2018-03-19",46,0,1,11,5,63
"Harrow","14:00:00","2018-03-19",73,1,0,10,0,84
"Bexley","15:00:00","2018-03-19",392,3,22,56,5,478
"Enfield","15:00:00","2018-03-19",797,4,3,77,14,895
"Haringey","15:00:00","2018-03-19",45,0,1,12,2,60
"Harrow","15:00:00","2018-03-19",128,0,0,13,1,142
"Bexley","16:00:00","2018-03-19",385,9,24,63,2,483
"Enfield","16:00:00","2018-03-19",782,10,0,93,2,887
"Haringey","16:00:00","2018-03-19",61,1,0,16,5,83
"Harrow","16:00:00","2018-03-19",133,1,0,11,0,145
"Bexley","17:00:00","2018-03-19",451,4,22,58,0,535
"Enfield","17:00:00","2018-03-19",923,2,0,97,5,1027
"Haringey","17:00:00","2018-03-19",62,0,0,13,0,75
"Harrow","17:00:00","2018-03-19",109,2,0,8,0,119
"Bexley","18:00:00","2018-03-19",405,9,19,49,1,483
"Enfield","18:00:00","2018-03-19",866,5,1,54,1,927
"Haringey","18:00:00","2018-03-19",63,2,0,14,1,80
"Harrow","18:00:00","2018-03-19",84,1,0,11,0,96
"Hillingdon","07:00:00","2018-03-20",37,0,1,10,1,49
"Hillingdon","08:00:00","2018-03-20",115,0,1,6,0,122
"Hillingdon","09:00:00","2018-03-20",25,0,0,9,1,35
"Hillingdon","10:00:00","2018-03-20",19,0,0,1,1,21
"Hillingdon","11:00:00","2018-03-20",30,0,0,9,2,41
"Hillingdon","12:00:00","2018-03-20",33,0,0,0,3,36
"Hillingdon","13:00:00","2018-03-20",22,0,0,4,2,28
"Hillingdon","14:00:00","2018-03-20",22,0,0,5,0,27
"Hillingdon","15:00:00","2018-03-20",81,0,1,7,0,89
"Hillingdon","16:00:00","2018-03-20",45,0,0,4,3,52
"Hillingdon","17:00:00","2018-03-20",55,0,0,4,1,60
"Hillingdon","18:00:00","2018-03-20",42,0,1,5,1,49
"Hackney","07:00:00","2018-03-21",25,0,0,6,0,31
"Hammersmith and Fulham","07:00:00","2018-03-21",37,2,0,3,0,42
"Lewisham","07:00:00","2018-03-21",694,20,14,224,22,974
"Sutton","07:00:00","2018-03-21",624,22,51,150,8,855
"Hackney","08:00:00","2018-03-21",35,1,1,10,1,48
"Hammersmith and Fulham","08:00:00","2018-03-21",81,2,0,13,1,97
"Lewisham","08:00:00","2018-03-21",791,14,10,171,28,1014
"Sutton","08:00:00","2018-03-21",709,8,48,81,3,849
"Hackney","09:00:00","2018-03-21",25,2,0,11,1,39
"Hammersmith and Fulham","09:00:00","2018-03-21",47,3,0,7,1,58
"Lewisham","09:00:00","2018-03-21",698,7,17,168,25,915
"Sutton","09:00:00","2018-03-21",491,12,49,83,6,641
"Hackney","10:00:00","2018-03-21",27,0,0,9,2,38
"Hammersmith and Fulham","10:00:00","2018-03-21",34,0,0,11,0,45
"Lewisham","10:00:00","2018-03-21",636,12,10,170,29,857
"Sutton","10:00:00","2018-03-21",516,3,50,73,9,651
"Hackney","11:00:00","2018-03-21",32,1,0,12,1,46
"Hammersmith and Fulham","11:00:00","2018-03-21",28,1,0,13,1,43
"Lewisham","11:00:00","2018-03-21",662,11,15,218,26,932
"Sutton","11:00:00","2018-03-21",560,5,47,68,10,690
"Hackney","12:00:00","2018-03-21",27,1,0,12,1,41
"Hammersmith and Fulham","12:00:00","2018-03-21",24,0,0,6,0,30
"Lewisham","12:00:00","2018-03-21",747,11,12,203,23,996
"Sutton","12:00:00","2018-03-21",491,5,45,75,11,627
"Hackney","13:00:00","2018-03-21",30,2,0,14,2,48
"Hammersmith and Fulham","13:00:00","2018-03-21",32,0,0,8,1,41
"Lewisham","13:00:00","2018-03-21",637,8,10,208,17,880
"Sutton","13:00:00","2018-03-21",516,9,44,86,7,662
"Hackney","14:00:00","2018-03-21",26,3,0,10,0,39
"Hammersmith and Fulham","14:00:00","2018-03-21",32,1,0,15,1,49
"Lewisham","14:00:00","2018-03-21",733,7,15,197,30,982
"Sutton","14:00:00","2018-03-21",494,6,41,91,1,633
"Hackney","15:00:00","2018-03-21",34,2,0,13,0,49
"Hammersmith and Fulham","15:00:00","2018-03-21",57,1,0,9,0,67
"Lewisham","15:00:00","2018-03-21",828,25,16,189,15,1073
"Sutton","15:00:00","2018-03-21",595,3,51,103,3,755
"Hackney","16:00:00","2018-03-21",45,1,2,11,1,60
"Hammersmith and Fulham","16:00:00","2018-03-21",52,1,0,12,1,66
"Lewisham","16:00:00","2018-03-21",804,35,15,194,11,1059
"Sutton","16:00:00","2018-03-21",694,11,42,118,5,870
"Hackney","17:00:00","2018-03-21",28,1,0,13,3,45
"Hammersmith and Fulham","17:00:00","2018-03-21",45,1,0,5,0,51
"Lewisham","17:00:00","2018-03-21",957,25,16,168,3,1169
"Sutton","17:00:00","2018-03-21",704,24,35,72,2,837
"Hackney","18:00:00","2018-03-21",33,1,1,10,0,45
"Hammersmith and Fulham","18:00:00","2018-03-21",61,6,0,4,0,71
"Lewisham","18:00:00","2018-03-21",975,31,14,147,10,1177
"Sutton","18:00:00","2018-03-21",721,37,51,73,0,882
"Sutton","07:00:00","2018-03-22",241,1,6,39,3,290
"Sutton","08:00:00","2018-03-22",353,3,7,40,6,409
"Sutton","09:00:00","2018-03-22",260,1,9,40,3,313
"Sutton","10:00:00","2018-03-22",320,2,10,38,6,376
"Sutton","11:00:00","2018-03-22",257,3,7,29,5,301
"Sutton","12:00:00","2018-03-22",284,4,10,31,4,333
"Sutton","13:00:00","2018-03-22",346,3,9,34,6,398
"Sutton","14:00:00","2018-03-22",257,3,6,35,2,303
"Sutton","15:00:00","2018-03-22",250,5,9,39,0,303
"Sutton","16:00:00","2018-03-22",380,5,9,41,0,435
"Sutton","17:00:00","2018-03-22",347,9,8,43,2,409
"Sutton","18:00:00","2018-03-22",401,7,10,35,1,454
"Croydon","07:00:00","2018-03-23",182,0,0,33,2,217
"Ealing","07:00:00","2018-03-23",42,0,0,9,0,51
"Hillingdon","07:00:00","2018-03-23",65,1,0,11,1,78
"Lambeth","07:00:00","2018-03-23",38,1,0,9,1,49
"Croydon","08:00:00","2018-03-23",203,1,0,18,2,224
"Ealing","08:00:00","2018-03-23",83,1,0,13,0,97
"Hillingdon","08:00:00","2018-03-23",122,0,0,16,1,139
"Lambeth","08:00:00","2018-03-23",79,2,0,8,0,89
"Croydon","09:00:00","2018-03-23",97,0,0,18,3,118
"Ealing","09:00:00","2018-03-23",59,1,0,2,1,63
"Hillingdon","09:00:00","2018-03-23",57,1,0,17,1,76
"Lambeth","09:00:00","2018-03-23",50,1,0,5,1,57
"Croydon","10:00:00","2018-03-23",70,4,0,11,0,85
"Ealing","10:00:00","2018-03-23",46,0,0,6,0,52
"Hillingdon","10:00:00","2018-03-23",49,0,0,6,0,55
"Lambeth","10:00:00","2018-03-23",30,0,0,6,0,36
"Croydon","11:00:00","2018-03-23",77,0,0,22,2,101
"Ealing","11:00:00","2018-03-23",43,0,0,5,0,48
"Hillingdon","11:00:00","2018-03-23",63,2,0,14,0,79
"Lambeth","11:00:00","2018-03-23",33,1,0,14,1,49
"Croydon","12:00:00","2018-03-23",71,0,0,21,5,97
"Ealing","12:00:00","2018-03-23",53,2,0,8,0,63
"Hillingdon","12:00:00","2018-03-23",69,0,0,8,0,77
"Lambeth","12:00:00","2018-03-23",38,1,0,7,0,46
"Croydon","13:00:00","2018-03-23",82,0,0,18,2,102
"Ealing","13:00:00","2018-03-23",48,1,0,6,0,55
"Hillingdon","13:00:00","2018-03-23",68,1,0,12,0,81
"Lambeth","13:00:00","2018-03-23",36,1,0,2,0,39
"Croydon","14:00:00","2018-03-23",96,0,0,12,0,108
"Ealing","14:00:00","2018-03-23",51,4,0,10,0,65
"Hillingdon","14:00:00","2018-03-23",95,0,0,9,1,105
"Lambeth","14:00:00","2018-03-23",29,1,0,5,0,35
"Croydon","15:00:00","2018-03-23",107,0,0,13,0,120
"Ealing","15:00:00","2018-03-23",105,0,0,15,0,120
"Hillingdon","15:00:00","2018-03-23",131,0,0,3,0,134
"Lambeth","15:00:00","2018-03-23",42,0,0,8,2,52
"Croydon","16:00:00","2018-03-23",135,1,0,21,1,158
"Ealing","16:00:00","2018-03-23",145,2,0,32,0,179
"Hillingdon","16:00:00","2018-03-23",110,0,0,4,0,114
"Lambeth","16:00:00","2018-03-23",39,2,0,5,0,46
"Croydon","17:00:00","2018-03-23",122,1,0,19,0,142
"Ealing","17:00:00","2018-03-23",191,6,0,31,0,228
"Hillingdon","17:00:00","2018-03-23",92,3,0,13,0,108
"Lambeth","17:00:00","2018-03-23",35,6,0,4,0,45
"Croydon","18:00:00","2018-03-23",123,2,0,8,0,133
"Ealing","18:00:00","2018-03-23",176,2,0,14,0,192
"Hillingdon","18:00:00","2018-03-23",117,0,0,8,0,125
"Lambeth","18:00:00","2018-03-23",37,7,0,2,0,46
"Bromley","07:00:00","2018-04-16",75,3,7,9,0,94
"Croydon","07:00:00","2018-04-16",506,6,11,91,2,616
"Enfield","07:00:00","2018-04-16",5768,121,46,1994,543,8472
"Hackney","07:00:00","2018-04-16",486,14,102,130,23,755
"Hammersmith and Fulham","07:00:00","2018-04-16",790,60,48,193,37,1128
"Hillingdon","07:00:00","2018-04-16",1398,19,54,252,31,1754
"Lewisham","07:00:00","2018-04-16",49,0,0,6,0,55
"Merton","07:00:00","2018-04-16",270,6,0,52,1,329
"Tower Hamlets","07:00:00","2018-04-16",473,25,78,216,16,808
"Wandsworth","07:00:00","2018-04-16",3043,244,9,800,103,4199
"Westminster","07:00:00","2018-04-16",42,5,0,16,1,64
"Bromley","08:00:00","2018-04-16",123,1,7,9,0,140
"Croydon","08:00:00","2018-04-16",593,5,12,67,0,677
"Enfield","08:00:00","2018-04-16",5362,94,39,1565,557,7617
"Hackney","08:00:00","2018-04-16",580,27,93,197,43,940
"Hammersmith and Fulham","08:00:00","2018-04-16",939,80,44,212,42,1317
"Hillingdon","08:00:00","2018-04-16",1415,31,53,238,22,1759
"Lewisham","08:00:00","2018-04-16",70,0,0,7,0,77
"Merton","08:00:00","2018-04-16",285,5,0,48,2,340
"Tower Hamlets","08:00:00","2018-04-16",637,30,58,251,42,1018
"Wandsworth","08:00:00","2018-04-16",2885,304,9,616,134,3948
"Westminster","08:00:00","2018-04-16",91,2,1,21,3,118
"Bromley","09:00:00","2018-04-16",63,1,5,10,0,79
"Croydon","09:00:00","2018-04-16",519,10,11,69,7,616
"Enfield","09:00:00","2018-04-16",4490,73,45,1420,640,6668
"Hackney","09:00:00","2018-04-16",503,24,82,151,54,814
"Hammersmith and Fulham","09:00:00","2018-04-16",865,58,42,225,43,1233
"Hillingdon","09:00:00","2018-04-16",1079,25,49,217,40,1410
"Lewisham","09:00:00","2018-04-16",50,0,0,11,0,61
"Merton","09:00:00","2018-04-16",199,4,0,50,0,253
"Tower Hamlets","09:00:00","2018-04-16",587,36,61,226,49,959
"Wandsworth","09:00:00","2018-04-16",2515,140,13,625,144,3437
"Westminster","09:00:00","2018-04-16",77,3,0,24,0,104
"Bromley","10:00:00","2018-04-16",50,0,7,13,0,70
"Croydon","10:00:00","2018-04-16",319,8,9,53,3,392
"Enfield","10:00:00","2018-04-16",3955,41,34,1384,655,6069
"Hackney","10:00:00","2018-04-16",499,23,93,190,51,856
"Hammersmith and Fulham","10:00:00","2018-04-16",767,58,34,229,38,1126
"Hillingdon","10:00:00","2018-04-16",1210,21,50,235,50,1566
"Lewisham","10:00:00","2018-04-16",43,1,0,17,0,61
"Merton","10:00:00","2018-04-16",182,2,0,51,3,238
"Tower Hamlets","10:00:00","2018-04-16",550,31,61,263,39,944
"Wandsworth","10:00:00","2018-04-16",2205,78,9,590,159,3041
"Westminster","10:00:00","2018-04-16",82,5,0,24,1,112
"Bromley","11:00:00","2018-04-16",66,1,5,11,0,83
"Croydon","11:00:00","2018-04-16",344,6,10,64,2,426
"Enfield","11:00:00","2018-04-16",3939,63,38,1441,669,6150
"Hackney","11:00:00","2018-04-16",490,23,89,207,58,867
"Hammersmith and Fulham","11:00:00","2018-04-16",814,40,37,212,31,1134
"Hillingdon","11:00:00","2018-04-16",1406,21,49,263,61,1800
"Lewisham","11:00:00","2018-04-16",47,0,0,15,3,65
"Merton","11:00:00","2018-04-16",167,2,0,41,1,211
"Tower Hamlets","11:00:00","2018-04-16",523,29,62,227,52,893
"Wandsworth","11:00:00","2018-04-16",2199,63,7,654,165,3088
"Westminster","11:00:00","2018-04-16",76,13,0,23,0,112
"Bromley","12:00:00","2018-04-16",54,2,7,9,0,72
"Croydon","12:00:00","2018-04-16",388,6,11,51,5,461
"Enfield","12:00:00","2018-04-16",4132,60,39,1468,662,6361
"Hackney","12:00:00","2018-04-16",504,27,71,182,56,840
"Hammersmith and Fulham","12:00:00","2018-04-16",724,57,31,202,34,1048
"Hillingdon","12:00:00","2018-04-16",1374,23,44,240,49,1730
"Lewisham","12:00:00","2018-04-16",31,1,0,15,1,48
"Merton","12:00:00","2018-04-16",152,3,0,41,0,196
"Tower Hamlets","12:00:00","2018-04-16",518,35,67,227,40,887
"Wandsworth","12:00:00","2018-04-16",2317,68,5,630,174,3194
"Westminster","12:00:00","2018-04-16",76,17,0,26,0,119
"Bromley","13:00:00","2018-04-16",62,0,7,17,0,86
"Croydon","13:00:00","2018-04-16",378,5,10,69,5,467
"Enfield","13:00:00","2018-04-16",4274,64,38,1401,636,6413
"Hackney","13:00:00","2018-04-16",508,31,86,200,49,874
"Hammersmith and Fulham","13:00:00","2018-04-16",777,56,30,206,30,1099
"Hillingdon","13:00:00","2018-04-16",1703,22,55,229,37,2046
"Lewisham","13:00:00","2018-04-16",40,2,0,6,1,49
"Merton","13:00:00","2018-04-16",158,4,0,34,2,198
"Tower Hamlets","13:00:00","2018-04-16",591,45,62,190,32,920
"Wandsworth","13:00:00","2018-04-16",2337,96,6,592,136,3167
"Westminster","13:00:00","2018-04-16",68,17,1,26,2,114
"Bromley","14:00:00","2018-04-16",52,1,6,12,0,71
"Croydon","14:00:00","2018-04-16",451,8,12,77,3,551
"Enfield","14:00:00","2018-04-16",4581,45,40,1482,596,6744
"Hackney","14:00:00","2018-04-16",506,30,88,194,42,860
"Hammersmith and Fulham","14:00:00","2018-04-16",882,62,39,205,22,1210
"Hillingdon","14:00:00","2018-04-16",1724,33,47,238,29,2071
"Lewisham","14:00:00","2018-04-16",35,1,0,10,1,47
"Merton","14:00:00","2018-04-16",167,3,0,30,1,201
"Tower Hamlets","14:00:00","2018-04-16",653,40,67,215,36,1011
"Wandsworth","14:00:00","2018-04-16",2558,87,8,635,123,3411
"Westminster","14:00:00","2018-04-16",74,19,0,14,0,107
"Bromley","15:00:00","2018-04-16",78,0,5,12,0,95
"Croydon","15:00:00","2018-04-16",591,16,8,70,0,685
"Enfield","15:00:00","2018-04-16",4665,80,37,1595,512,6889
"Hackney","15:00:00","2018-04-16",525,29,86,159,31,830
"Hammersmith and Fulham","15:00:00","2018-04-16",971,67,39,202,26,1305
"Hillingdon","15:00:00","2018-04-16",1749,25,44,204,28,2050
"Lewisham","15:00:00","2018-04-16",49,3,0,9,1,62
"Merton","15:00:00","2018-04-16",209,4,0,31,1,245
"Tower Hamlets","15:00:00","2018-04-16",669,39,59,222,26,1015
"Wandsworth","15:00:00","2018-04-16",2824,88,15,793,109,3829
"Westminster","15:00:00","2018-04-16",85,14,1,21,3,124
"Bromley","16:00:00","2018-04-16",78,2,6,27,0,113
"Croydon","16:00:00","2018-04-16",595,15,13,79,1,703
"Enfield","16:00:00","2018-04-16",5741,120,42,1664,299,7866
"Hackney","16:00:00","2018-04-16",610,60,81,199,26,976
"Hammersmith and Fulham","16:00:00","2018-04-16",1038,72,40,204,15,1369
"Hillingdon","16:00:00","2018-04-16",1831,25,54,169,26,2105
"Lewisham","16:00:00","2018-04-16",60,7,0,14,0,81
"Merton","16:00:00","2018-04-16",251,6,0,37,0,294
"Tower Hamlets","16:00:00","2018-04-16",630,56,57,184,14,941
"Wandsworth","16:00:00","2018-04-16",3216,167,14,723,64,4184
"Westminster","16:00:00","2018-04-16",70,13,1,15,2,101
"Bromley","17:00:00","2018-04-16",96,2,5,17,0,120
"Croydon","17:00:00","2018-04-16",652,21,8,78,0,759
"Enfield","17:00:00","2018-04-16",6184,136,30,1381,208,7939
"Hackney","17:00:00","2018-04-16",635,96,84,146,18,979
"Hammersmith and Fulham","17:00:00","2018-04-16",1039,114,39,114,10,1316
"Hillingdon","17:00:00","2018-04-16",1619,33,46,152,18,1868
"Lewisham","17:00:00","2018-04-16",68,5,0,11,0,84
"Merton","17:00:00","2018-04-16",300,8,0,41,0,349
"Tower Hamlets","17:00:00","2018-04-16",685,62,59,132,16,954
"Wandsworth","17:00:00","2018-04-16",3477,273,12,578,56,4396
"Westminster","17:00:00","2018-04-16",83,30,0,16,0,129
"Bromley","18:00:00","2018-04-16",88,0,7,7,0,102
"Croydon","18:00:00","2018-04-16",571,20,11,62,1,665
"Enfield","18:00:00","2018-04-16",5480,115,33,951,176,6755
"Hackney","18:00:00","2018-04-16",712,72,76,110,12,982
"Hammersmith and Fulham","18:00:00","2018-04-16",1090,113,37,96,7,1343
"Hillingdon","18:00:00","2018-04-16",1695,32,49,173,10,1959
"Lewisham","18:00:00","2018-04-16",63,2,0,5,0,70
"Merton","18:00:00","2018-04-16",302,14,0,31,0,347
"Tower Hamlets","18:00:00","2018-04-16",714,46,65,96,7,928
"Westminster","18:00:00","2018-04-16",85,30,0,8,0,123
"Brent","07:00:00","2018-04-17",482,20,33,126,11,672
"Ealing","07:00:00","2018-04-17",322,5,17,64,7,415
"Enfield","07:00:00","2018-04-17",617,27,33,124,35,836
"Hillingdon","07:00:00","2018-04-17",1181,21,17,220,9,1448
"Merton","07:00:00","2018-04-17",1466,59,39,357,20,1941
"Redbridge","07:00:00","2018-04-17",1145,23,14,260,11,1453
"Waltham Forest","07:00:00","2018-04-17",598,25,15,145,28,811
"Brent","08:00:00","2018-04-17",557,19,15,70,12,673
"Ealing","08:00:00","2018-04-17",460,4,21,66,5,556
"Enfield","08:00:00","2018-04-17",777,18,36,159,19,1009
"Hillingdon","08:00:00","2018-04-17",1160,16,15,164,10,1365
"Merton","08:00:00","2018-04-17",1344,42,44,267,33,1730
"Redbridge","08:00:00","2018-04-17",1182,23,10,189,20,1424
"Waltham Forest","08:00:00","2018-04-17",502,19,10,123,18,672
"Brent","09:00:00","2018-04-17",447,12,20,82,18,579
"Ealing","09:00:00","2018-04-17",311,5,21,73,11,421
"Enfield","09:00:00","2018-04-17",700,19,34,147,21,921
"Hillingdon","09:00:00","2018-04-17",1027,17,12,179,32,1267
"Merton","09:00:00","2018-04-17",1133,23,37,221,35,1449
"Redbridge","09:00:00","2018-04-17",1001,13,8,179,21,1222
"Waltham Forest","09:00:00","2018-04-17",429,16,16,82,23,566
"Brent","10:00:00","2018-04-17",392,7,17,87,15,518
"Ealing","10:00:00","2018-04-17",303,6,20,65,7,401
"Enfield","10:00:00","2018-04-17",589,10,30,116,28,773
"Hillingdon","10:00:00","2018-04-17",982,10,12,218,23,1245
"Merton","10:00:00","2018-04-17",956,23,40,209,49,1277
"Redbridge","10:00:00","2018-04-17",903,16,6,167,21,1113
"Waltham Forest","10:00:00","2018-04-17",373,13,10,95,35,526
"Brent","11:00:00","2018-04-17",359,10,12,99,22,502
"Ealing","11:00:00","2018-04-17",412,19,18,71,15,535
"Enfield","11:00:00","2018-04-17",601,12,28,146,19,806
"Hillingdon","11:00:00","2018-04-17",999,13,12,199,26,1249
"Merton","11:00:00","2018-04-17",930,24,36,206,39,1235
"Redbridge","11:00:00","2018-04-17",838,13,10,144,9,1014
"Waltham Forest","11:00:00","2018-04-17",329,11,13,90,15,458
"Brent","12:00:00","2018-04-17",364,13,14,75,13,479
"Ealing","12:00:00","2018-04-17",394,40,19,73,11,537
"Enfield","12:00:00","2018-04-17",682,12,33,151,17,895
"Hillingdon","12:00:00","2018-04-17",1085,16,9,187,37,1334
"Merton","12:00:00","2018-04-17",1060,22,35,209,44,1370
"Redbridge","12:00:00","2018-04-17",968,13,8,164,16,1169
"Waltham Forest","12:00:00","2018-04-17",305,13,14,110,27,469
"Brent","13:00:00","2018-04-17",383,14,14,82,15,508
"Ealing","13:00:00","2018-04-17",480,49,15,55,10,609
"Enfield","13:00:00","2018-04-17",627,25,28,104,26,810
"Hillingdon","13:00:00","2018-04-17",1025,14,9,202,36,1286
"Merton","13:00:00","2018-04-17",1080,25,36,206,50,1397
"Redbridge","13:00:00","2018-04-17",1000,22,7,151,12,1192
"Waltham Forest","13:00:00","2018-04-17",337,17,13,71,17,455
"Brent","14:00:00","2018-04-17",343,15,10,64,9,441
"Ealing","14:00:00","2018-04-17",460,29,22,61,6,578
"Enfield","14:00:00","2018-04-17",678,18,33,109,19,857
"Hillingdon","14:00:00","2018-04-17",1149,10,9,185,33,1386
"Merton","14:00:00","2018-04-17",1142,30,34,212,43,1461
"Redbridge","14:00:00","2018-04-17",874,16,9,140,12,1051
"Waltham Forest","14:00:00","2018-04-17",386,21,14,75,13,509
"Brent","15:00:00","2018-04-17",358,15,12,69,12,466
"Ealing","15:00:00","2018-04-17",488,27,15,76,7,613
"Enfield","15:00:00","2018-04-17",664,30,31,114,17,856
"Hillingdon","15:00:00","2018-04-17",1288,16,16,235,26,1581
"Merton","15:00:00","2018-04-17",1273,31,37,241,25,1607
"Redbridge","15:00:00","2018-04-17",1189,27,10,141,14,1381
"Waltham Forest","15:00:00","2018-04-17",385,30,9,102,21,547
"Brent","16:00:00","2018-04-17",497,19,13,74,7,610
"Ealing","16:00:00","2018-04-17",612,38,15,60,1,726
"Enfield","16:00:00","2018-04-17",707,34,28,107,18,894
"Hillingdon","16:00:00","2018-04-17",1288,16,11,243,17,1575
"Merton","16:00:00","2018-04-17",1354,35,32,316,12,1749
"Redbridge","16:00:00","2018-04-17",1324,27,7,192,4,1554
"Waltham Forest","16:00:00","2018-04-17",459,27,12,106,10,614
"Brent","17:00:00","2018-04-17",552,23,11,93,9,688
"Ealing","17:00:00","2018-04-17",547,44,11,63,1,666
"Enfield","17:00:00","2018-04-17",839,33,29,159,12,1072
"Hillingdon","17:00:00","2018-04-17",1451,24,7,185,7,1674
"Merton","17:00:00","2018-04-17",1697,56,37,294,11,2095
"Redbridge","17:00:00","2018-04-17",1439,33,8,170,8,1658
"Waltham Forest","17:00:00","2018-04-17",499,25,12,78,11,625
"Brent","18:00:00","2018-04-17",526,27,17,71,4,645
"Ealing","18:00:00","2018-04-17",617,61,18,31,3,730
"Enfield","18:00:00","2018-04-17",800,38,31,97,4,970
"Hillingdon","18:00:00","2018-04-17",1303,21,13,139,1,1477
"Merton","18:00:00","2018-04-17",1312,57,35,167,5,1576
"Redbridge","18:00:00","2018-04-17",1463,44,11,116,5,1639
"Waltham Forest","18:00:00","2018-04-17",539,31,11,87,6,674
"Hackney","07:00:00","2018-04-18",573,94,68,240,55,1030
"Haringey","07:00:00","2018-04-18",134,7,0,40,0,181
"Havering","07:00:00","2018-04-18",826,6,10,130,17,989
"Hillingdon","07:00:00","2018-04-18",408,8,1,80,6,503
"Hounslow","07:00:00","2018-04-18",732,52,118,220,18,1140
"Kensington and Chelsea","07:00:00","2018-04-18",534,72,5,333,60,1004
"Richmond upon Thames","07:00:00","2018-04-18",423,10,47,86,6,572
"Hackney","08:00:00","2018-04-18",683,116,80,255,52,1186
"Haringey","08:00:00","2018-04-18",150,7,0,40,0,197
"Havering","08:00:00","2018-04-18",1004,5,16,104,37,1166
"Hillingdon","08:00:00","2018-04-18",625,5,0,73,7,710
"Hounslow","08:00:00","2018-04-18",1110,42,98,161,18,1429
"Kensington and Chelsea","08:00:00","2018-04-18",702,44,4,366,53,1169
"Richmond upon Thames","08:00:00","2018-04-18",622,11,44,75,10,762
"Hackney","09:00:00","2018-04-18",675,59,75,277,50,1136
"Haringey","09:00:00","2018-04-18",92,4,0,30,2,128
"Havering","09:00:00","2018-04-18",609,7,11,109,40,776
"Hillingdon","09:00:00","2018-04-18",256,2,0,43,4,305
"Hounslow","09:00:00","2018-04-18",868,39,101,203,30,1241
"Kensington and Chelsea","09:00:00","2018-04-18",667,40,7,380,57,1151
"Richmond upon Thames","09:00:00","2018-04-18",348,10,45,78,8,489
"Hackney","10:00:00","2018-04-18",583,57,56,261,33,990
"Haringey","10:00:00","2018-04-18",106,0,0,22,2,130
"Havering","10:00:00","2018-04-18",545,5,14,84,33,681
"Hillingdon","10:00:00","2018-04-18",218,4,0,40,12,274
"Hounslow","10:00:00","2018-04-18",800,32,101,229,32,1194
"Kensington and Chelsea","10:00:00","2018-04-18",569,41,7,369,60,1046
"Richmond upon Thames","10:00:00","2018-04-18",306,4,47,81,6,444
"Hackney","11:00:00","2018-04-18",658,76,67,316,45,1162
"Haringey","11:00:00","2018-04-18",94,0,0,25,3,122
"Havering","11:00:00","2018-04-18",564,7,13,97,31,712
"Hillingdon","11:00:00","2018-04-18",239,10,0,49,11,309
"Hounslow","11:00:00","2018-04-18",728,55,96,203,26,1108
"Kensington and Chelsea","11:00:00","2018-04-18",536,34,4,293,41,908
"Richmond upon Thames","11:00:00","2018-04-18",318,7,42,60,3,430
"Hackney","12:00:00","2018-04-18",585,60,68,262,39,1014
"Haringey","12:00:00","2018-04-18",97,1,0,31,1,130
"Havering","12:00:00","2018-04-18",500,11,8,91,17,627
"Hillingdon","12:00:00","2018-04-18",246,2,0,48,7,303
"Hounslow","12:00:00","2018-04-18",789,73,92,194,23,1171
"Kensington and Chelsea","12:00:00","2018-04-18",645,53,5,337,46,1086
"Richmond upon Thames","12:00:00","2018-04-18",363,7,42,63,5,480
"Hackney","13:00:00","2018-04-18",642,90,57,259,25,1073
"Haringey","13:00:00","2018-04-18",99,5,0,25,2,131
"Havering","13:00:00","2018-04-18",653,6,9,114,32,814
"Hillingdon","13:00:00","2018-04-18",224,6,0,48,5,283
"Hounslow","13:00:00","2018-04-18",884,65,96,161,18,1224
"Kensington and Chelsea","13:00:00","2018-04-18",670,32,2,259,41,1004
"Richmond upon Thames","13:00:00","2018-04-18",319,5,46,51,4,425
"Hackney","14:00:00","2018-04-18",673,66,73,271,44,1127
"Haringey","14:00:00","2018-04-18",106,3,0,24,2,135
"Havering","14:00:00","2018-04-18",783,12,13,120,13,941
"Hillingdon","14:00:00","2018-04-18",277,6,0,39,6,328
"Hounslow","14:00:00","2018-04-18",884,47,95,163,16,1205
"Kensington and Chelsea","14:00:00","2018-04-18",661,32,2,212,38,945
"Richmond upon Thames","14:00:00","2018-04-18",323,8,47,63,3,444
"Hackney","15:00:00","2018-04-18",750,63,64,264,27,1168
"Haringey","15:00:00","2018-04-18",115,2,0,33,1,151
"Havering","15:00:00","2018-04-18",685,11,11,119,17,843
"Hillingdon","15:00:00","2018-04-18",295,12,0,55,1,363
"Hounslow","15:00:00","2018-04-18",1046,47,104,152,11,1360
"Kensington and Chelsea","15:00:00","2018-04-18",557,39,7,199,35,837
"Richmond upon Thames","15:00:00","2018-04-18",455,9,43,65,3,575
"Hackney","16:00:00","2018-04-18",774,83,70,239,14,1180
"Haringey","16:00:00","2018-04-18",125,5,0,21,0,151
"Havering","16:00:00","2018-04-18",712,13,13,116,9,863
"Hillingdon","16:00:00","2018-04-18",370,8,3,66,1,448
"Hounslow","16:00:00","2018-04-18",1102,64,109,151,8,1434
"Kensington and Chelsea","16:00:00","2018-04-18",711,64,5,192,21,993
"Richmond upon Thames","16:00:00","2018-04-18",478,11,44,55,1,589
"Hackney","17:00:00","2018-04-18",917,135,63,188,19,1322
"Haringey","17:00:00","2018-04-18",149,8,0,25,1,183
"Havering","17:00:00","2018-04-18",769,16,9,119,1,914
"Hillingdon","17:00:00","2018-04-18",537,7,3,71,3,621
"Hounslow","17:00:00","2018-04-18",1192,82,88,126,10,1498
"Kensington and Chelsea","17:00:00","2018-04-18",818,71,5,124,8,1026
"Richmond upon Thames","17:00:00","2018-04-18",570,22,41,53,1,687
"Hackney","18:00:00","2018-04-18",909,108,53,119,9,1198
"Haringey","18:00:00","2018-04-18",151,7,0,19,0,177
"Havering","18:00:00","2018-04-18",737,17,12,75,4,845
"Hillingdon","18:00:00","2018-04-18",383,5,0,36,0,424
"Hounslow","18:00:00","2018-04-18",1328,121,96,113,5,1663
"Kensington and Chelsea","18:00:00","2018-04-18",839,79,8,72,5,1003
"Richmond upon Thames","18:00:00","2018-04-18",481,17,39,24,0,561
"Barnet","07:00:00","2018-04-19",902,10,21,195,11,1139
"Bromley","07:00:00","2018-04-19",546,28,34,168,8,784
"Enfield","07:00:00","2018-04-19",140,3,2,24,1,170
"Greenwich","07:00:00","2018-04-19",124,0,0,8,0,132
"Havering","07:00:00","2018-04-19",826,6,15,220,9,1076
"Kingston upon Thames","07:00:00","2018-04-19",594,11,19,81,4,709
"Waltham Forest","07:00:00","2018-04-19",12,0,0,1,0,13
"Westminster","07:00:00","2018-04-19",236,48,48,138,43,513
"Barnet","08:00:00","2018-04-19",894,5,9,69,6,983
"Bromley","08:00:00","2018-04-19",656,33,36,156,16,897
"Enfield","08:00:00","2018-04-19",280,1,2,33,1,317
"Greenwich","08:00:00","2018-04-19",159,1,0,7,0,167
"Havering","08:00:00","2018-04-19",955,2,11,206,14,1188
"Kingston upon Thames","08:00:00","2018-04-19",781,8,22,66,9,886
"Waltham Forest","08:00:00","2018-04-19",35,0,1,0,1,37
"Westminster","08:00:00","2018-04-19",207,69,51,129,28,484
"Barnet","09:00:00","2018-04-19",792,5,21,93,27,938
"Bromley","09:00:00","2018-04-19",699,19,40,156,16,930
"Enfield","09:00:00","2018-04-19",157,0,0,17,5,179
"Greenwich","09:00:00","2018-04-19",93,0,1,14,0,108
"Havering","09:00:00","2018-04-19",863,2,13,149,12,1039
"Kingston upon Thames","09:00:00","2018-04-19",554,6,15,65,6,646
"Waltham Forest","09:00:00","2018-04-19",18,0,0,2,0,20
"Westminster","09:00:00","2018-04-19",203,66,36,110,42,457
"Barnet","10:00:00","2018-04-19",580,4,16,108,10,718
"Bromley","10:00:00","2018-04-19",632,12,39,183,12,878
"Enfield","10:00:00","2018-04-19",101,2,0,15,1,119
"Greenwich","10:00:00","2018-04-19",34,0,0,5,0,39
"Havering","10:00:00","2018-04-19",950,3,12,186,12,1163
"Kingston upon Thames","10:00:00","2018-04-19",470,6,12,83,14,585
"Waltham Forest","10:00:00","2018-04-19",16,0,0,0,0,16
"Westminster","10:00:00","2018-04-19",205,41,57,129,20,452
"Barnet","11:00:00","2018-04-19",726,9,14,105,14,868
"Bromley","11:00:00","2018-04-19",590,18,42,162,15,827
"Enfield","11:00:00","2018-04-19",145,3,0,20,1,169
"Greenwich","11:00:00","2018-04-19",56,0,0,11,0,67
"Havering","11:00:00","2018-04-19",584,5,7,181,11,788
"Kingston upon Thames","11:00:00","2018-04-19",483,6,13,90,8,600
"Waltham Forest","11:00:00","2018-04-19",17,1,0,1,2,21
"Westminster","11:00:00","2018-04-19",193,42,49,123,26,433
"Barnet","12:00:00","2018-04-19",620,11,13,115,13,772
"Bromley","12:00:00","2018-04-19",605,14,36,148,12,815
"Enfield","12:00:00","2018-04-19",118,0,0,23,0,141
"Greenwich","12:00:00","2018-04-19",61,0,0,13,1,75
"Havering","12:00:00","2018-04-19",681,5,8,139,6,839
"Kingston upon Thames","12:00:00","2018-04-19",499,9,10,83,8,609
"Waltham Forest","12:00:00","2018-04-19",11,0,0,2,1,14
"Westminster","12:00:00","2018-04-19",227,53,45,124,21,470
"Barnet","13:00:00","2018-04-19",622,14,15,111,8,770
"Bromley","13:00:00","2018-04-19",568,15,37,158,14,792
"Enfield","13:00:00","2018-04-19",120,2,0,26,2,150
"Greenwich","13:00:00","2018-04-19",37,1,0,10,0,48
"Havering","13:00:00","2018-04-19",782,4,11,163,10,970
"Kingston upon Thames","13:00:00","2018-04-19",496,7,9,75,7,594
"Waltham Forest","13:00:00","2018-04-19",16,1,0,4,0,21
"Westminster","13:00:00","2018-04-19",233,42,49,98,13,435
"Barnet","14:00:00","2018-04-19",650,12,13,123,9,807
"Bromley","14:00:00","2018-04-19",615,17,39,165,10,846
"Enfield","14:00:00","2018-04-19",180,3,0,33,3,219
"Greenwich","14:00:00","2018-04-19",51,0,0,8,0,59
"Havering","14:00:00","2018-04-19",1009,4,12,209,16,1250
"Kingston upon Thames","14:00:00","2018-04-19",534,12,15,62,8,631
"Waltham Forest","14:00:00","2018-04-19",31,0,0,2,1,34
"Westminster","14:00:00","2018-04-19",302,45,58,115,18,538
"Barnet","15:00:00","2018-04-19",764,11,11,111,11,908
"Bromley","15:00:00","2018-04-19",766,33,36,182,4,1021
"Enfield","15:00:00","2018-04-19",283,0,3,35,2,323
"Greenwich","15:00:00","2018-04-19",76,1,0,10,0,87
"Havering","15:00:00","2018-04-19",852,0,9,283,10,1154
"Kingston upon Thames","15:00:00","2018-04-19",680,8,21,47,5,761
"Waltham Forest","15:00:00","2018-04-19",31,0,0,2,1,34
"Westminster","15:00:00","2018-04-19",333,49,40,92,17,531
"Barnet","16:00:00","2018-04-19",941,9,27,112,3,1092
"Bromley","16:00:00","2018-04-19",804,36,33,217,6,1096
"Enfield","16:00:00","2018-04-19",329,0,6,74,2,411
"Greenwich","16:00:00","2018-04-19",87,1,0,9,0,97
"Havering","16:00:00","2018-04-19",893,8,35,212,3,1151
"Kingston upon Thames","16:00:00","2018-04-19",684,10,15,91,7,807
"Waltham Forest","16:00:00","2018-04-19",37,0,1,2,0,40
"Westminster","16:00:00","2018-04-19",295,56,42,88,4,485
"Barnet","17:00:00","2018-04-19",1421,9,10,129,1,1570
"Bromley","17:00:00","2018-04-19",865,52,43,184,7,1151
"Enfield","17:00:00","2018-04-19",282,7,0,30,0,319
"Greenwich","17:00:00","2018-04-19",97,0,0,10,0,107
"Havering","17:00:00","2018-04-19",962,10,11,252,1,1236
"Kingston upon Thames","17:00:00","2018-04-19",750,7,13,60,1,831
"Waltham Forest","17:00:00","2018-04-19",30,0,0,3,0,33
"Westminster","17:00:00","2018-04-19",354,106,47,47,7,561
"Barnet","18:00:00","2018-04-19",1420,3,13,64,0,1500
"Bromley","18:00:00","2018-04-19",919,55,37,184,4,1199
"Enfield","18:00:00","2018-04-19",233,7,0,25,0,265
"Greenwich","18:00:00","2018-04-19",62,0,0,6,1,69
"Havering","18:00:00","2018-04-19",776,5,7,193,1,982
"Kingston upon Thames","18:00:00","2018-04-19",713,15,17,32,4,781
"Waltham Forest","18:00:00","2018-04-19",15,0,0,1,0,16
"Westminster","18:00:00","2018-04-19",347,111,40,34,4,536
"Barnet","07:00:00","2018-04-20",583,2,3,176,0,764
"Croydon","07:00:00","2018-04-20",512,14,20,94,13,653
"Greenwich","07:00:00","2018-04-20",1249,49,76,355,86,1815
"Hillingdon","07:00:00","2018-04-20",1781,26,88,296,45,2236
"Hounslow","07:00:00","2018-04-20",114,3,0,33,2,152
"Lewisham","07:00:00","2018-04-20",570,20,36,125,19,770
"Newham","07:00:00","2018-04-20",11,0,0,5,0,16
"Redbridge","07:00:00","2018-04-20",79,0,0,10,0,89
"Barnet","08:00:00","2018-04-20",626,1,0,96,0,723
"Croydon","08:00:00","2018-04-20",590,8,15,70,12,695
"Greenwich","08:00:00","2018-04-20",1473,45,61,460,79,2118
"Hillingdon","08:00:00","2018-04-20",2248,19,94,212,37,2610
"Hounslow","08:00:00","2018-04-20",159,6,0,39,1,205
"Lewisham","08:00:00","2018-04-20",714,8,45,117,17,901
"Newham","08:00:00","2018-04-20",17,1,0,3,0,21
"Redbridge","08:00:00","2018-04-20",166,1,0,15,0,182
"Barnet","09:00:00","2018-04-20",661,2,1,121,0,785
"Croydon","09:00:00","2018-04-20",523,6,22,68,9,628
"Greenwich","09:00:00","2018-04-20",1121,36,66,437,50,1710
"Hillingdon","09:00:00","2018-04-20",1972,16,94,243,43,2368
"Hounslow","09:00:00","2018-04-20",132,7,0,35,3,177
"Lewisham","09:00:00","2018-04-20",615,6,34,131,15,801
"Newham","09:00:00","2018-04-20",16,0,0,2,0,18
"Redbridge","09:00:00","2018-04-20",50,0,0,13,0,63
"Barnet","10:00:00","2018-04-20",428,6,1,67,0,502
"Croydon","10:00:00","2018-04-20",460,3,16,56,8,543
"Greenwich","10:00:00","2018-04-20",1190,25,68,481,61,1825
"Hillingdon","10:00:00","2018-04-20",1616,22,80,280,52,2050
"Hounslow","10:00:00","2018-04-20",111,2,0,35,5,153
"Lewisham","10:00:00","2018-04-20",584,10,34,114,10,752
"Newham","10:00:00","2018-04-20",16,0,0,4,1,21
"Redbridge","10:00:00","2018-04-20",31,0,0,10,2,43
"Barnet","11:00:00","2018-04-20",423,2,3,77,0,505
"Croydon","11:00:00","2018-04-20",406,2,16,75,15,514
"Greenwich","11:00:00","2018-04-20",1259,34,64,473,78,1908
"Hillingdon","11:00:00","2018-04-20",1665,21,73,284,64,2107
"Hounslow","11:00:00","2018-04-20",98,2,0,33,2,135
"Lewisham","11:00:00","2018-04-20",583,13,23,101,25,745
"Newham","11:00:00","2018-04-20",13,0,0,7,0,20
"Redbridge","11:00:00","2018-04-20",31,0,0,12,0,43
"Barnet","12:00:00","2018-04-20",510,7,1,124,0,642
"Croydon","12:00:00","2018-04-20",465,4,14,79,6,568
"Greenwich","12:00:00","2018-04-20",1044,21,58,418,63,1604
"Hillingdon","12:00:00","2018-04-20",1738,29,83,246,57,2153
"Hounslow","12:00:00","2018-04-20",113,8,0,39,5,165
"Lewisham","12:00:00","2018-04-20",532,17,34,129,18,730
"Newham","12:00:00","2018-04-20",18,0,0,3,0,21
"Redbridge","12:00:00","2018-04-20",50,0,0,12,0,62
"Barnet","13:00:00","2018-04-20",478,7,0,62,0,547
"Croydon","13:00:00","2018-04-20",418,6,16,65,4,509
"Greenwich","13:00:00","2018-04-20",1193,29,50,485,73,1830
"Hillingdon","13:00:00","2018-04-20",1780,24,81,212,57,2154
"Hounslow","13:00:00","2018-04-20",134,7,0,22,3,166
"Lewisham","13:00:00","2018-04-20",561,17,29,115,20,742
"Newham","13:00:00","2018-04-20",12,0,1,1,0,14
"Redbridge","13:00:00","2018-04-20",48,0,0,4,0,52
"Barnet","14:00:00","2018-04-20",504,2,2,88,0,596
"Croydon","14:00:00","2018-04-20",452,6,16,57,8,539
"Greenwich","14:00:00","2018-04-20",1454,32,53,461,43,2043
"Hillingdon","14:00:00","2018-04-20",1751,35,87,282,58,2213
"Hounslow","14:00:00","2018-04-20",134,2,0,22,5,163
"Lewisham","14:00:00","2018-04-20",665,14,32,131,21,863
"Newham","14:00:00","2018-04-20",19,1,1,2,0,23
"Redbridge","14:00:00","2018-04-20",69,0,0,8,0,77
"Barnet","15:00:00","2018-04-20",571,9,2,131,0,713
"Croydon","15:00:00","2018-04-20",670,7,18,69,4,768
"Greenwich","15:00:00","2018-04-20",1420,29,52,244,31,1776
"Hillingdon","15:00:00","2018-04-20",2320,27,94,268,44,2753
"Hounslow","15:00:00","2018-04-20",161,2,0,25,1,189
"Lewisham","15:00:00","2018-04-20",658,17,33,109,9,826
"Newham","15:00:00","2018-04-20",22,0,1,7,0,30
"Redbridge","15:00:00","2018-04-20",103,1,0,6,0,110
"Barnet","16:00:00","2018-04-20",657,13,7,101,0,778
"Croydon","16:00:00","2018-04-20",597,8,18,82,3,708
"Greenwich","16:00:00","2018-04-20",1169,32,47,284,19,1551
"Hillingdon","16:00:00","2018-04-20",2632,35,98,291,29,3085
"Hounslow","16:00:00","2018-04-20",162,1,0,28,1,192
"Lewisham","16:00:00","2018-04-20",640,25,30,116,7,818
"Newham","16:00:00","2018-04-20",26,0,0,3,0,29
"Redbridge","16:00:00","2018-04-20",61,1,0,3,0,65
"Barnet","17:00:00","2018-04-20",817,14,4,96,0,931
"Croydon","17:00:00","2018-04-20",596,18,14,69,3,700
"Greenwich","17:00:00","2018-04-20",1731,29,50,194,26,2030
"Hillingdon","17:00:00","2018-04-20",2654,41,78,216,21,3010
"Hounslow","17:00:00","2018-04-20",214,3,0,17,2,236
"Lewisham","17:00:00","2018-04-20",701,40,32,112,3,888
"Newham","17:00:00","2018-04-20",22,0,0,5,0,27
"Redbridge","17:00:00","2018-04-20",83,2,0,13,0,98
"Barnet","18:00:00","2018-04-20",873,14,1,126,0,1014
"Croydon","18:00:00","2018-04-20",581,20,17,37,0,655
"Greenwich","18:00:00","2018-04-20",1411,27,55,183,17,1693
"Hillingdon","18:00:00","2018-04-20",2007,42,72,170,11,2302
"Hounslow","18:00:00","2018-04-20",190,8,0,18,0,216
"Lewisham","18:00:00","2018-04-20",722,26,27,88,7,870
"Newham","18:00:00","2018-04-20",24,0,0,6,0,30
"Redbridge","18:00:00","2018-04-20",36,0,0,5,0,41
"Brent","07:00:00","2018-04-23",441,8,10,62,5,526
"Hounslow","07:00:00","2018-04-23",471,5,6,83,18,583
"Kingston upon Thames","07:00:00","2018-04-23",1430,37,28,242,24,1761
"Lambeth","07:00:00","2018-04-23",1087,152,56,527,103,1925
"Tower Hamlets","07:00:00","2018-04-23",578,196,48,236,45,1103
"Waltham Forest","07:00:00","2018-04-23",158,1,10,51,2,222
"Brent","08:00:00","2018-04-23",731,7,11,37,2,788
"Hounslow","08:00:00","2018-04-23",497,7,6,72,22,604
"Kingston upon Thames","08:00:00","2018-04-23",1682,43,16,207,27,1975
"Lambeth","08:00:00","2018-04-23",1518,150,58,480,116,2322
"Tower Hamlets","08:00:00","2018-04-23",886,193,52,237,44,1412
"Waltham Forest","08:00:00","2018-04-23",237,1,5,55,3,301
"Brent","09:00:00","2018-04-23",484,11,12,49,9,565
"Hounslow","09:00:00","2018-04-23",356,4,9,92,32,493
"Kingston upon Thames","09:00:00","2018-04-23",1388,25,18,265,47,1743
"Lambeth","09:00:00","2018-04-23",1048,87,69,544,118,1866
"Tower Hamlets","09:00:00","2018-04-23",698,96,52,307,51,1204
"Waltham Forest","09:00:00","2018-04-23",256,3,7,51,3,320
"Brent","10:00:00","2018-04-23",364,12,15,48,10,449
"Hounslow","10:00:00","2018-04-23",328,3,5,70,24,430
"Kingston upon Thames","10:00:00","2018-04-23",1052,13,14,220,52,1351
"Lambeth","10:00:00","2018-04-23",1264,51,63,500,135,2013
"Tower Hamlets","10:00:00","2018-04-23",666,38,56,320,62,1142
"Waltham Forest","10:00:00","2018-04-23",200,1,7,52,3,263
"Brent","11:00:00","2018-04-23",383,9,11,51,9,463
"Hounslow","11:00:00","2018-04-23",317,3,5,71,16,412
"Kingston upon Thames","11:00:00","2018-04-23",1056,17,11,257,63,1404
"Lambeth","11:00:00","2018-04-23",1253,54,49,543,131,2030
"Tower Hamlets","11:00:00","2018-04-23",670,37,43,291,60,1101
"Waltham Forest","11:00:00","2018-04-23",255,4,5,74,3,341
"Brent","12:00:00","2018-04-23",406,14,12,42,7,481
"Hounslow","12:00:00","2018-04-23",335,8,6,83,23,455
"Kingston upon Thames","12:00:00","2018-04-23",1027,18,15,207,55,1322
"Lambeth","12:00:00","2018-04-23",1098,73,59,521,92,1843
"Tower Hamlets","12:00:00","2018-04-23",749,61,49,289,54,1202
"Waltham Forest","12:00:00","2018-04-23",216,3,5,40,6,270
"Brent","13:00:00","2018-04-23",388,16,10,48,12,474
"Hounslow","13:00:00","2018-04-23",359,2,7,65,22,455
"Kingston upon Thames","13:00:00","2018-04-23",1054,18,17,222,63,1374
"Lambeth","13:00:00","2018-04-23",1230,60,60,500,115,1965
"Tower Hamlets","13:00:00","2018-04-23",733,44,49,265,44,1135
"Waltham Forest","13:00:00","2018-04-23",219,8,6,59,6,298
"Brent","14:00:00","2018-04-23",436,17,12,47,6,518
"Hounslow","14:00:00","2018-04-23",297,6,6,70,21,400
"Kingston upon Thames","14:00:00","2018-04-23",1221,19,15,186,37,1478
"Lambeth","14:00:00","2018-04-23",1199,84,66,402,117,1868
"Tower Hamlets","14:00:00","2018-04-23",807,54,50,197,43,1151
"Waltham Forest","14:00:00","2018-04-23",252,5,7,56,3,323
"Brent","15:00:00","2018-04-23",528,8,16,39,5,596
"Hounslow","15:00:00","2018-04-23",420,3,8,89,29,549
"Kingston upon Thames","15:00:00","2018-04-23",1477,26,17,178,38,1736
"Lambeth","15:00:00","2018-04-23",1101,147,58,558,59,1923
"Tower Hamlets","15:00:00","2018-04-23",869,82,49,252,38,1290
"Waltham Forest","15:00:00","2018-04-23",311,8,6,48,5,378
"Brent","16:00:00","2018-04-23",502,15,13,40,3,573
"Hounslow","16:00:00","2018-04-23",480,10,4,85,18,597
"Kingston upon Thames","16:00:00","2018-04-23",1571,24,29,218,26,1868
"Lambeth","16:00:00","2018-04-23",1389,168,92,465,32,2146
"Tower Hamlets","16:00:00","2018-04-23",848,132,55,221,30,1286
"Waltham Forest","16:00:00","2018-04-23",394,9,11,62,2,478
"Brent","17:00:00","2018-04-23",568,11,16,46,2,643
"Hounslow","17:00:00","2018-04-23",627,7,6,94,15,749
"Kingston upon Thames","17:00:00","2018-04-23",1657,37,18,157,12,1881
"Lambeth","17:00:00","2018-04-23",1437,408,65,350,28,2288
"Tower Hamlets","17:00:00","2018-04-23",954,202,50,219,23,1448
"Waltham Forest","17:00:00","2018-04-23",329,4,6,58,3,400
"Brent","18:00:00","2018-04-23",485,16,12,42,2,557
"Hounslow","18:00:00","2018-04-23",684,8,7,58,9,766
"Kingston upon Thames","18:00:00","2018-04-23",1780,53,17,103,10,1963
"Lambeth","18:00:00","2018-04-23",1743,481,75,197,25,2521
"Tower Hamlets","18:00:00","2018-04-23",935,183,49,147,22,1336
"Waltham Forest","18:00:00","2018-04-23",347,8,5,47,3,410
"Bexley","07:00:00","2018-04-24",952,15,34,294,65,1360
"Croydon","07:00:00","2018-04-24",316,5,0,32,2,355
"Enfield","07:00:00","2018-04-24",898,9,73,202,53,1235
"Kensington and Chelsea","07:00:00","2018-04-24",1052,104,49,354,44,1603
"Lambeth","07:00:00","2018-04-24",308,7,0,61,1,377
"Bexley","08:00:00","2018-04-24",1075,14,36,359,58,1542
"Croydon","08:00:00","2018-04-24",320,2,0,41,0,363
"Enfield","08:00:00","2018-04-24",1041,13,54,195,56,1359
"Kensington and Chelsea","08:00:00","2018-04-24",924,112,48,328,62,1474
"Lambeth","08:00:00","2018-04-24",399,2,1,62,4,468
"Bexley","09:00:00","2018-04-24",960,15,35,311,57,1378
"Croydon","09:00:00","2018-04-24",292,4,2,27,0,325
"Enfield","09:00:00","2018-04-24",912,18,73,244,65,1312
"Kensington and Chelsea","09:00:00","2018-04-24",1010,56,36,342,55,1499
"Lambeth","09:00:00","2018-04-24",270,5,1,81,4,361
"Bexley","10:00:00","2018-04-24",908,13,34,217,54,1226
"Croydon","10:00:00","2018-04-24",197,2,1,33,3,236
"Enfield","10:00:00","2018-04-24",795,14,66,218,89,1182
"Kensington and Chelsea","10:00:00","2018-04-24",901,75,46,377,76,1475
"Lambeth","10:00:00","2018-04-24",181,7,1,38,3,230
"Bexley","11:00:00","2018-04-24",1020,9,41,282,71,1423
"Croydon","11:00:00","2018-04-24",159,1,0,34,2,196
"Enfield","11:00:00","2018-04-24",877,16,59,190,66,1208
"Kensington and Chelsea","11:00:00","2018-04-24",922,54,39,374,72,1461
"Lambeth","11:00:00","2018-04-24",184,2,0,52,6,244
"Bexley","12:00:00","2018-04-24",1003,7,33,265,38,1346
"Croydon","12:00:00","2018-04-24",182,4,1,22,2,211
"Enfield","12:00:00","2018-04-24",1138,13,59,194,63,1467
"Kensington and Chelsea","12:00:00","2018-04-24",921,77,36,359,69,1462
"Lambeth","12:00:00","2018-04-24",204,10,0,70,3,287
"Bexley","13:00:00","2018-04-24",996,4,27,221,69,1317
"Croydon","13:00:00","2018-04-24",159,3,1,38,2,203
"Enfield","13:00:00","2018-04-24",924,12,56,162,55,1209
"Kensington and Chelsea","13:00:00","2018-04-24",863,92,36,362,82,1435
"Lambeth","13:00:00","2018-04-24",204,3,0,64,6,277
"Bexley","14:00:00","2018-04-24",1003,9,38,242,76,1368
"Croydon","14:00:00","2018-04-24",183,3,0,27,1,214
"Enfield","14:00:00","2018-04-24",938,16,56,173,50,1233
"Kensington and Chelsea","14:00:00","2018-04-24",851,57,32,303,53,1296
"Lambeth","14:00:00","2018-04-24",199,7,1,50,1,258
"Bexley","15:00:00","2018-04-24",1007,12,27,267,75,1388
"Croydon","15:00:00","2018-04-24",201,3,0,22,1,227
"Enfield","15:00:00","2018-04-24",1128,12,62,195,56,1453
"Kensington and Chelsea","15:00:00","2018-04-24",1083,109,41,266,36,1535
"Lambeth","15:00:00","2018-04-24",275,5,1,45,6,332
"Bexley","16:00:00","2018-04-24",960,8,33,253,47,1301
"Croydon","16:00:00","2018-04-24",275,3,3,36,0,317
"Enfield","16:00:00","2018-04-24",1045,15,67,159,27,1313
"Kensington and Chelsea","16:00:00","2018-04-24",1114,135,52,324,34,1659
"Lambeth","16:00:00","2018-04-24",310,9,0,69,1,389
"Bexley","17:00:00","2018-04-24",1214,18,31,237,26,1526
"Croydon","17:00:00","2018-04-24",285,5,0,32,0,322
"Enfield","17:00:00","2018-04-24",1233,17,64,137,24,1475
"Kensington and Chelsea","17:00:00","2018-04-24",1119,135,44,248,25,1571
"Lambeth","17:00:00","2018-04-24",345,12,0,51,0,408
"Bexley","18:00:00","2018-04-24",1126,17,26,147,23,1339
"Croydon","18:00:00","2018-04-24",287,8,0,30,0,325
"Enfield","18:00:00","2018-04-24",1191,18,65,102,15,1391
"Kensington and Chelsea","18:00:00","2018-04-24",1204,171,43,190,19,1627
"Lambeth","18:00:00","2018-04-24",298,5,0,34,0,337
"City of London","07:00:00","2018-04-25",668,106,126,301,53,1254
"Ealing","07:00:00","2018-04-25",522,4,12,110,6,654
"Enfield","07:00:00","2018-04-25",662,27,34,183,24,930
"Hammersmith and Fulham","07:00:00","2018-04-25",21,1,3,2,1,28
"Haringey","07:00:00","2018-04-25",682,86,41,261,53,1123
"Hounslow","07:00:00","2018-04-25",194,6,1,29,6,236
"Kensington and Chelsea","07:00:00","2018-04-25",994,175,25,376,63,1633
"Lambeth","07:00:00","2018-04-25",21,0,0,0,1,22
"Richmond upon Thames","07:00:00","2018-04-25",214,5,0,42,3,264
"City of London","08:00:00","2018-04-25",869,129,135,344,71,1548
"Ealing","08:00:00","2018-04-25",483,6,22,74,6,591
"Enfield","08:00:00","2018-04-25",1044,21,32,185,20,1302
"Hammersmith and Fulham","08:00:00","2018-04-25",46,1,2,5,0,54
"Haringey","08:00:00","2018-04-25",814,58,49,244,32,1197
"Hounslow","08:00:00","2018-04-25",307,4,0,21,15,347
"Kensington and Chelsea","08:00:00","2018-04-25",974,158,22,309,65,1528
"Lambeth","08:00:00","2018-04-25",35,1,1,9,0,46
"Richmond upon Thames","08:00:00","2018-04-25",437,9,6,38,11,501
"City of London","09:00:00","2018-04-25",833,89,114,290,37,1363
"Ealing","09:00:00","2018-04-25",453,3,13,83,6,558
"Enfield","09:00:00","2018-04-25",862,16,40,146,28,1092
"Hammersmith and Fulham","09:00:00","2018-04-25",19,0,1,13,0,33
"Haringey","09:00:00","2018-04-25",696,51,37,232,37,1053
"Hounslow","09:00:00","2018-04-25",466,10,0,34,19,529
"Kensington and Chelsea","09:00:00","2018-04-25",979,171,30,428,80,1688
"Lambeth","09:00:00","2018-04-25",28,1,0,9,0,38
"Richmond upon Thames","09:00:00","2018-04-25",296,18,3,43,4,364
"City of London","10:00:00","2018-04-25",837,66,139,360,60,1462
"Ealing","10:00:00","2018-04-25",328,4,13,53,0,398
"Enfield","10:00:00","2018-04-25",656,17,35,161,26,895
"Hammersmith and Fulham","10:00:00","2018-04-25",23,0,0,11,0,34
"Haringey","10:00:00","2018-04-25",585,29,47,230,32,923
"Hounslow","10:00:00","2018-04-25",328,6,0,24,11,369
"Kensington and Chelsea","10:00:00","2018-04-25",899,76,36,438,88,1537
"Lambeth","10:00:00","2018-04-25",27,1,0,7,1,36
"Richmond upon Thames","10:00:00","2018-04-25",201,10,0,66,11,288
"City of London","11:00:00","2018-04-25",858,78,114,351,50,1451
"Ealing","11:00:00","2018-04-25",297,6,20,54,4,381
"Enfield","11:00:00","2018-04-25",752,22,31,155,15,975
"Hammersmith and Fulham","11:00:00","2018-04-25",21,0,0,10,0,31
"Haringey","11:00:00","2018-04-25",633,50,41,228,32,984
"Hounslow","11:00:00","2018-04-25",449,3,0,44,16,512
"Kensington and Chelsea","11:00:00","2018-04-25",1040,66,38,477,86,1707
"Lambeth","11:00:00","2018-04-25",19,1,0,8,0,28
"Richmond upon Thames","11:00:00","2018-04-25",227,16,1,60,8,312
"City of London","12:00:00","2018-04-25",881,65,105,245,27,1323
"Ealing","12:00:00","2018-04-25",327,9,18,92,9,455
"Enfield","12:00:00","2018-04-25",784,25,28,151,22,1010
"Hammersmith and Fulham","12:00:00","2018-04-25",18,0,0,11,1,30
"Haringey","12:00:00","2018-04-25",584,41,36,207,32,900
"Hounslow","12:00:00","2018-04-25",403,4,0,31,8,446
"Kensington and Chelsea","12:00:00","2018-04-25",1049,96,28,468,88,1729
"Lambeth","12:00:00","2018-04-25",14,4,0,10,0,28
"Richmond upon Thames","12:00:00","2018-04-25",239,24,0,61,5,329
"City of London","13:00:00","2018-04-25",806,56,96,223,37,1218
"Ealing","13:00:00","2018-04-25",382,10,14,102,5,513
"Enfield","13:00:00","2018-04-25",787,30,30,152,13,1012
"Hammersmith and Fulham","13:00:00","2018-04-25",24,3,0,7,0,34
"Haringey","13:00:00","2018-04-25",578,31,36,168,30,843
"Hounslow","13:00:00","2018-04-25",408,5,1,35,11,460
"Kensington and Chelsea","13:00:00","2018-04-25",1051,76,25,509,100,1761
"Lambeth","13:00:00","2018-04-25",21,3,0,9,1,34
"Richmond upon Thames","13:00:00","2018-04-25",198,25,1,51,8,283
"City of London","14:00:00","2018-04-25",856,59,122,311,44,1392
"Ealing","14:00:00","2018-04-25",369,8,13,76,2,468
"Enfield","14:00:00","2018-04-25",809,33,43,142,15,1042
"Hammersmith and Fulham","14:00:00","2018-04-25",24,3,0,14,0,41
"Haringey","14:00:00","2018-04-25",684,31,46,216,20,997
"Hounslow","14:00:00","2018-04-25",404,6,0,34,12,456
"Kensington and Chelsea","14:00:00","2018-04-25",995,68,22,418,64,1567
"Lambeth","14:00:00","2018-04-25",20,4,0,9,0,33
"Richmond upon Thames","14:00:00","2018-04-25",202,16,4,58,6,286
"City of London","15:00:00","2018-04-25",974,65,113,223,28,1403
"Ealing","15:00:00","2018-04-25",457,9,18,85,8,577
"Enfield","15:00:00","2018-04-25",791,29,35,130,8,993
"Hammersmith and Fulham","15:00:00","2018-04-25",39,2,5,5,2,53
"Haringey","15:00:00","2018-04-25",668,33,44,204,23,972
"Hounslow","15:00:00","2018-04-25",500,4,1,37,4,546
"Kensington and Chelsea","15:00:00","2018-04-25",1202,87,27,482,49,1847
"Lambeth","15:00:00","2018-04-25",32,4,1,6,0,43
"Richmond upon Thames","15:00:00","2018-04-25",234,19,3,41,3,300
"City of London","16:00:00","2018-04-25",950,84,144,241,20,1439
"Ealing","16:00:00","2018-04-25",567,4,20,119,5,715
"Enfield","16:00:00","2018-04-25",774,45,42,127,11,999
"Hammersmith and Fulham","16:00:00","2018-04-25",24,1,2,14,0,41
"Haringey","16:00:00","2018-04-25",744,54,48,220,12,1078
"Hounslow","16:00:00","2018-04-25",423,11,2,21,1,458
"Kensington and Chelsea","16:00:00","2018-04-25",1126,149,22,408,47,1752
"Lambeth","16:00:00","2018-04-25",21,10,0,5,1,37
"Richmond upon Thames","16:00:00","2018-04-25",253,23,8,52,2,338
"City of London","17:00:00","2018-04-25",1072,113,128,271,20,1604
"Ealing","17:00:00","2018-04-25",584,17,16,111,4,732
"Enfield","17:00:00","2018-04-25",1041,43,30,164,6,1284
"Hammersmith and Fulham","17:00:00","2018-04-25",27,3,0,14,0,44
"Haringey","17:00:00","2018-04-25",795,74,42,149,9,1069
"Hounslow","17:00:00","2018-04-25",467,11,2,20,2,502
"Kensington and Chelsea","17:00:00","2018-04-25",1220,233,34,304,23,1814
"Lambeth","17:00:00","2018-04-25",23,2,0,5,0,30
"Richmond upon Thames","17:00:00","2018-04-25",287,40,2,56,0,385
"City of London","18:00:00","2018-04-25",1032,124,144,178,6,1484
"Ealing","18:00:00","2018-04-25",529,9,16,87,3,644
"Enfield","18:00:00","2018-04-25",1105,70,38,167,5,1385
"Hammersmith and Fulham","18:00:00","2018-04-25",23,3,0,13,0,39
"Haringey","18:00:00","2018-04-25",818,95,36,142,6,1097
"Hounslow","18:00:00","2018-04-25",428,8,0,17,2,455
"Kensington and Chelsea","18:00:00","2018-04-25",1360,222,34,203,17,1836
"Lambeth","18:00:00","2018-04-25",23,6,0,3,0,32
"Richmond upon Thames","18:00:00","2018-04-25",300,36,0,24,1,361
"Brent","07:00:00","2018-04-26",382,28,52,122,18,602
"Camden","07:00:00","2018-04-26",374,62,62,187,28,713
"Kingston upon Thames","07:00:00","2018-04-26",1488,36,6,390,41,1961
"Lewisham","07:00:00","2018-04-26",199,6,0,82,8,295
"Sutton","07:00:00","2018-04-26",251,4,0,41,5,301
"Westminster","07:00:00","2018-04-26",56,2,0,22,1,81
"Brent","08:00:00","2018-04-26",472,39,48,142,15,716
"Camden","08:00:00","2018-04-26",388,73,61,177,35,734
"Kingston upon Thames","08:00:00","2018-04-26",1450,36,5,268,57,1816
"Lewisham","08:00:00","2018-04-26",319,11,0,125,9,464
"Sutton","08:00:00","2018-04-26",505,4,1,36,7,553
"Westminster","08:00:00","2018-04-26",187,1,0,22,2,212
"Brent","09:00:00","2018-04-26",363,28,50,115,11,567
"Camden","09:00:00","2018-04-26",445,54,69,172,39,779
"Kingston upon Thames","09:00:00","2018-04-26",1327,22,11,328,55,1743
"Lewisham","09:00:00","2018-04-26",205,8,0,82,14,309
"Sutton","09:00:00","2018-04-26",396,4,4,44,8,456
"Westminster","09:00:00","2018-04-26",86,3,0,22,2,113
"Brent","10:00:00","2018-04-26",316,18,52,105,9,500
"Camden","10:00:00","2018-04-26",476,47,76,158,20,777
"Kingston upon Thames","10:00:00","2018-04-26",1271,14,11,265,45,1606
"Lewisham","10:00:00","2018-04-26",214,7,0,98,16,335
"Sutton","10:00:00","2018-04-26",273,6,2,38,6,325
"Westminster","10:00:00","2018-04-26",77,2,0,30,1,110
"Brent","11:00:00","2018-04-26",336,34,48,115,12,545
"Camden","11:00:00","2018-04-26",398,56,66,178,14,712
"Kingston upon Thames","11:00:00","2018-04-26",1110,12,7,321,53,1503
"Lewisham","11:00:00","2018-04-26",226,3,0,107,22,358
"Sutton","11:00:00","2018-04-26",294,5,0,39,2,340
"Westminster","11:00:00","2018-04-26",62,2,0,23,0,87
"Brent","12:00:00","2018-04-26",296,27,48,100,6,477
"Camden","12:00:00","2018-04-26",408,48,68,194,27,745
"Kingston upon Thames","12:00:00","2018-04-26",1123,16,6,280,47,1472
"Lewisham","12:00:00","2018-04-26",263,2,0,105,23,393
"Sutton","12:00:00","2018-04-26",293,4,0,33,4,334
"Westminster","12:00:00","2018-04-26",69,1,0,27,1,98
"Brent","13:00:00","2018-04-26",363,26,45,103,1,538
"Camden","13:00:00","2018-04-26",410,53,64,155,20,702
"Kingston upon Thames","13:00:00","2018-04-26",1175,14,5,285,47,1526
"Lewisham","13:00:00","2018-04-26",282,4,0,105,17,408
"Sutton","13:00:00","2018-04-26",295,5,0,46,3,349
"Westminster","13:00:00","2018-04-26",74,3,0,28,0,105
"Brent","14:00:00","2018-04-26",388,23,58,104,6,579
"Camden","14:00:00","2018-04-26",347,58,67,184,20,676
"Kingston upon Thames","14:00:00","2018-04-26",1169,14,16,308,57,1564
"Lewisham","14:00:00","2018-04-26",266,9,0,136,34,445
"Sutton","14:00:00","2018-04-26",339,4,7,32,1,383
"Westminster","14:00:00","2018-04-26",84,3,0,18,1,106
"Brent","15:00:00","2018-04-26",426,30,55,116,5,632
"Camden","15:00:00","2018-04-26",492,53,76,192,16,829
"Kingston upon Thames","15:00:00","2018-04-26",1182,24,8,344,30,1588
"Lewisham","15:00:00","2018-04-26",312,15,0,112,25,464
"Sutton","15:00:00","2018-04-26",419,3,4,40,2,468
"Westminster","15:00:00","2018-04-26",115,2,0,20,0,137
"Brent","16:00:00","2018-04-26",480,34,46,152,2,714
"Camden","16:00:00","2018-04-26",511,58,72,128,7,776
"Kingston upon Thames","16:00:00","2018-04-26",1349,27,4,282,22,1684
"Lewisham","16:00:00","2018-04-26",303,21,0,123,10,457
"Sutton","16:00:00","2018-04-26",438,3,1,53,2,497
"Westminster","16:00:00","2018-04-26",109,3,0,19,1,132
"Brent","17:00:00","2018-04-26",525,36,46,114,4,725
"Camden","17:00:00","2018-04-26",518,101,69,91,6,785
"Kingston upon Thames","17:00:00","2018-04-26",1465,41,7,198,16,1727
"Lewisham","17:00:00","2018-04-26",269,15,0,76,10,370
"Sutton","17:00:00","2018-04-26",445,7,1,47,1,501
"Westminster","17:00:00","2018-04-26",109,5,0,15,0,129
"Brent","18:00:00","2018-04-26",531,51,51,91,1,725
"Camden","18:00:00","2018-04-26",608,82,72,76,4,842
"Kingston upon Thames","18:00:00","2018-04-26",1458,37,10,150,6,1661
"Lewisham","18:00:00","2018-04-26",305,20,0,60,17,402
"Sutton","18:00:00","2018-04-26",402,5,0,27,1,435
"Westminster","18:00:00","2018-04-26",118,6,0,13,1,138
"Brent","07:00:00","2018-04-27",2669,41,131,625,76,3542
"Enfield","07:00:00","2018-04-27",280,0,0,34,0,314
"Havering","07:00:00","2018-04-27",507,4,22,79,7,619
"Hillingdon","07:00:00","2018-04-27",189,0,6,7,2,204
"Kingston upon Thames","07:00:00","2018-04-27",6074,145,32,1587,238,8076
"Lambeth","07:00:00","2018-04-27",385,58,48,223,67,781
"Redbridge","07:00:00","2018-04-27",22,0,0,2,0,24
"Brent","08:00:00","2018-04-27",2985,63,101,445,71,3665
"Enfield","08:00:00","2018-04-27",339,1,0,46,0,386
"Havering","08:00:00","2018-04-27",953,8,33,80,11,1085
"Hillingdon","08:00:00","2018-04-27",321,0,9,14,2,346
"Kingston upon Thames","08:00:00","2018-04-27",7104,131,33,1331,240,8839
"Lambeth","08:00:00","2018-04-27",341,71,59,237,60,768
"Redbridge","08:00:00","2018-04-27",32,0,0,6,0,38
"Brent","09:00:00","2018-04-27",2743,51,123,480,98,3495
"Enfield","09:00:00","2018-04-27",236,0,0,33,0,269
"Havering","09:00:00","2018-04-27",719,2,34,91,14,860
"Hillingdon","09:00:00","2018-04-27",141,0,11,21,5,178
"Kingston upon Thames","09:00:00","2018-04-27",6061,75,32,1480,225,7873
"Lambeth","09:00:00","2018-04-27",431,41,58,235,43,808
"Redbridge","09:00:00","2018-04-27",21,0,0,4,0,25
"Brent","10:00:00","2018-04-27",2490,57,106,497,115,3265
"Enfield","10:00:00","2018-04-27",186,0,0,24,0,210
"Havering","10:00:00","2018-04-27",547,0,20,88,9,664
"Hillingdon","10:00:00","2018-04-27",90,0,4,13,1,108
"Kingston upon Thames","10:00:00","2018-04-27",5190,61,34,1283,275,6843
"Lambeth","10:00:00","2018-04-27",520,25,49,282,42,918
"Redbridge","10:00:00","2018-04-27",15,0,0,4,0,19
"Brent","11:00:00","2018-04-27",2490,55,96,543,106,3290
"Enfield","11:00:00","2018-04-27",153,0,0,26,0,179
"Havering","11:00:00","2018-04-27",613,0,24,75,11,723
"Hillingdon","11:00:00","2018-04-27",132,0,6,18,3,159
"Kingston upon Thames","11:00:00","2018-04-27",5976,42,27,1180,242,7467
"Lambeth","11:00:00","2018-04-27",494,26,52,284,62,918
"Redbridge","11:00:00","2018-04-27",6,0,0,9,0,15
"Brent","12:00:00","2018-04-27",2767,60,93,529,107,3556
"Enfield","12:00:00","2018-04-27",171,2,0,34,0,207
"Havering","12:00:00","2018-04-27",631,3,15,77,11,737
"Hillingdon","12:00:00","2018-04-27",132,0,5,19,0,156
"Kingston upon Thames","12:00:00","2018-04-27",5389,50,29,1350,172,6990
"Lambeth","12:00:00","2018-04-27",597,35,54,300,58,1044
"Redbridge","12:00:00","2018-04-27",16,0,0,3,0,19
"Brent","13:00:00","2018-04-27",2840,71,98,544,91,3644
"Enfield","13:00:00","2018-04-27",195,3,0,35,0,233
"Havering","13:00:00","2018-04-27",564,1,15,79,11,670
"Hillingdon","13:00:00","2018-04-27",107,2,6,10,0,125
"Kingston upon Thames","13:00:00","2018-04-27",4947,51,34,1232,199,6463
"Lambeth","13:00:00","2018-04-27",552,30,38,288,59,967
"Redbridge","13:00:00","2018-04-27",17,0,0,8,0,25
"Brent","14:00:00","2018-04-27",3074,59,106,491,69,3799
"Enfield","14:00:00","2018-04-27",156,0,0,31,0,187
"Havering","14:00:00","2018-04-27",680,3,26,100,9,818
"Hillingdon","14:00:00","2018-04-27",150,0,8,10,1,169
"Kingston upon Thames","14:00:00","2018-04-27",6062,46,30,1324,216,7678
"Lambeth","14:00:00","2018-04-27",487,27,44,296,44,898
"Redbridge","14:00:00","2018-04-27",19,0,0,1,0,20
"Brent","15:00:00","2018-04-27",3137,65,121,452,58,3833
"Enfield","15:00:00","2018-04-27",284,1,0,31,1,317
"Havering","15:00:00","2018-04-27",945,3,20,94,5,1067
"Hillingdon","15:00:00","2018-04-27",256,0,6,7,0,269
"Kingston upon Thames","15:00:00","2018-04-27",6730,48,41,1594,148,8561
"Lambeth","15:00:00","2018-04-27",535,50,60,259,38,942
"Redbridge","15:00:00","2018-04-27",27,0,0,4,0,31
"Brent","16:00:00","2018-04-27",3204,64,100,474,55,3897
"Enfield","16:00:00","2018-04-27",252,2,0,48,0,302
"Havering","16:00:00","2018-04-27",863,3,17,90,5,978
"Hillingdon","16:00:00","2018-04-27",207,0,5,12,1,225
"Kingston upon Thames","16:00:00","2018-04-27",7461,129,47,1402,78,9117
"Lambeth","16:00:00","2018-04-27",568,56,68,218,15,925
"Redbridge","16:00:00","2018-04-27",25,0,0,6,0,31
"Brent","17:00:00","2018-04-27",3251,78,92,493,28,3942
"Enfield","17:00:00","2018-04-27",291,0,0,38,0,329
"Havering","17:00:00","2018-04-27",866,6,19,89,1,981
"Hillingdon","17:00:00","2018-04-27",205,1,6,1,1,214
"Kingston upon Thames","17:00:00","2018-04-27",7303,143,31,1138,50,8665
"Lambeth","17:00:00","2018-04-27",608,89,50,178,18,943
"Redbridge","17:00:00","2018-04-27",21,0,0,4,0,25
"Brent","18:00:00","2018-04-27",3410,78,81,382,17,3968
"Enfield","18:00:00","2018-04-27",224,0,0,36,0,260
"Havering","18:00:00","2018-04-27",766,4,20,81,5,876
"Hillingdon","18:00:00","2018-04-27",147,0,7,3,0,157
"Kingston upon Thames","18:00:00","2018-04-27",7475,109,28,691,47,8350
"Lambeth","18:00:00","2018-04-27",769,76,41,129,3,1018
"Redbridge","18:00:00","2018-04-27",19,0,0,7,0,26
"Bexley","07:00:00","2018-04-30",1203,6,50,132,3,1394
"Camden","07:00:00","2018-04-30",369,70,55,208,30,732
"Enfield","07:00:00","2018-04-30",3285,72,8,1077,270,4712
"Hillingdon","07:00:00","2018-04-30",432,2,2,72,4,512
"Hounslow","07:00:00","2018-04-30",427,7,2,79,5,520
"Redbridge","07:00:00","2018-04-30",600,3,44,128,11,786
"Richmond upon Thames","07:00:00","2018-04-30",852,63,21,145,0,1081
"Tower Hamlets","07:00:00","2018-04-30",313,4,0,128,2,447
"Wandsworth","07:00:00","2018-04-30",21,0,0,3,0,24
"Bexley","08:00:00","2018-04-30",1655,6,63,147,6,1877
"Camden","08:00:00","2018-04-30",352,83,51,260,37,783
"Enfield","08:00:00","2018-04-30",2724,59,4,739,325,3851
"Hillingdon","08:00:00","2018-04-30",607,1,1,49,0,658
"Hounslow","08:00:00","2018-04-30",624,8,2,65,3,702
"Redbridge","08:00:00","2018-04-30",822,5,45,100,14,986
"Richmond upon Thames","08:00:00","2018-04-30",855,46,21,79,10,1011
"Tower Hamlets","08:00:00","2018-04-30",350,6,2,123,2,483
"Wandsworth","08:00:00","2018-04-30",32,1,2,6,1,42
"Bexley","09:00:00","2018-04-30",1061,1,64,138,8,1272
"Camden","09:00:00","2018-04-30",483,67,44,281,64,939
"Enfield","09:00:00","2018-04-30",2484,37,8,854,326,3709
"Hillingdon","09:00:00","2018-04-30",293,24,2,44,2,365
"Hounslow","09:00:00","2018-04-30",385,13,5,70,3,476
"Redbridge","09:00:00","2018-04-30",756,6,30,145,15,952
"Richmond upon Thames","09:00:00","2018-04-30",657,27,28,94,7,813
"Tower Hamlets","09:00:00","2018-04-30",348,5,2,128,2,485
"Wandsworth","09:00:00","2018-04-30",22,1,0,4,0,27
"Bexley","10:00:00","2018-04-30",839,2,71,105,7,1024
"Camden","10:00:00","2018-04-30",441,36,43,222,30,772
"Enfield","10:00:00","2018-04-30",2808,20,7,941,399,4175
"Hillingdon","10:00:00","2018-04-30",181,0,2,40,3,226
"Hounslow","10:00:00","2018-04-30",313,4,2,54,3,376
"Redbridge","10:00:00","2018-04-30",691,11,36,121,24,883
"Richmond upon Thames","10:00:00","2018-04-30",502,16,17,72,4,611
"Tower Hamlets","10:00:00","2018-04-30",326,6,4,133,2,471
"Wandsworth","10:00:00","2018-04-30",19,1,0,1,0,21
"Bexley","11:00:00","2018-04-30",877,1,61,118,13,1070
"Camden","11:00:00","2018-04-30",509,30,46,244,30,859
"Enfield","11:00:00","2018-04-30",3126,21,11,1055,487,4700
"Hillingdon","11:00:00","2018-04-30",192,0,1,37,4,234
"Hounslow","11:00:00","2018-04-30",332,4,1,52,2,391
"Redbridge","11:00:00","2018-04-30",643,4,34,94,13,788
"Richmond upon Thames","11:00:00","2018-04-30",434,9,18,110,4,575
"Tower Hamlets","11:00:00","2018-04-30",250,9,3,91,5,358
"Wandsworth","11:00:00","2018-04-30",22,1,0,6,0,29
"Bexley","12:00:00","2018-04-30",1072,3,78,112,14,1279
"Camden","12:00:00","2018-04-30",472,32,59,214,43,820
"Enfield","12:00:00","2018-04-30",3215,33,8,1082,503,4841
"Hillingdon","12:00:00","2018-04-30",205,6,1,37,3,252
"Hounslow","12:00:00","2018-04-30",312,2,1,75,0,390
"Redbridge","12:00:00","2018-04-30",808,10,32,109,12,971
"Richmond upon Thames","12:00:00","2018-04-30",488,14,24,86,3,615
"Tower Hamlets","12:00:00","2018-04-30",249,10,0,107,2,368
"Wandsworth","12:00:00","2018-04-30",24,3,0,7,0,34
"Bexley","13:00:00","2018-04-30",889,4,71,104,8,1076
"Camden","13:00:00","2018-04-30",481,32,51,170,34,768
"Enfield","13:00:00","2018-04-30",3633,27,8,1231,486,5385
"Hillingdon","13:00:00","2018-04-30",191,0,1,40,0,232
"Hounslow","13:00:00","2018-04-30",272,7,1,51,2,333
"Redbridge","13:00:00","2018-04-30",806,10,29,104,9,958
"Richmond upon Thames","13:00:00","2018-04-30",444,21,19,96,3,583
"Tower Hamlets","13:00:00","2018-04-30",240,7,0,79,2,328
"Wandsworth","13:00:00","2018-04-30",15,0,0,8,1,24
"Bexley","14:00:00","2018-04-30",971,7,69,129,6,1182
"Camden","14:00:00","2018-04-30",461,26,49,179,24,739
"Enfield","14:00:00","2018-04-30",4139,33,22,1297,425,5916
"Hillingdon","14:00:00","2018-04-30",244,1,1,34,0,280
"Hounslow","14:00:00","2018-04-30",269,5,4,59,0,337
"Redbridge","14:00:00","2018-04-30",804,6,34,103,22,969
"Richmond upon Thames","14:00:00","2018-04-30",479,10,19,83,0,591
"Tower Hamlets","14:00:00","2018-04-30",367,9,0,118,2,496
"Wandsworth","14:00:00","2018-04-30",12,1,0,3,0,16
"Bexley","15:00:00","2018-04-30",1499,2,62,142,6,1711
"Camden","15:00:00","2018-04-30",482,35,48,141,25,731
"Enfield","15:00:00","2018-04-30",4121,43,14,1291,339,5808
"Hillingdon","15:00:00","2018-04-30",295,3,3,46,2,349
"Hounslow","15:00:00","2018-04-30",360,5,3,64,2,434
"Redbridge","15:00:00","2018-04-30",911,6,30,120,18,1085
"Richmond upon Thames","15:00:00","2018-04-30",629,15,18,80,7,749
"Tower Hamlets","15:00:00","2018-04-30",474,11,4,147,0,636
"Wandsworth","15:00:00","2018-04-30",22,1,2,1,0,26
"Bexley","16:00:00","2018-04-30",1251,8,58,147,5,1469
"Camden","16:00:00","2018-04-30",483,42,64,122,20,731
"Enfield","16:00:00","2018-04-30",4588,71,15,1197,225,6096
"Hillingdon","16:00:00","2018-04-30",354,10,1,68,0,433
"Hounslow","16:00:00","2018-04-30",433,9,4,60,0,506
"Redbridge","16:00:00","2018-04-30",851,5,38,120,4,1018
"Richmond upon Thames","16:00:00","2018-04-30",679,29,20,125,2,855
"Tower Hamlets","16:00:00","2018-04-30",480,12,3,143,0,638
"Wandsworth","16:00:00","2018-04-30",30,4,0,3,0,37
"Bexley","17:00:00","2018-04-30",1541,9,64,181,4,1799
"Camden","17:00:00","2018-04-30",452,54,49,90,2,647
"Enfield","17:00:00","2018-04-30",4571,88,12,992,156,5819
"Hillingdon","17:00:00","2018-04-30",429,5,0,44,0,478
"Hounslow","17:00:00","2018-04-30",496,5,5,57,2,565
"Redbridge","17:00:00","2018-04-30",1009,2,38,128,4,1181
"Richmond upon Thames","17:00:00","2018-04-30",825,36,23,49,0,933
"Tower Hamlets","17:00:00","2018-04-30",508,9,0,113,2,632
"Wandsworth","17:00:00","2018-04-30",20,1,0,3,0,24
"Bexley","18:00:00","2018-04-30",1279,18,79,116,6,1498
"Camden","18:00:00","2018-04-30",528,66,47,73,6,720
"Enfield","18:00:00","2018-04-30",4626,78,13,736,130,5583
"Hillingdon","18:00:00","2018-04-30",353,1,0,36,0,390
"Hounslow","18:00:00","2018-04-30",443,12,0,30,0,485
"Redbridge","18:00:00","2018-04-30",1045,8,40,100,5,1198
"Richmond upon Thames","18:00:00","2018-04-30",548,12,20,35,0,615
"Tower Hamlets","18:00:00","2018-04-30",480,15,1,101,0,597
"Wandsworth","18:00:00","2018-04-30",23,3,0,2,0,28
"Bromley","07:00:00","2018-05-01",672,5,2,105,2,786
"Croydon","07:00:00","2018-05-01",69,1,0,7,0,77
"Richmond upon Thames","07:00:00","2018-05-01",1093,8,51,152,6,1310
"Bromley","08:00:00","2018-05-01",672,9,1,91,3,776
"Croydon","08:00:00","2018-05-01",107,2,0,10,1,120
"Richmond upon Thames","08:00:00","2018-05-01",988,19,35,121,13,1176
"Bromley","09:00:00","2018-05-01",360,4,2,77,5,448
"Croydon","09:00:00","2018-05-01",58,1,0,16,0,75
"Richmond upon Thames","09:00:00","2018-05-01",704,14,28,108,21,875
"Bromley","10:00:00","2018-05-01",299,10,0,54,8,371
"Croydon","10:00:00","2018-05-01",45,0,0,13,0,58
"Richmond upon Thames","10:00:00","2018-05-01",607,11,36,130,20,804
"Bromley","11:00:00","2018-05-01",317,2,0,71,3,393
"Croydon","11:00:00","2018-05-01",42,1,0,13,0,56
"Richmond upon Thames","11:00:00","2018-05-01",609,19,26,101,16,771
"Bromley","12:00:00","2018-05-01",311,3,0,65,10,389
"Croydon","12:00:00","2018-05-01",46,2,0,10,2,60
"Richmond upon Thames","12:00:00","2018-05-01",635,6,26,124,11,802
"Bromley","13:00:00","2018-05-01",324,1,1,72,6,404
"Croydon","13:00:00","2018-05-01",45,3,0,9,1,58
"Richmond upon Thames","13:00:00","2018-05-01",721,4,34,114,14,887
"Bromley","14:00:00","2018-05-01",328,11,2,73,12,426
"Croydon","14:00:00","2018-05-01",52,5,0,8,1,66
"Richmond upon Thames","14:00:00","2018-05-01",729,11,44,120,14,918
"Bromley","15:00:00","2018-05-01",467,8,1,86,1,563
"Croydon","15:00:00","2018-05-01",118,2,1,13,0,134
"Richmond upon Thames","15:00:00","2018-05-01",715,16,38,128,5,902
"Bromley","16:00:00","2018-05-01",514,8,3,115,4,644
"Croydon","16:00:00","2018-05-01",69,1,1,10,0,81
"Richmond upon Thames","16:00:00","2018-05-01",800,10,36,102,4,952
"Bromley","17:00:00","2018-05-01",623,9,3,76,0,711
"Croydon","17:00:00","2018-05-01",73,2,0,8,0,83
"Richmond upon Thames","17:00:00","2018-05-01",915,20,39,100,4,1078
"Bromley","18:00:00","2018-05-01",547,13,1,37,1,599
"Croydon","18:00:00","2018-05-01",56,1,0,11,0,68
"Richmond upon Thames","18:00:00","2018-05-01",907,18,20,60,1,1006
"Croydon","07:00:00","2018-05-02",104,1,0,18,0,123
"Ealing","07:00:00","2018-05-02",137,4,0,43,1,185
"Greenwich","07:00:00","2018-05-02",478,8,9,99,3,597
"Harrow","07:00:00","2018-05-02",386,0,2,32,4,424
"Hillingdon","07:00:00","2018-05-02",287,1,0,40,1,329
"Lambeth","07:00:00","2018-05-02",23,4,0,3,1,31
"Southwark","07:00:00","2018-05-02",384,24,7,155,1,571
"Croydon","08:00:00","2018-05-02",187,1,0,14,1,203
"Ealing","08:00:00","2018-05-02",299,4,2,42,5,352
"Greenwich","08:00:00","2018-05-02",604,5,15,63,7,694
"Harrow","08:00:00","2018-05-02",576,0,2,30,7,615
"Hillingdon","08:00:00","2018-05-02",645,3,0,50,14,712
"Lambeth","08:00:00","2018-05-02",18,0,0,2,0,20
"Southwark","08:00:00","2018-05-02",451,7,7,149,4,618
"Croydon","09:00:00","2018-05-02",71,2,0,7,1,81
"Ealing","09:00:00","2018-05-02",183,2,0,33,1,219
"Greenwich","09:00:00","2018-05-02",413,6,13,70,3,505
"Harrow","09:00:00","2018-05-02",258,0,0,30,1,289
"Hillingdon","09:00:00","2018-05-02",245,0,0,41,10,296
"Lambeth","09:00:00","2018-05-02",22,1,0,6,0,29
"Southwark","09:00:00","2018-05-02",391,10,5,165,2,573
"Croydon","10:00:00","2018-05-02",39,0,0,8,0,47
"Ealing","10:00:00","2018-05-02",101,2,0,31,5,139
"Greenwich","10:00:00","2018-05-02",271,11,11,60,5,358
"Harrow","10:00:00","2018-05-02",201,0,4,39,0,244
"Hillingdon","10:00:00","2018-05-02",148,0,0,54,6,208
"Lambeth","10:00:00","2018-05-02",10,2,0,6,0,18
"Southwark","10:00:00","2018-05-02",339,7,6,145,4,501
"Croydon","11:00:00","2018-05-02",40,0,0,9,0,49
"Ealing","11:00:00","2018-05-02",128,3,0,32,0,163
"Greenwich","11:00:00","2018-05-02",323,4,10,54,7,398
"Harrow","11:00:00","2018-05-02",179,2,0,34,3,218
"Hillingdon","11:00:00","2018-05-02",155,0,0,53,8,216
"Lambeth","11:00:00","2018-05-02",12,0,0,7,0,19
"Southwark","11:00:00","2018-05-02",268,2,5,116,5,396
"Croydon","12:00:00","2018-05-02",51,0,0,4,0,55
"Ealing","12:00:00","2018-05-02",153,3,0,34,1,191
"Greenwich","12:00:00","2018-05-02",285,7,9,60,8,369
"Harrow","12:00:00","2018-05-02",204,1,3,34,0,242
"Hillingdon","12:00:00","2018-05-02",185,1,0,54,8,248
"Lambeth","12:00:00","2018-05-02",18,1,0,8,1,28
"Southwark","12:00:00","2018-05-02",282,3,5,146,5,441
"Croydon","13:00:00","2018-05-02",59,0,0,4,0,63
"Ealing","13:00:00","2018-05-02",124,5,0,34,1,164
"Greenwich","13:00:00","2018-05-02",301,5,13,48,6,373
"Harrow","13:00:00","2018-05-02",206,0,1,29,1,237
"Hillingdon","13:00:00","2018-05-02",173,5,0,40,4,222
"Lambeth","13:00:00","2018-05-02",11,1,0,8,1,21
"Southwark","13:00:00","2018-05-02",293,14,4,144,2,457
"Croydon","14:00:00","2018-05-02",55,0,0,10,1,66
"Ealing","14:00:00","2018-05-02",166,5,2,23,2,198
"Greenwich","14:00:00","2018-05-02",332,6,10,56,6,410
"Harrow","14:00:00","2018-05-02",287,0,0,26,1,314
"Hillingdon","14:00:00","2018-05-02",196,0,0,47,6,249
"Lambeth","14:00:00","2018-05-02",15,1,0,6,0,22
"Southwark","14:00:00","2018-05-02",300,6,6,135,3,450
"Croydon","15:00:00","2018-05-02",173,1,0,11,3,188
"Ealing","15:00:00","2018-05-02",213,8,2,26,2,251
"Greenwich","15:00:00","2018-05-02",465,2,13,70,5,555
"Harrow","15:00:00","2018-05-02",466,0,2,36,0,504
"Hillingdon","15:00:00","2018-05-02",440,3,0,73,6,522
"Lambeth","15:00:00","2018-05-02",16,0,0,5,0,21
"Southwark","15:00:00","2018-05-02",440,12,5,125,3,585
"Croydon","16:00:00","2018-05-02",99,0,0,12,0,111
"Ealing","16:00:00","2018-05-02",177,3,0,43,1,224
"Greenwich","16:00:00","2018-05-02",496,10,22,113,2,643
"Harrow","16:00:00","2018-05-02",464,1,3,40,1,509
"Hillingdon","16:00:00","2018-05-02",497,5,0,70,3,575
"Lambeth","16:00:00","2018-05-02",17,0,0,5,0,22
"Southwark","16:00:00","2018-05-02",352,14,6,107,2,481
"Croydon","17:00:00","2018-05-02",108,0,0,10,0,118
"Ealing","17:00:00","2018-05-02",277,8,1,45,0,331
"Greenwich","17:00:00","2018-05-02",530,25,9,72,2,638
"Harrow","17:00:00","2018-05-02",403,3,2,29,0,437
"Hillingdon","17:00:00","2018-05-02",414,5,0,72,1,492
"Lambeth","17:00:00","2018-05-02",15,0,0,4,0,19
"Southwark","17:00:00","2018-05-02",396,20,5,110,2,533
"Croydon","18:00:00","2018-05-02",79,0,0,9,0,88
"Ealing","18:00:00","2018-05-02",240,6,1,24,1,272
"Greenwich","18:00:00","2018-05-02",535,9,7,63,1,615
"Harrow","18:00:00","2018-05-02",320,1,0,30,0,351
"Hillingdon","18:00:00","2018-05-02",395,1,0,41,0,437
"Lambeth","18:00:00","2018-05-02",16,1,0,4,0,21
"Southwark","18:00:00","2018-05-02",281,11,4,83,1,380
"Bromley","07:00:00","2018-05-03",31,0,0,4,0,35
"Hackney","07:00:00","2018-05-03",371,12,2,117,10,512
"Haringey","07:00:00","2018-05-03",806,24,49,243,34,1156
"Harrow","07:00:00","2018-05-03",85,1,1,15,1,103
"Havering","07:00:00","2018-05-03",77,1,6,24,1,109
"Merton","07:00:00","2018-05-03",628,36,58,206,15,943
"Sutton","07:00:00","2018-05-03",159,1,6,22,0,188
"Tower Hamlets","07:00:00","2018-05-03",36,6,0,16,3,61
"Wandsworth","07:00:00","2018-05-03",522,177,49,294,58,1100
"Westminster","07:00:00","2018-05-03",277,41,5,113,32,468
"Bromley","08:00:00","2018-05-03",37,0,0,4,0,41
"Hackney","08:00:00","2018-05-03",499,4,13,132,15,663
"Haringey","08:00:00","2018-05-03",781,23,56,194,42,1096
"Harrow","08:00:00","2018-05-03",231,0,3,22,1,257
"Havering","08:00:00","2018-05-03",88,0,6,10,0,104
"Merton","08:00:00","2018-05-03",706,37,62,154,30,989
"Sutton","08:00:00","2018-05-03",214,0,9,21,1,245
"Tower Hamlets","08:00:00","2018-05-03",63,3,0,28,6,100
"Wandsworth","08:00:00","2018-05-03",677,209,55,250,38,1229
"Westminster","08:00:00","2018-05-03",291,33,4,97,21,446
"Bromley","09:00:00","2018-05-03",41,0,0,4,1,46
"Hackney","09:00:00","2018-05-03",399,5,10,125,6,545
"Haringey","09:00:00","2018-05-03",809,14,45,224,34,1126
"Harrow","09:00:00","2018-05-03",146,2,1,22,2,173
"Havering","09:00:00","2018-05-03",109,0,17,22,0,148
"Merton","09:00:00","2018-05-03",529,16,63,128,28,764
"Sutton","09:00:00","2018-05-03",92,0,8,25,0,125
"Tower Hamlets","09:00:00","2018-05-03",48,5,1,23,4,81
"Wandsworth","09:00:00","2018-05-03",512,81,41,261,59,954
"Westminster","09:00:00","2018-05-03",300,32,1,102,25,460
"Bromley","10:00:00","2018-05-03",23,0,0,4,0,27
"Hackney","10:00:00","2018-05-03",356,4,10,106,10,486
"Haringey","10:00:00","2018-05-03",711,7,40,191,30,979
"Harrow","10:00:00","2018-05-03",77,4,2,13,2,98
"Havering","10:00:00","2018-05-03",102,0,10,28,0,140
"Merton","10:00:00","2018-05-03",483,16,68,147,29,743
"Sutton","10:00:00","2018-05-03",78,0,9,16,2,105
"Tower Hamlets","10:00:00","2018-05-03",47,4,0,26,11,88
"Wandsworth","10:00:00","2018-05-03",551,54,40,272,57,974
"Westminster","10:00:00","2018-05-03",330,25,1,114,31,501
"Bromley","11:00:00","2018-05-03",22,0,0,5,0,27
"Hackney","11:00:00","2018-05-03",294,4,3,93,14,408
"Haringey","11:00:00","2018-05-03",730,17,44,202,40,1033
"Harrow","11:00:00","2018-05-03",95,0,0,16,0,111
"Havering","11:00:00","2018-05-03",94,0,7,21,1,123
"Merton","11:00:00","2018-05-03",486,19,51,165,39,760
"Sutton","11:00:00","2018-05-03",82,0,8,13,0,103
"Tower Hamlets","11:00:00","2018-05-03",45,4,2,21,5,77
"Wandsworth","11:00:00","2018-05-03",526,54,35,273,40,928
"Westminster","11:00:00","2018-05-03",321,21,3,95,29,469
"Bromley","12:00:00","2018-05-03",36,1,0,4,1,42
"Hackney","12:00:00","2018-05-03",330,7,0,111,8,456
"Haringey","12:00:00","2018-05-03",711,14,39,204,33,1001
"Harrow","12:00:00","2018-05-03",83,0,0,14,0,97
"Havering","12:00:00","2018-05-03",70,1,7,13,0,91
"Merton","12:00:00","2018-05-03",556,43,56,161,22,838
"Sutton","12:00:00","2018-05-03",91,0,7,24,3,125
"Tower Hamlets","12:00:00","2018-05-03",58,8,0,29,9,104
"Wandsworth","12:00:00","2018-05-03",465,60,35,246,51,857
"Westminster","12:00:00","2018-05-03",288,25,1,94,34,442
"Bromley","13:00:00","2018-05-03",21,0,0,6,0,27
"Hackney","13:00:00","2018-05-03",363,15,1,103,11,493
"Haringey","13:00:00","2018-05-03",706,18,43,167,17,951
"Harrow","13:00:00","2018-05-03",104,4,0,21,0,129
"Havering","13:00:00","2018-05-03",69,0,6,6,0,81
"Merton","13:00:00","2018-05-03",560,40,59,147,30,836
"Sutton","13:00:00","2018-05-03",85,0,7,15,1,108
"Tower Hamlets","13:00:00","2018-05-03",62,5,1,28,6,102
"Wandsworth","13:00:00","2018-05-03",451,59,35,216,44,805
"Westminster","13:00:00","2018-05-03",347,32,3,113,30,525
"Bromley","14:00:00","2018-05-03",29,0,0,4,0,33
"Hackney","14:00:00","2018-05-03",330,6,4,100,20,460
"Haringey","14:00:00","2018-05-03",752,11,38,183,21,1005
"Harrow","14:00:00","2018-05-03",91,1,2,13,0,107
"Havering","14:00:00","2018-05-03",73,0,6,16,1,96
"Merton","14:00:00","2018-05-03",665,24,63,137,29,918
"Sutton","14:00:00","2018-05-03",109,0,8,18,0,135
"Tower Hamlets","14:00:00","2018-05-03",69,2,2,33,9,115
"Wandsworth","14:00:00","2018-05-03",558,66,43,243,37,947
"Westminster","14:00:00","2018-05-03",333,28,2,84,20,467
"Bromley","15:00:00","2018-05-03",22,0,0,9,0,31
"Hackney","15:00:00","2018-05-03",401,14,8,135,18,576
"Haringey","15:00:00","2018-05-03",859,14,40,191,27,1131
"Harrow","15:00:00","2018-05-03",130,0,4,15,0,149
"Havering","15:00:00","2018-05-03",101,1,10,15,1,128
"Merton","15:00:00","2018-05-03",638,23,60,158,25,904
"Sutton","15:00:00","2018-05-03",125,1,7,25,1,159
"Tower Hamlets","15:00:00","2018-05-03",61,5,1,31,7,105
"Wandsworth","15:00:00","2018-05-03",590,61,40,214,38,943
"Westminster","15:00:00","2018-05-03",370,39,4,103,13,529
"Bromley","16:00:00","2018-05-03",20,0,0,11,0,31
"Hackney","16:00:00","2018-05-03",485,28,17,122,10,662
"Haringey","16:00:00","2018-05-03",935,33,50,219,11,1248
"Harrow","16:00:00","2018-05-03",144,3,3,7,0,157
"Havering","16:00:00","2018-05-03",71,2,11,22,0,106
"Merton","16:00:00","2018-05-03",684,44,54,150,15,947
"Sutton","16:00:00","2018-05-03",120,0,9,22,1,152
"Tower Hamlets","16:00:00","2018-05-03",71,6,0,20,8,105
"Wandsworth","16:00:00","2018-05-03",580,86,42,187,17,912
"Westminster","16:00:00","2018-05-03",372,42,7,74,6,501
"Bromley","17:00:00","2018-05-03",31,0,0,6,0,37
"Hackney","17:00:00","2018-05-03",519,23,5,109,7,663
"Haringey","17:00:00","2018-05-03",918,34,52,147,16,1167
"Harrow","17:00:00","2018-05-03",198,0,1,16,0,215
"Havering","17:00:00","2018-05-03",109,1,9,34,0,153
"Merton","17:00:00","2018-05-03",772,52,63,133,2,1022
"Sutton","17:00:00","2018-05-03",170,0,8,24,0,202
"Tower Hamlets","17:00:00","2018-05-03",43,5,0,20,2,70
"Wandsworth","17:00:00","2018-05-03",662,154,33,144,23,1016
"Westminster","17:00:00","2018-05-03",329,35,4,62,6,436
"Bromley","18:00:00","2018-05-03",20,0,0,3,0,23
"Hackney","18:00:00","2018-05-03",589,20,2,74,3,688
"Haringey","18:00:00","2018-05-03",967,30,50,122,3,1172
"Harrow","18:00:00","2018-05-03",196,2,0,12,0,210
"Havering","18:00:00","2018-05-03",86,2,9,34,0,131
"Merton","18:00:00","2018-05-03",776,46,62,98,3,985
"Sutton","18:00:00","2018-05-03",131,3,7,17,1,159
"Tower Hamlets","18:00:00","2018-05-03",52,12,0,11,3,78
"Wandsworth","18:00:00","2018-05-03",740,216,51,117,17,1141
"Westminster","18:00:00","2018-05-03",443,55,7,53,2,560
"Ealing","07:00:00","2018-05-04",1993,70,73,309,121,2566
"Havering","07:00:00","2018-05-04",360,2,15,62,3,442
"Hillingdon","07:00:00","2018-05-04",1872,15,48,336,195,2466
"Newham","07:00:00","2018-05-04",919,12,100,187,32,1250
"Ealing","08:00:00","2018-05-04",2096,50,91,320,170,2727
"Havering","08:00:00","2018-05-04",565,6,18,50,4,643
"Hillingdon","08:00:00","2018-05-04",1520,15,54,337,245,2171
"Newham","08:00:00","2018-05-04",980,12,89,155,41,1277
"Ealing","09:00:00","2018-05-04",1810,32,85,401,173,2501
"Havering","09:00:00","2018-05-04",529,2,16,53,2,602
"Hillingdon","09:00:00","2018-05-04",868,8,41,273,197,1387
"Newham","09:00:00","2018-05-04",925,13,105,193,40,1276
"Ealing","10:00:00","2018-05-04",2061,27,75,512,235,2910
"Havering","10:00:00","2018-05-04",472,2,15,47,8,544
"Hillingdon","10:00:00","2018-05-04",826,7,52,285,211,1381
"Newham","10:00:00","2018-05-04",1014,15,100,195,33,1357
"Ealing","11:00:00","2018-05-04",2110,30,75,430,212,2857
"Havering","11:00:00","2018-05-04",494,10,16,62,6,588
"Hillingdon","11:00:00","2018-05-04",998,10,62,372,266,1708
"Newham","11:00:00","2018-05-04",891,26,85,195,43,1240
"Ealing","12:00:00","2018-05-04",2254,29,78,466,147,2974
"Havering","12:00:00","2018-05-04",407,3,11,61,7,489
"Hillingdon","12:00:00","2018-05-04",1182,13,52,344,242,1833
"Newham","12:00:00","2018-05-04",1008,28,100,174,38,1348
"Ealing","13:00:00","2018-05-04",2184,37,69,492,170,2952
"Havering","13:00:00","2018-05-04",496,6,14,78,6,600
"Hillingdon","13:00:00","2018-05-04",1460,21,59,332,261,2133
"Newham","13:00:00","2018-05-04",1059,30,104,179,32,1404
"Ealing","14:00:00","2018-05-04",2387,39,90,464,136,3116
"Havering","14:00:00","2018-05-04",513,12,15,68,9,617
"Hillingdon","14:00:00","2018-05-04",1615,16,64,372,272,2339
"Newham","14:00:00","2018-05-04",1017,34,96,147,31,1325
"Ealing","15:00:00","2018-05-04",2055,53,91,373,109,2681
"Havering","15:00:00","2018-05-04",592,7,19,76,9,703
"Hillingdon","15:00:00","2018-05-04",1603,17,47,332,214,2213
"Newham","15:00:00","2018-05-04",1204,39,82,139,28,1492
"Ealing","16:00:00","2018-05-04",1914,56,69,270,63,2372
"Havering","16:00:00","2018-05-04",513,4,18,74,1,610
"Hillingdon","16:00:00","2018-05-04",1908,19,49,363,171,2510
"Newham","16:00:00","2018-05-04",1199,33,94,148,22,1496
"Ealing","17:00:00","2018-05-04",1851,62,67,279,52,2311
"Havering","17:00:00","2018-05-04",581,3,14,60,1,659
"Hillingdon","17:00:00","2018-05-04",2069,20,68,293,153,2603
"Newham","17:00:00","2018-05-04",1005,29,95,116,9,1254
"Ealing","18:00:00","2018-05-04",1847,57,83,259,37,2283
"Havering","18:00:00","2018-05-04",520,6,14,56,1,597
"Hillingdon","18:00:00","2018-05-04",2025,10,60,211,145,2451
"Newham","18:00:00","2018-05-04",1184,41,95,118,4,1442
"Barking and Dagenham","07:00:00","2018-05-08",1008,18,18,241,51,1336
"Bromley","07:00:00","2018-05-08",137,0,4,15,0,156
"Croydon","07:00:00","2018-05-08",25,0,0,2,0,27
"Greenwich","07:00:00","2018-05-08",1124,39,31,203,50,1447
"Hillingdon","07:00:00","2018-05-08",8,0,0,0,0,8
"Hounslow","07:00:00","2018-05-08",1253,37,32,343,35,1700
"Tower Hamlets","07:00:00","2018-05-08",62,3,1,22,1,89
"Wandsworth","07:00:00","2018-05-08",947,102,8,374,54,1485
"Westminster","07:00:00","2018-05-08",482,22,51,178,14,747
"Barking and Dagenham","08:00:00","2018-05-08",906,5,28,205,30,1174
"Bromley","08:00:00","2018-05-08",218,0,4,26,1,249
"Croydon","08:00:00","2018-05-08",41,0,0,3,0,44
"Greenwich","08:00:00","2018-05-08",1225,21,22,202,53,1523
"Hillingdon","08:00:00","2018-05-08",13,1,0,0,0,14
"Hounslow","08:00:00","2018-05-08",1010,35,26,228,33,1332
"Tower Hamlets","08:00:00","2018-05-08",116,2,3,38,4,163
"Wandsworth","08:00:00","2018-05-08",911,108,6,287,37,1349
"Westminster","08:00:00","2018-05-08",678,20,59,130,23,910
"Barking and Dagenham","09:00:00","2018-05-08",850,5,25,197,50,1127
"Bromley","09:00:00","2018-05-08",164,1,4,26,4,199
"Croydon","09:00:00","2018-05-08",17,0,0,3,0,20
"Greenwich","09:00:00","2018-05-08",1162,20,40,289,50,1561
"Hillingdon","09:00:00","2018-05-08",16,0,0,3,1,20
"Hounslow","09:00:00","2018-05-08",1029,23,27,236,43,1358
"Tower Hamlets","09:00:00","2018-05-08",108,2,1,31,1,143
"Wandsworth","09:00:00","2018-05-08",994,59,7,350,64,1474
"Westminster","09:00:00","2018-05-08",604,34,54,186,13,891
"Barking and Dagenham","10:00:00","2018-05-08",856,5,14,241,43,1159
"Bromley","10:00:00","2018-05-08",136,0,4,33,6,179
"Croydon","10:00:00","2018-05-08",12,2,0,5,0,19
"Greenwich","10:00:00","2018-05-08",917,17,41,316,78,1369
"Hillingdon","10:00:00","2018-05-08",11,0,0,0,0,11
"Hounslow","10:00:00","2018-05-08",1045,26,34,326,59,1490
"Tower Hamlets","10:00:00","2018-05-08",79,4,2,30,7,122
"Wandsworth","10:00:00","2018-05-08",909,51,11,377,78,1426
"Westminster","10:00:00","2018-05-08",488,30,58,190,21,787
"Barking and Dagenham","11:00:00","2018-05-08",811,14,16,229,50,1120
"Bromley","11:00:00","2018-05-08",114,0,4,19,0,137
"Croydon","11:00:00","2018-05-08",12,0,0,3,0,15
"Greenwich","11:00:00","2018-05-08",920,13,23,291,87,1334
"Hillingdon","11:00:00","2018-05-08",13,0,0,2,0,15
"Hounslow","11:00:00","2018-05-08",1110,35,27,345,71,1588
"Tower Hamlets","11:00:00","2018-05-08",74,3,0,29,1,107
"Wandsworth","11:00:00","2018-05-08",903,39,9,399,74,1424
"Westminster","11:00:00","2018-05-08",510,41,65,140,18,774
"Barking and Dagenham","12:00:00","2018-05-08",888,7,18,207,54,1174
"Bromley","12:00:00","2018-05-08",174,0,4,43,0,221
"Croydon","12:00:00","2018-05-08",11,0,0,5,0,16
"Greenwich","12:00:00","2018-05-08",881,16,36,289,64,1286
"Hillingdon","12:00:00","2018-05-08",11,0,0,7,0,18
"Hounslow","12:00:00","2018-05-08",1078,28,24,313,72,1515
"Tower Hamlets","12:00:00","2018-05-08",81,6,6,23,4,120
"Wandsworth","12:00:00","2018-05-08",919,43,5,394,54,1415
"Westminster","12:00:00","2018-05-08",443,50,50,162,11,716
"Barking and Dagenham","13:00:00","2018-05-08",1007,8,16,199,62,1292
"Bromley","13:00:00","2018-05-08",124,2,4,23,4,157
"Croydon","13:00:00","2018-05-08",17,0,0,5,0,22
"Greenwich","13:00:00","2018-05-08",1035,13,34,354,76,1512
"Hillingdon","13:00:00","2018-05-08",4,1,0,6,0,11
"Hounslow","13:00:00","2018-05-08",1153,32,31,302,65,1583
"Tower Hamlets","13:00:00","2018-05-08",93,12,0,26,2,133
"Wandsworth","13:00:00","2018-05-08",1076,51,11,410,62,1610
"Westminster","13:00:00","2018-05-08",471,51,57,171,16,766
"Barking and Dagenham","14:00:00","2018-05-08",999,11,23,230,49,1312
"Bromley","14:00:00","2018-05-08",140,0,4,19,1,164
"Croydon","14:00:00","2018-05-08",23,0,0,0,0,23
"Greenwich","14:00:00","2018-05-08",1204,17,26,360,107,1714
"Hillingdon","14:00:00","2018-05-08",18,0,0,4,1,23
"Hounslow","14:00:00","2018-05-08",1116,34,33,291,40,1514
"Tower Hamlets","14:00:00","2018-05-08",122,7,0,22,2,153
"Wandsworth","14:00:00","2018-05-08",968,60,6,451,65,1550
"Westminster","14:00:00","2018-05-08",499,50,71,184,18,822
"Barking and Dagenham","15:00:00","2018-05-08",1108,10,27,204,40,1389
"Bromley","15:00:00","2018-05-08",159,1,3,23,1,187
"Croydon","15:00:00","2018-05-08",30,0,0,1,0,31
"Greenwich","15:00:00","2018-05-08",1382,30,39,343,88,1882
"Hillingdon","15:00:00","2018-05-08",25,0,0,5,0,30
"Hounslow","15:00:00","2018-05-08",1162,37,31,274,38,1542
"Tower Hamlets","15:00:00","2018-05-08",122,4,0,21,5,152
"Wandsworth","15:00:00","2018-05-08",1107,71,7,400,47,1632
"Westminster","15:00:00","2018-05-08",600,50,46,136,14,846
"Barking and Dagenham","16:00:00","2018-05-08",1166,16,20,215,31,1448
"Bromley","16:00:00","2018-05-08",183,2,5,22,0,212
"Croydon","16:00:00","2018-05-08",31,1,0,6,0,38
"Greenwich","16:00:00","2018-05-08",1182,33,46,310,41,1612
"Hillingdon","16:00:00","2018-05-08",11,0,0,3,0,14
"Hounslow","16:00:00","2018-05-08",1275,47,32,305,41,1700
"Tower Hamlets","16:00:00","2018-05-08",106,0,2,23,0,131
"Wandsworth","16:00:00","2018-05-08",1099,90,13,375,29,1606
"Westminster","16:00:00","2018-05-08",481,32,65,118,17,713
"Barking and Dagenham","17:00:00","2018-05-08",1066,18,16,170,14,1284
"Bromley","17:00:00","2018-05-08",174,3,4,30,0,211
"Croydon","17:00:00","2018-05-08",31,2,0,2,0,35
"Greenwich","17:00:00","2018-05-08",1284,31,37,304,39,1695
"Hillingdon","17:00:00","2018-05-08",22,1,0,2,0,25
"Hounslow","17:00:00","2018-05-08",1307,65,22,220,21,1635
"Tower Hamlets","17:00:00","2018-05-08",117,4,1,17,3,142
"Wandsworth","17:00:00","2018-05-08",1081,153,8,302,19,1563
"Westminster","17:00:00","2018-05-08",634,57,59,95,6,851
"Barking and Dagenham","18:00:00","2018-05-08",1113,11,17,144,12,1297
"Bromley","18:00:00","2018-05-08",203,2,4,14,0,223
"Croydon","18:00:00","2018-05-08",27,0,0,1,0,28
"Greenwich","18:00:00","2018-05-08",1477,57,49,248,37,1868
"Hillingdon","18:00:00","2018-05-08",13,0,0,3,0,16
"Hounslow","18:00:00","2018-05-08",1330,46,31,190,12,1609
"Tower Hamlets","18:00:00","2018-05-08",124,7,1,10,0,142
"Wandsworth","18:00:00","2018-05-08",1093,131,3,169,11,1407
"Westminster","18:00:00","2018-05-08",645,84,59,83,7,878
"Barking and Dagenham","07:00:00","2018-05-09",525,7,18,114,10,674
"Barnet","07:00:00","2018-05-09",90,3,0,14,0,107
"Bromley","07:00:00","2018-05-09",400,11,16,74,6,507
"Croydon","07:00:00","2018-05-09",158,4,1,17,1,181
"Hillingdon","07:00:00","2018-05-09",1571,22,4,259,41,1897
"Islington","07:00:00","2018-05-09",559,181,61,436,86,1323
"Redbridge","07:00:00","2018-05-09",49,1,5,9,0,64
"Southwark","07:00:00","2018-05-09",222,31,252,159,39,703
"Wandsworth","07:00:00","2018-05-09",206,5,0,71,1,283
"Westminster","07:00:00","2018-05-09",808,93,149,444,79,1573
"Barking and Dagenham","08:00:00","2018-05-09",673,3,17,72,9,774
"Barnet","08:00:00","2018-05-09",217,0,0,18,0,235
"Bromley","08:00:00","2018-05-09",431,9,22,59,12,533
"Croydon","08:00:00","2018-05-09",238,4,0,28,1,271
"Hillingdon","08:00:00","2018-05-09",1632,13,14,183,34,1876
"Islington","08:00:00","2018-05-09",533,147,52,499,109,1340
"Redbridge","08:00:00","2018-05-09",122,1,4,8,0,135
"Southwark","08:00:00","2018-05-09",225,22,267,156,50,720
"Wandsworth","08:00:00","2018-05-09",346,9,0,58,4,417
"Westminster","08:00:00","2018-05-09",831,97,163,375,107,1573
"Barking and Dagenham","09:00:00","2018-05-09",405,3,13,60,8,489
"Barnet","09:00:00","2018-05-09",64,1,0,3,0,68
"Bromley","09:00:00","2018-05-09",313,5,13,72,18,421
"Croydon","09:00:00","2018-05-09",119,1,0,22,0,142
"Hillingdon","09:00:00","2018-05-09",1319,11,9,199,40,1578
"Islington","09:00:00","2018-05-09",815,104,78,334,77,1408
"Redbridge","09:00:00","2018-05-09",72,1,5,10,1,89
"Southwark","09:00:00","2018-05-09",268,29,280,158,64,799
"Wandsworth","09:00:00","2018-05-09",233,9,2,80,6,330
"Westminster","09:00:00","2018-05-09",682,128,183,338,63,1394
"Barking and Dagenham","10:00:00","2018-05-09",344,3,12,67,15,441
"Barnet","10:00:00","2018-05-09",32,0,0,8,0,40
"Bromley","10:00:00","2018-05-09",302,6,12,57,12,389
"Croydon","10:00:00","2018-05-09",97,1,0,24,1,123
"Hillingdon","10:00:00","2018-05-09",834,15,5,180,44,1078
"Islington","10:00:00","2018-05-09",699,51,61,298,67,1176
"Redbridge","10:00:00","2018-05-09",57,2,7,9,0,75
"Southwark","10:00:00","2018-05-09",328,21,288,206,79,922
"Wandsworth","10:00:00","2018-05-09",163,7,5,44,5,224
"Westminster","10:00:00","2018-05-09",707,58,205,397,55,1422
"Barking and Dagenham","11:00:00","2018-05-09",358,8,18,66,7,457
"Barnet","11:00:00","2018-05-09",30,0,0,6,0,36
"Bromley","11:00:00","2018-05-09",303,6,13,77,8,407
"Croydon","11:00:00","2018-05-09",131,0,0,16,1,148
"Hillingdon","11:00:00","2018-05-09",891,8,5,166,29,1099
"Islington","11:00:00","2018-05-09",746,61,57,426,100,1390
"Redbridge","11:00:00","2018-05-09",41,0,5,7,0,53
"Southwark","11:00:00","2018-05-09",306,20,221,235,82,864
"Wandsworth","11:00:00","2018-05-09",181,5,2,47,4,239
"Westminster","11:00:00","2018-05-09",872,55,193,265,52,1437
"Barking and Dagenham","12:00:00","2018-05-09",365,8,12,69,11,465
"Barnet","12:00:00","2018-05-09",30,0,0,6,0,36
"Bromley","12:00:00","2018-05-09",319,6,20,72,14,431
"Croydon","12:00:00","2018-05-09",84,1,1,22,4,112
"Hillingdon","12:00:00","2018-05-09",899,13,3,161,34,1110
"Islington","12:00:00","2018-05-09",968,56,106,247,56,1433
"Redbridge","12:00:00","2018-05-09",42,0,5,6,0,53
"Southwark","12:00:00","2018-05-09",279,32,246,236,70,863
"Wandsworth","12:00:00","2018-05-09",176,8,6,61,4,255
"Westminster","12:00:00","2018-05-09",735,79,212,311,71,1408
"Barking and Dagenham","13:00:00","2018-05-09",372,4,9,56,10,451
"Barnet","13:00:00","2018-05-09",28,0,0,5,0,33
"Bromley","13:00:00","2018-05-09",343,12,20,75,7,457
"Croydon","13:00:00","2018-05-09",123,4,0,18,3,148
"Hillingdon","13:00:00","2018-05-09",930,19,2,155,25,1131
"Islington","13:00:00","2018-05-09",676,51,61,223,46,1057
"Redbridge","13:00:00","2018-05-09",36,2,6,13,2,59
"Southwark","13:00:00","2018-05-09",303,39,240,203,69,854
"Wandsworth","13:00:00","2018-05-09",195,6,0,67,2,270
"Westminster","13:00:00","2018-05-09",793,48,153,330,68,1392
"Barking and Dagenham","14:00:00","2018-05-09",417,4,16,65,6,508
"Barnet","14:00:00","2018-05-09",45,0,0,9,0,54
"Bromley","14:00:00","2018-05-09",346,9,22,53,4,434
"Croydon","14:00:00","2018-05-09",113,0,0,21,1,135
"Hillingdon","14:00:00","2018-05-09",1082,10,14,167,23,1296
"Islington","14:00:00","2018-05-09",756,53,60,445,80,1394
"Redbridge","14:00:00","2018-05-09",47,0,4,5,1,57
"Southwark","14:00:00","2018-05-09",330,54,283,201,62,930
"Wandsworth","14:00:00","2018-05-09",178,4,0,60,5,247
"Westminster","14:00:00","2018-05-09",796,50,186,272,67,1371
"Barking and Dagenham","15:00:00","2018-05-09",517,6,20,61,2,606
"Barnet","15:00:00","2018-05-09",142,0,0,10,0,152
"Bromley","15:00:00","2018-05-09",336,18,21,85,4,464
"Croydon","15:00:00","2018-05-09",129,3,0,27,1,160
"Hillingdon","15:00:00","2018-05-09",1432,10,24,222,28,1716
"Islington","15:00:00","2018-05-09",1105,74,111,173,33,1496
"Redbridge","15:00:00","2018-05-09",95,0,7,9,0,111
"Southwark","15:00:00","2018-05-09",299,74,254,217,40,884
"Wandsworth","15:00:00","2018-05-09",264,2,5,51,5,327
"Westminster","15:00:00","2018-05-09",742,78,208,325,39,1392
"Barking and Dagenham","16:00:00","2018-05-09",466,7,13,79,4,569
"Barnet","16:00:00","2018-05-09",77,1,0,13,0,91
"Bromley","16:00:00","2018-05-09",373,14,16,84,0,487
"Croydon","16:00:00","2018-05-09",161,5,0,24,0,190
"Hillingdon","16:00:00","2018-05-09",1280,15,8,215,20,1538
"Islington","16:00:00","2018-05-09",805,56,66,158,30,1115
"Redbridge","16:00:00","2018-05-09",79,0,5,6,0,90
"Southwark","16:00:00","2018-05-09",335,130,307,226,24,1022
"Wandsworth","16:00:00","2018-05-09",270,9,2,60,1,342
"Westminster","16:00:00","2018-05-09",791,71,168,266,35,1331
"Barking and Dagenham","17:00:00","2018-05-09",583,11,16,68,3,681
"Barnet","17:00:00","2018-05-09",75,1,0,13,0,89
"Bromley","17:00:00","2018-05-09",475,20,20,88,2,605
"Croydon","17:00:00","2018-05-09",161,7,0,16,0,184
"Hillingdon","17:00:00","2018-05-09",1308,13,2,130,10,1463
"Islington","17:00:00","2018-05-09",990,77,65,266,21,1419
"Redbridge","17:00:00","2018-05-09",94,4,6,9,0,113
"Southwark","17:00:00","2018-05-09",368,189,277,171,19,1024
"Wandsworth","17:00:00","2018-05-09",247,8,0,60,1,316
"Westminster","17:00:00","2018-05-09",886,61,171,238,22,1378
"Barking and Dagenham","18:00:00","2018-05-09",528,13,12,82,0,635
"Barnet","18:00:00","2018-05-09",75,0,0,8,0,83
"Bromley","18:00:00","2018-05-09",367,19,20,37,0,443
"Croydon","18:00:00","2018-05-09",179,7,0,25,0,211
"Hillingdon","18:00:00","2018-05-09",1146,22,3,102,3,1276
"Islington","18:00:00","2018-05-09",999,74,54,110,8,1245
"Redbridge","18:00:00","2018-05-09",57,2,5,9,0,73
"Southwark","18:00:00","2018-05-09",467,222,287,101,16,1093
"Wandsworth","18:00:00","2018-05-09",299,12,0,48,1,360
"Westminster","18:00:00","2018-05-09",934,52,164,189,19,1358
"Greenwich","07:00:00","2018-05-10",154,1,1,19,0,175
"Havering","07:00:00","2018-05-10",2781,25,12,775,127,3720
"Hillingdon","07:00:00","2018-05-10",1282,15,16,206,20,1539
"Lambeth","07:00:00","2018-05-10",473,46,18,166,14,717
"Westminster","07:00:00","2018-05-10",927,56,12,390,46,1431
"Greenwich","08:00:00","2018-05-10",238,0,2,18,0,258
"Havering","08:00:00","2018-05-10",2423,32,4,554,116,3129
"Hillingdon","08:00:00","2018-05-10",1530,9,21,172,13,1745
"Lambeth","08:00:00","2018-05-10",613,40,25,131,10,819
"Westminster","08:00:00","2018-05-10",1358,92,18,351,56,1875
"Greenwich","09:00:00","2018-05-10",154,1,0,30,1,186
"Havering","09:00:00","2018-05-10",2043,9,5,472,127,2656
"Hillingdon","09:00:00","2018-05-10",983,7,25,186,20,1221
"Lambeth","09:00:00","2018-05-10",500,19,22,126,12,679
"Westminster","09:00:00","2018-05-10",1196,65,16,366,84,1727
"Greenwich","10:00:00","2018-05-10",111,0,0,15,0,126
"Havering","10:00:00","2018-05-10",1771,23,7,444,143,2388
"Hillingdon","10:00:00","2018-05-10",713,3,16,146,26,904
"Lambeth","10:00:00","2018-05-10",397,12,28,125,17,579
"Westminster","10:00:00","2018-05-10",1149,51,20,397,76,1693
"Greenwich","11:00:00","2018-05-10",83,1,0,18,0,102
"Havering","11:00:00","2018-05-10",1763,19,3,497,147,2429
"Hillingdon","11:00:00","2018-05-10",758,5,21,162,28,974
"Lambeth","11:00:00","2018-05-10",351,16,21,95,11,494
"Westminster","11:00:00","2018-05-10",1131,64,16,413,72,1696
"Greenwich","12:00:00","2018-05-10",83,0,0,12,0,95
"Havering","12:00:00","2018-05-10",1750,9,0,524,117,2400
"Hillingdon","12:00:00","2018-05-10",906,9,20,160,24,1119
"Lambeth","12:00:00","2018-05-10",390,14,21,116,8,549
"Westminster","12:00:00","2018-05-10",1175,60,18,396,75,1724
"Greenwich","13:00:00","2018-05-10",109,2,0,16,0,127
"Havering","13:00:00","2018-05-10",1796,20,4,523,140,2483
"Hillingdon","13:00:00","2018-05-10",742,12,19,137,23,933
"Lambeth","13:00:00","2018-05-10",379,25,24,127,10,565
"Westminster","13:00:00","2018-05-10",1183,59,14,387,59,1702
"Greenwich","14:00:00","2018-05-10",139,0,0,17,0,156
"Havering","14:00:00","2018-05-10",2056,22,13,612,110,2813
"Hillingdon","14:00:00","2018-05-10",921,17,15,158,28,1139
"Lambeth","14:00:00","2018-05-10",427,24,25,122,10,608
"Westminster","14:00:00","2018-05-10",1182,71,23,366,50,1692
"Greenwich","15:00:00","2018-05-10",203,4,2,22,0,231
"Havering","15:00:00","2018-05-10",2155,23,8,655,101,2942
"Hillingdon","15:00:00","2018-05-10",1157,18,23,201,16,1415
"Lambeth","15:00:00","2018-05-10",540,29,27,125,7,728
"Westminster","15:00:00","2018-05-10",1275,48,16,401,35,1775
"Greenwich","16:00:00","2018-05-10",228,3,0,41,0,272
"Havering","16:00:00","2018-05-10",2662,19,13,728,68,3490
"Hillingdon","16:00:00","2018-05-10",1286,16,18,234,5,1559
"Lambeth","16:00:00","2018-05-10",583,32,25,143,4,787
"Westminster","16:00:00","2018-05-10",1449,94,13,387,25,1968
"Greenwich","17:00:00","2018-05-10",272,7,0,27,0,306
"Havering","17:00:00","2018-05-10",2961,41,3,479,51,3535
"Hillingdon","17:00:00","2018-05-10",1667,19,21,201,4,1912
"Lambeth","17:00:00","2018-05-10",598,58,21,106,1,784
"Westminster","17:00:00","2018-05-10",1507,81,22,297,21,1928
"Greenwich","18:00:00","2018-05-10",310,0,0,25,0,335
"Havering","18:00:00","2018-05-10",2612,33,3,360,47,3055
"Hillingdon","18:00:00","2018-05-10",1243,13,19,146,5,1426
"Lambeth","18:00:00","2018-05-10",588,49,22,77,2,738
"Westminster","18:00:00","2018-05-10",1650,124,17,181,9,1981
"Barnet","07:00:00","2018-05-11",1049,46,21,229,24,1369
"Bexley","07:00:00","2018-05-11",240,2,28,49,5,324
"Brent","07:00:00","2018-05-11",247,3,0,50,4,304
"Croydon","07:00:00","2018-05-11",349,7,0,86,5,447
"Lambeth","07:00:00","2018-05-11",167,9,1,49,3,229
"Lewisham","07:00:00","2018-05-11",570,89,92,216,88,1055
"Southwark","07:00:00","2018-05-11",195,103,123,157,30,608
"Sutton","07:00:00","2018-05-11",901,6,13,122,18,1060
"Tower Hamlets","07:00:00","2018-05-11",1633,317,15,835,341,3141
"Barnet","08:00:00","2018-05-11",1479,46,32,234,49,1840
"Bexley","08:00:00","2018-05-11",354,5,20,36,2,417
"Brent","08:00:00","2018-05-11",200,4,2,44,3,253
"Croydon","08:00:00","2018-05-11",368,4,1,64,1,438
"Lambeth","08:00:00","2018-05-11",267,10,0,56,7,340
"Lewisham","08:00:00","2018-05-11",534,72,96,203,83,988
"Southwark","08:00:00","2018-05-11",194,105,112,139,38,588
"Sutton","08:00:00","2018-05-11",903,11,6,109,23,1052
"Tower Hamlets","08:00:00","2018-05-11",1653,214,28,700,338,2933
"Barnet","09:00:00","2018-05-11",1273,34,27,236,58,1628
"Bexley","09:00:00","2018-05-11",318,2,28,48,7,403
"Brent","09:00:00","2018-05-11",256,9,0,47,6,318
"Croydon","09:00:00","2018-05-11",336,0,0,103,6,445
"Lambeth","09:00:00","2018-05-11",204,8,1,47,2,262
"Lewisham","09:00:00","2018-05-11",486,30,95,190,80,881
"Southwark","09:00:00","2018-05-11",229,70,121,127,52,599
"Sutton","09:00:00","2018-05-11",702,7,10,113,25,857
"Tower Hamlets","09:00:00","2018-05-11",1552,107,18,648,408,2733
"Barnet","10:00:00","2018-05-11",1234,18,24,278,36,1590
"Bexley","10:00:00","2018-05-11",304,6,21,40,3,374
"Brent","10:00:00","2018-05-11",135,3,0,29,4,171
"Croydon","10:00:00","2018-05-11",342,0,0,83,3,428
"Lambeth","10:00:00","2018-05-11",154,5,0,53,1,213
"Lewisham","10:00:00","2018-05-11",523,32,91,196,92,934
"Southwark","10:00:00","2018-05-11",243,40,112,145,47,587
"Sutton","10:00:00","2018-05-11",680,4,8,76,27,795
"Tower Hamlets","10:00:00","2018-05-11",1681,90,18,655,394,2838
"Barnet","11:00:00","2018-05-11",1036,36,17,210,42,1341
"Bexley","11:00:00","2018-05-11",307,8,25,36,5,381
"Brent","11:00:00","2018-05-11",84,6,0,21,2,113
"Croydon","11:00:00","2018-05-11",305,3,0,54,1,363
"Lambeth","11:00:00","2018-05-11",139,10,0,49,2,200
"Lewisham","11:00:00","2018-05-11",515,21,95,212,80,923
"Southwark","11:00:00","2018-05-11",211,55,106,161,49,582
"Sutton","11:00:00","2018-05-11",579,13,12,104,27,735
"Tower Hamlets","11:00:00","2018-05-11",1767,82,16,761,379,3005
"Barnet","12:00:00","2018-05-11",1304,30,18,268,39,1659
"Bexley","12:00:00","2018-05-11",294,6,22,46,8,376
"Brent","12:00:00","2018-05-11",103,1,0,12,1,117
"Croydon","12:00:00","2018-05-11",311,4,0,71,2,388
"Lambeth","12:00:00","2018-05-11",190,21,0,46,1,258
"Lewisham","12:00:00","2018-05-11",514,27,81,175,79,876
"Southwark","12:00:00","2018-05-11",293,58,112,158,48,669
"Sutton","12:00:00","2018-05-11",622,12,7,119,31,791
"Tower Hamlets","12:00:00","2018-05-11",1878,90,24,764,405,3161
"Barnet","13:00:00","2018-05-11",1339,26,21,244,38,1668
"Bexley","13:00:00","2018-05-11",354,5,17,35,1,412
"Brent","13:00:00","2018-05-11",97,1,0,16,2,116
"Croydon","13:00:00","2018-05-11",287,3,1,57,1,349
"Lambeth","13:00:00","2018-05-11",158,11,0,39,5,213
"Lewisham","13:00:00","2018-05-11",573,47,97,205,64,986
"Southwark","13:00:00","2018-05-11",327,70,111,162,29,699
"Sutton","13:00:00","2018-05-11",636,13,11,110,19,789
"Tower Hamlets","13:00:00","2018-05-11",1871,100,14,869,416,3270
"Barnet","14:00:00","2018-05-11",1262,32,19,186,27,1526
"Bexley","14:00:00","2018-05-11",327,3,25,52,2,409
"Brent","14:00:00","2018-05-11",84,2,0,16,3,105
"Croydon","14:00:00","2018-05-11",340,2,0,54,3,399
"Lambeth","14:00:00","2018-05-11",164,16,0,55,1,236
"Lewisham","14:00:00","2018-05-11",594,45,90,191,66,986
"Southwark","14:00:00","2018-05-11",218,47,113,126,36,540
"Sutton","14:00:00","2018-05-11",762,12,11,96,13,894
"Tower Hamlets","14:00:00","2018-05-11",2124,138,18,932,374,3586
"Barnet","15:00:00","2018-05-11",1335,36,23,225,21,1640
"Bexley","15:00:00","2018-05-11",445,3,19,54,3,524
"Brent","15:00:00","2018-05-11",115,2,0,19,0,136
"Croydon","15:00:00","2018-05-11",438,6,0,66,8,518
"Lambeth","15:00:00","2018-05-11",247,11,0,44,1,303
"Lewisham","15:00:00","2018-05-11",561,48,85,168,43,905
"Southwark","15:00:00","2018-05-11",285,79,116,149,16,645
"Sutton","15:00:00","2018-05-11",710,12,10,112,21,865
"Tower Hamlets","15:00:00","2018-05-11",2312,171,17,910,301,3711
"Barnet","16:00:00","2018-05-11",1604,45,25,262,12,1948
"Bexley","16:00:00","2018-05-11",419,3,24,59,6,511
"Brent","16:00:00","2018-05-11",79,2,1,17,0,99
"Croydon","16:00:00","2018-05-11",472,5,0,79,1,557
"Lambeth","16:00:00","2018-05-11",258,12,0,59,0,329
"Lewisham","16:00:00","2018-05-11",612,72,85,144,29,942
"Southwark","16:00:00","2018-05-11",293,102,111,96,13,615
"Sutton","16:00:00","2018-05-11",864,7,9,67,4,951
"Tower Hamlets","16:00:00","2018-05-11",2292,247,15,897,223,3674
"Barnet","17:00:00","2018-05-11",1588,57,22,210,11,1888
"Bexley","17:00:00","2018-05-11",415,5,17,53,0,490
"Brent","17:00:00","2018-05-11",103,3,0,23,0,129
"Croydon","17:00:00","2018-05-11",435,5,0,52,1,493
"Lambeth","17:00:00","2018-05-11",235,17,0,33,0,285
"Lewisham","17:00:00","2018-05-11",685,89,104,152,8,1038
"Southwark","17:00:00","2018-05-11",339,185,123,85,10,742
"Sutton","17:00:00","2018-05-11",819,26,8,80,6,939
"Tower Hamlets","17:00:00","2018-05-11",2617,329,17,653,157,3773
"Barnet","18:00:00","2018-05-11",1639,67,16,169,6,1897
"Bexley","18:00:00","2018-05-11",369,8,22,52,1,452
"Brent","18:00:00","2018-05-11",72,2,0,11,0,85
"Croydon","18:00:00","2018-05-11",432,5,0,42,0,479
"Lambeth","18:00:00","2018-05-11",273,40,0,24,0,337
"Lewisham","18:00:00","2018-05-11",749,85,82,97,10,1023
"Southwark","18:00:00","2018-05-11",464,148,108,60,5,785
"Sutton","18:00:00","2018-05-11",834,10,9,62,4,919
"Tower Hamlets","18:00:00","2018-05-11",2866,266,18,539,113,3802
"Bexley","07:00:00","2018-05-14",1580,20,9,298,39,1946
"Camden","07:00:00","2018-05-14",759,58,17,240,18,1092
"Ealing","07:00:00","2018-05-14",424,32,13,130,17,616
"Hammersmith and Fulham","07:00:00","2018-05-14",66,3,0,12,2,83
"Hounslow","07:00:00","2018-05-14",3024,87,63,531,100,3805
"Richmond upon Thames","07:00:00","2018-05-14",476,13,9,89,7,594
"Sutton","07:00:00","2018-05-14",107,0,1,20,0,128
"Tower Hamlets","07:00:00","2018-05-14",117,5,18,39,2,181
"Bexley","08:00:00","2018-05-14",1376,17,15,279,27,1714
"Camden","08:00:00","2018-05-14",949,48,16,186,20,1219
"Ealing","08:00:00","2018-05-14",532,22,12,135,24,725
"Hammersmith and Fulham","08:00:00","2018-05-14",134,8,3,23,0,168
"Hounslow","08:00:00","2018-05-14",3530,81,62,481,87,4241
"Richmond upon Thames","08:00:00","2018-05-14",652,12,5,87,11,767
"Sutton","08:00:00","2018-05-14",299,4,3,21,1,328
"Tower Hamlets","08:00:00","2018-05-14",180,10,21,55,1,267
"Bexley","09:00:00","2018-05-14",1357,6,6,281,48,1698
"Camden","09:00:00","2018-05-14",982,31,18,201,29,1261
"Ealing","09:00:00","2018-05-14",460,18,13,127,20,638
"Hammersmith and Fulham","09:00:00","2018-05-14",121,11,0,31,0,163
"Hounslow","09:00:00","2018-05-14",2685,64,50,470,122,3391
"Richmond upon Thames","09:00:00","2018-05-14",467,7,6,85,9,574
"Sutton","09:00:00","2018-05-14",139,1,3,17,3,163
"Tower Hamlets","09:00:00","2018-05-14",145,10,18,47,5,225
"Bexley","10:00:00","2018-05-14",1242,13,10,269,48,1582
"Camden","10:00:00","2018-05-14",823,35,21,212,27,1118
"Ealing","10:00:00","2018-05-14",429,16,12,158,16,631
"Hammersmith and Fulham","10:00:00","2018-05-14",91,3,0,25,2,121
"Hounslow","10:00:00","2018-05-14",1957,33,52,419,126,2587
"Richmond upon Thames","10:00:00","2018-05-14",439,4,5,102,9,559
"Sutton","10:00:00","2018-05-14",78,0,2,16,2,98
"Tower Hamlets","10:00:00","2018-05-14",105,10,18,46,5,184
"Bexley","11:00:00","2018-05-14",1081,8,6,261,47,1403
"Camden","11:00:00","2018-05-14",924,32,17,257,30,1260
"Ealing","11:00:00","2018-05-14",361,12,15,128,27,543
"Hammersmith and Fulham","11:00:00","2018-05-14",86,3,0,22,2,113
"Hounslow","11:00:00","2018-05-14",1967,30,50,627,144,2818
"Richmond upon Thames","11:00:00","2018-05-14",437,9,6,111,7,570
"Sutton","11:00:00","2018-05-14",67,2,0,14,3,86
"Tower Hamlets","11:00:00","2018-05-14",112,4,19,43,3,181
"Bexley","12:00:00","2018-05-14",1096,10,4,234,36,1380
"Camden","12:00:00","2018-05-14",993,32,20,234,24,1303
"Ealing","12:00:00","2018-05-14",400,18,13,125,22,578
"Hammersmith and Fulham","12:00:00","2018-05-14",97,6,0,21,0,124
"Hounslow","12:00:00","2018-05-14",2196,45,55,449,111,2856
"Richmond upon Thames","12:00:00","2018-05-14",427,14,8,79,8,536
"Sutton","12:00:00","2018-05-14",94,0,0,16,0,110
"Tower Hamlets","12:00:00","2018-05-14",146,12,18,39,3,218
"Bexley","13:00:00","2018-05-14",1189,11,9,290,60,1559
"Camden","13:00:00","2018-05-14",905,27,22,224,19,1197
"Ealing","13:00:00","2018-05-14",388,13,13,118,23,555
"Hammersmith and Fulham","13:00:00","2018-05-14",89,10,0,21,0,120
"Hounslow","13:00:00","2018-05-14",2062,30,47,380,114,2633
"Richmond upon Thames","13:00:00","2018-05-14",433,12,5,85,7,542
"Sutton","13:00:00","2018-05-14",58,0,0,12,2,72
"Tower Hamlets","13:00:00","2018-05-14",139,5,16,33,2,195
"Bexley","14:00:00","2018-05-14",1106,15,8,286,50,1465
"Camden","14:00:00","2018-05-14",1000,44,17,241,22,1324
"Ealing","14:00:00","2018-05-14",399,18,15,117,22,571
"Hammersmith and Fulham","14:00:00","2018-05-14",106,6,0,29,0,141
"Hounslow","14:00:00","2018-05-14",2104,42,41,446,71,2704
"Richmond upon Thames","14:00:00","2018-05-14",509,6,6,91,12,624
"Sutton","14:00:00","2018-05-14",118,0,2,15,0,135
"Tower Hamlets","14:00:00","2018-05-14",172,13,19,47,2,253
"Bexley","15:00:00","2018-05-14",1221,11,5,265,32,1534
"Camden","15:00:00","2018-05-14",1216,36,19,252,24,1547
"Ealing","15:00:00","2018-05-14",504,15,14,104,22,659
"Hammersmith and Fulham","15:00:00","2018-05-14",142,6,3,29,1,181
"Hounslow","15:00:00","2018-05-14",2867,52,58,527,100,3604
"Richmond upon Thames","15:00:00","2018-05-14",525,6,3,101,6,641
"Sutton","15:00:00","2018-05-14",243,0,4,13,0,260
"Tower Hamlets","15:00:00","2018-05-14",213,6,18,41,4,282
"Bexley","16:00:00","2018-05-14",1329,21,9,283,9,1651
"Camden","16:00:00","2018-05-14",1094,45,25,270,11,1445
"Ealing","16:00:00","2018-05-14",458,25,13,94,10,600
"Hammersmith and Fulham","16:00:00","2018-05-14",162,2,0,25,1,190
"Hounslow","16:00:00","2018-05-14",2850,70,57,420,62,3459
"Richmond upon Thames","16:00:00","2018-05-14",675,15,7,108,2,807
"Sutton","16:00:00","2018-05-14",115,0,0,21,0,136
"Tower Hamlets","16:00:00","2018-05-14",145,5,16,36,0,202
"Bexley","17:00:00","2018-05-14",1432,23,6,230,5,1696
"Camden","17:00:00","2018-05-14",1268,52,24,228,8,1580
"Ealing","17:00:00","2018-05-14",476,26,13,61,15,591
"Hammersmith and Fulham","17:00:00","2018-05-14",168,14,0,24,0,206
"Hounslow","17:00:00","2018-05-14",3070,113,50,493,41,3767
"Richmond upon Thames","17:00:00","2018-05-14",705,15,4,89,9,822
"Sutton","17:00:00","2018-05-14",144,1,0,18,0,163
"Tower Hamlets","17:00:00","2018-05-14",184,8,19,37,4,252
"Bexley","18:00:00","2018-05-14",1149,22,6,114,7,1298
"Camden","18:00:00","2018-05-14",1193,61,17,115,7,1393
"Ealing","18:00:00","2018-05-14",569,44,15,65,5,698
"Hammersmith and Fulham","18:00:00","2018-05-14",149,10,0,11,0,170
"Hounslow","18:00:00","2018-05-14",2833,73,55,346,46,3353
"Richmond upon Thames","18:00:00","2018-05-14",584,10,5,57,5,661
"Sutton","18:00:00","2018-05-14",90,2,0,11,0,103
"Tower Hamlets","18:00:00","2018-05-14",199,14,17,16,1,247
"Ealing","07:00:00","2018-05-15",721,48,33,209,40,1051
"Hackney","07:00:00","2018-05-15",569,78,97,240,37,1021
"Haringey","07:00:00","2018-05-15",201,3,10,42,1,257
"Hounslow","07:00:00","2018-05-15",849,17,40,191,10,1107
"Islington","07:00:00","2018-05-15",877,213,211,613,126,2040
"Lambeth","07:00:00","2018-05-15",22,0,0,11,0,33
"Merton","07:00:00","2018-05-15",1104,79,10,301,32,1526
"Waltham Forest","07:00:00","2018-05-15",158,0,0,37,3,198
"Wandsworth","07:00:00","2018-05-15",128,32,29,44,2,235
"Ealing","08:00:00","2018-05-15",717,42,33,193,36,1021
"Hackney","08:00:00","2018-05-15",726,97,84,295,30,1232
"Haringey","08:00:00","2018-05-15",304,8,10,45,2,369
"Hounslow","08:00:00","2018-05-15",933,12,34,105,10,1094
"Lambeth","08:00:00","2018-05-15",22,1,0,7,0,30
"Merton","08:00:00","2018-05-15",1381,44,5,230,40,1700
"Waltham Forest","08:00:00","2018-05-15",270,1,0,60,3,334
"Wandsworth","08:00:00","2018-05-15",133,19,26,50,0,228
"Ealing","09:00:00","2018-05-15",629,28,28,236,44,965
"Hackney","09:00:00","2018-05-15",754,53,83,231,37,1158
"Haringey","09:00:00","2018-05-15",227,2,12,48,4,293
"Hounslow","09:00:00","2018-05-15",646,4,30,117,12,809
"Islington","09:00:00","2018-05-15",951,253,212,476,127,2019
"Lambeth","09:00:00","2018-05-15",38,0,0,10,0,48
"Merton","09:00:00","2018-05-15",1159,21,11,255,59,1505
"Waltham Forest","09:00:00","2018-05-15",262,1,0,60,7,330
"Wandsworth","09:00:00","2018-05-15",83,7,28,39,1,158
"Ealing","10:00:00","2018-05-15",481,24,38,196,52,791
"Hackney","10:00:00","2018-05-15",652,37,84,270,37,1080
"Haringey","10:00:00","2018-05-15",131,3,12,22,7,175
"Hounslow","10:00:00","2018-05-15",487,7,29,88,17,628
"Lambeth","10:00:00","2018-05-15",34,1,1,10,3,49
"Merton","10:00:00","2018-05-15",974,17,8,252,62,1313
"Waltham Forest","10:00:00","2018-05-15",216,3,0,63,6,288
"Wandsworth","10:00:00","2018-05-15",91,4,24,28,6,153
"Ealing","11:00:00","2018-05-15",537,44,37,213,45,876
"Hackney","11:00:00","2018-05-15",764,54,85,278,37,1218
"Haringey","11:00:00","2018-05-15",151,4,10,42,1,208
"Hounslow","11:00:00","2018-05-15",484,7,24,90,10,615
"Lambeth","11:00:00","2018-05-15",44,0,0,10,0,54
"Merton","11:00:00","2018-05-15",1135,29,9,211,73,1457
"Waltham Forest","11:00:00","2018-05-15",194,3,0,44,4,245
"Wandsworth","11:00:00","2018-05-15",101,12,22,41,1,177
"Ealing","12:00:00","2018-05-15",588,30,40,189,51,898
"Hackney","12:00:00","2018-05-15",616,46,78,235,38,1013
"Haringey","12:00:00","2018-05-15",158,2,9,53,0,222
"Hounslow","12:00:00","2018-05-15",522,7,22,96,6,653
"Lambeth","12:00:00","2018-05-15",27,0,0,4,0,31
"Merton","12:00:00","2018-05-15",1154,33,8,233,63,1491
"Waltham Forest","12:00:00","2018-05-15",172,3,0,31,3,209
"Wandsworth","12:00:00","2018-05-15",127,18,25,45,3,218
"Ealing","13:00:00","2018-05-15",584,45,46,175,44,894
"Hackney","13:00:00","2018-05-15",681,44,86,223,34,1068
"Haringey","13:00:00","2018-05-15",146,5,11,45,2,209
"Hounslow","13:00:00","2018-05-15",544,3,33,83,18,681
"Lambeth","13:00:00","2018-05-15",23,1,0,4,5,33
"Merton","13:00:00","2018-05-15",1105,21,6,206,36,1374
"Waltham Forest","13:00:00","2018-05-15",174,4,0,41,1,220
"Wandsworth","13:00:00","2018-05-15",95,12,26,26,2,161
"Ealing","14:00:00","2018-05-15",588,51,46,220,52,957
"Hackney","14:00:00","2018-05-15",840,57,78,229,35,1239
"Haringey","14:00:00","2018-05-15",164,3,9,60,0,236
"Hounslow","14:00:00","2018-05-15",638,13,42,102,13,808
"Islington","14:00:00","2018-05-15",993,213,201,499,78,1984
"Lambeth","14:00:00","2018-05-15",29,1,0,9,2,41
"Merton","14:00:00","2018-05-15",1112,30,9,221,50,1422
"Waltham Forest","14:00:00","2018-05-15",200,1,0,61,0,262
"Wandsworth","14:00:00","2018-05-15",103,12,25,36,2,178
"Ealing","15:00:00","2018-05-15",735,47,47,184,43,1056
"Hackney","15:00:00","2018-05-15",741,48,78,200,23,1090
"Haringey","15:00:00","2018-05-15",261,10,12,53,0,336
"Hounslow","15:00:00","2018-05-15",774,10,29,106,4,923
"Lambeth","15:00:00","2018-05-15",23,1,0,8,2,34
"Merton","15:00:00","2018-05-15",1296,41,8,219,33,1597
"Waltham Forest","15:00:00","2018-05-15",241,5,0,50,0,296
"Wandsworth","15:00:00","2018-05-15",101,15,23,39,1,179
"Ealing","16:00:00","2018-05-15",799,75,42,239,31,1186
"Hackney","16:00:00","2018-05-15",813,76,96,231,19,1235
"Haringey","16:00:00","2018-05-15",245,8,10,52,2,317
"Hounslow","16:00:00","2018-05-15",589,16,35,127,11,778
"Lambeth","16:00:00","2018-05-15",34,1,0,6,0,41
"Merton","16:00:00","2018-05-15",1195,45,9,224,20,1493
"Waltham Forest","16:00:00","2018-05-15",271,8,0,44,1,324
"Wandsworth","16:00:00","2018-05-15",92,22,30,26,1,171
"Ealing","17:00:00","2018-05-15",906,60,33,190,14,1203
"Hackney","17:00:00","2018-05-15",943,117,75,180,9,1324
"Haringey","17:00:00","2018-05-15",297,10,12,32,0,351
"Hounslow","17:00:00","2018-05-15",814,16,30,110,6,976
"Lambeth","17:00:00","2018-05-15",26,1,0,10,0,37
"Merton","17:00:00","2018-05-15",1350,70,6,178,15,1619
"Waltham Forest","17:00:00","2018-05-15",228,1,0,32,0,261
"Wandsworth","17:00:00","2018-05-15",103,32,24,20,1,180
"Ealing","18:00:00","2018-05-15",821,59,35,132,10,1057
"Hackney","18:00:00","2018-05-15",1002,87,86,132,4,1311
"Haringey","18:00:00","2018-05-15",275,11,9,24,0,319
"Hounslow","18:00:00","2018-05-15",678,19,45,101,10,853
"Lambeth","18:00:00","2018-05-15",28,4,0,6,0,38
"Merton","18:00:00","2018-05-15",1252,68,6,157,9,1492
"Waltham Forest","18:00:00","2018-05-15",238,3,0,26,0,267
"Wandsworth","18:00:00","2018-05-15",155,50,26,9,0,240
"Barnet","07:00:00","2018-05-16",35,0,0,12,0,47
"Bexley","07:00:00","2018-05-16",81,1,0,7,0,89
"Enfield","07:00:00","2018-05-16",97,0,1,6,0,104
"Hackney","07:00:00","2018-05-16",154,0,2,35,2,193
"Islington","07:00:00","2018-05-16",62,2,0,18,1,83
"Merton","07:00:00","2018-05-16",1060,89,98,296,44,1587
"Southwark","07:00:00","2018-05-16",998,281,161,551,82,2073
"Wandsworth","07:00:00","2018-05-16",281,12,2,46,3,344
"Barnet","08:00:00","2018-05-16",97,0,0,16,0,113
"Bexley","08:00:00","2018-05-16",99,0,0,7,0,106
"Enfield","08:00:00","2018-05-16",133,0,0,7,1,141
"Hackney","08:00:00","2018-05-16",249,4,7,72,1,333
"Islington","08:00:00","2018-05-16",81,3,3,17,6,110
"Merton","08:00:00","2018-05-16",1067,72,92,189,38,1458
"Southwark","08:00:00","2018-05-16",1035,357,157,527,66,2142
"Wandsworth","08:00:00","2018-05-16",433,14,2,78,4,531
"Barnet","09:00:00","2018-05-16",42,1,0,11,0,54
"Bexley","09:00:00","2018-05-16",63,2,0,11,0,76
"Enfield","09:00:00","2018-05-16",73,0,0,7,3,83
"Hackney","09:00:00","2018-05-16",261,3,3,61,4,332
"Islington","09:00:00","2018-05-16",70,1,0,26,5,102
"Merton","09:00:00","2018-05-16",886,34,97,225,57,1299
"Southwark","09:00:00","2018-05-16",945,243,168,483,93,1932
"Wandsworth","09:00:00","2018-05-16",256,8,0,64,5,333
"Barnet","10:00:00","2018-05-16",45,1,1,13,1,61
"Bexley","10:00:00","2018-05-16",48,0,1,14,0,63
"Enfield","10:00:00","2018-05-16",34,0,0,7,2,43
"Hackney","10:00:00","2018-05-16",164,4,1,50,1,220
"Islington","10:00:00","2018-05-16",48,4,0,21,5,78
"Merton","10:00:00","2018-05-16",861,31,102,252,75,1321
"Southwark","10:00:00","2018-05-16",926,110,158,488,96,1778
"Wandsworth","10:00:00","2018-05-16",186,3,0,67,5,261
"Barnet","11:00:00","2018-05-16",48,1,0,13,0,62
"Bexley","11:00:00","2018-05-16",53,1,0,6,0,60
"Enfield","11:00:00","2018-05-16",37,0,0,4,0,41
"Hackney","11:00:00","2018-05-16",152,13,1,51,1,218
"Islington","11:00:00","2018-05-16",68,2,0,27,1,98
"Merton","11:00:00","2018-05-16",869,30,92,275,50,1316
"Southwark","11:00:00","2018-05-16",1088,148,160,622,104,2122
"Wandsworth","11:00:00","2018-05-16",173,4,0,70,2,249
"Barnet","12:00:00","2018-05-16",49,2,1,7,2,61
"Bexley","12:00:00","2018-05-16",51,0,0,11,0,62
"Enfield","12:00:00","2018-05-16",44,0,0,7,1,52
"Hackney","12:00:00","2018-05-16",138,2,1,30,4,175
"Islington","12:00:00","2018-05-16",48,4,0,14,5,71
"Merton","12:00:00","2018-05-16",801,27,87,226,55,1196
"Southwark","12:00:00","2018-05-16",1005,109,143,613,75,1945
"Wandsworth","12:00:00","2018-05-16",184,8,0,57,3,252
"Barnet","13:00:00","2018-05-16",57,2,0,15,1,75
"Bexley","13:00:00","2018-05-16",53,0,0,6,0,59
"Enfield","13:00:00","2018-05-16",43,0,0,7,0,50
"Hackney","13:00:00","2018-05-16",173,6,1,42,2,224
"Islington","13:00:00","2018-05-16",48,3,0,12,3,66
"Merton","13:00:00","2018-05-16",867,24,104,256,47,1298
"Southwark","13:00:00","2018-05-16",1033,119,150,575,62,1939
"Wandsworth","13:00:00","2018-05-16",190,8,0,59,2,259
"Barnet","14:00:00","2018-05-16",56,0,0,11,2,69
"Bexley","14:00:00","2018-05-16",48,0,0,4,0,52
"Enfield","14:00:00","2018-05-16",38,0,0,9,0,47
"Hackney","14:00:00","2018-05-16",149,6,0,35,0,190
"Islington","14:00:00","2018-05-16",69,3,0,27,1,100
"Merton","14:00:00","2018-05-16",1025,30,104,223,58,1440
"Southwark","14:00:00","2018-05-16",1214,122,139,617,58,2150
"Wandsworth","14:00:00","2018-05-16",267,6,0,82,3,358
"Barnet","15:00:00","2018-05-16",86,2,1,18,2,109
"Bexley","15:00:00","2018-05-16",92,4,0,4,0,100
"Enfield","15:00:00","2018-05-16",79,0,0,9,0,88
"Hackney","15:00:00","2018-05-16",205,1,6,70,0,282
"Islington","15:00:00","2018-05-16",89,2,1,26,1,119
"Merton","15:00:00","2018-05-16",955,37,102,234,54,1382
"Southwark","15:00:00","2018-05-16",1185,175,153,535,49,2097
"Wandsworth","15:00:00","2018-05-16",306,12,0,68,0,386
"Barnet","16:00:00","2018-05-16",92,0,3,8,0,103
"Bexley","16:00:00","2018-05-16",85,0,0,17,0,102
"Enfield","16:00:00","2018-05-16",77,0,0,10,0,87
"Hackney","16:00:00","2018-05-16",225,4,4,56,0,289
"Islington","16:00:00","2018-05-16",69,4,0,15,3,91
"Merton","16:00:00","2018-05-16",964,73,95,209,36,1377
"Southwark","16:00:00","2018-05-16",1201,223,161,477,50,2112
"Wandsworth","16:00:00","2018-05-16",240,10,0,65,0,315
"Barnet","17:00:00","2018-05-16",108,1,1,22,0,132
"Bexley","17:00:00","2018-05-16",99,1,0,10,0,110
"Enfield","17:00:00","2018-05-16",105,0,0,10,0,115
"Hackney","17:00:00","2018-05-16",263,11,3,59,0,336
"Islington","17:00:00","2018-05-16",87,3,2,15,1,108
"Merton","17:00:00","2018-05-16",960,71,97,211,20,1359
"Southwark","17:00:00","2018-05-16",1387,332,142,382,21,2264
"Wandsworth","17:00:00","2018-05-16",266,18,1,37,0,322
"Barnet","18:00:00","2018-05-16",108,2,0,9,0,119
"Bexley","18:00:00","2018-05-16",92,1,0,6,0,99
"Enfield","18:00:00","2018-05-16",96,0,1,4,0,101
"Hackney","18:00:00","2018-05-16",248,18,1,45,0,312
"Islington","18:00:00","2018-05-16",79,5,0,16,0,100
"Merton","18:00:00","2018-05-16",1078,66,92,143,9,1388
"Southwark","18:00:00","2018-05-16",1438,360,162,247,14,2221
"Wandsworth","18:00:00","2018-05-16",220,10,0,31,0,261
"Bexley","07:00:00","2018-05-17",28,0,0,5,0,33
"Enfield","07:00:00","2018-05-17",25,0,0,3,0,28
"Greenwich","07:00:00","2018-05-17",57,0,1,16,0,74
"Harrow","07:00:00","2018-05-17",93,1,1,19,0,114
"Havering","07:00:00","2018-05-17",67,0,0,9,1,77
"Hillingdon","07:00:00","2018-05-17",1825,23,19,307,21,2195
"Merton","07:00:00","2018-05-17",601,38,13,258,50,960
"Newham","07:00:00","2018-05-17",49,1,0,7,1,58
"Southwark","07:00:00","2018-05-17",367,86,46,231,32,762
"Westminster","07:00:00","2018-05-17",2117,292,73,965,180,3627
"Bexley","08:00:00","2018-05-17",53,0,0,5,0,58
"Enfield","08:00:00","2018-05-17",35,0,0,8,2,45
"Greenwich","08:00:00","2018-05-17",128,0,6,16,1,151
"Harrow","08:00:00","2018-05-17",189,1,1,19,0,210
"Havering","08:00:00","2018-05-17",176,0,0,16,4,196
"Hillingdon","08:00:00","2018-05-17",1863,18,21,246,44,2192
"Merton","08:00:00","2018-05-17",620,61,28,267,47,1023
"Newham","08:00:00","2018-05-17",136,0,0,10,2,148
"Southwark","08:00:00","2018-05-17",408,111,37,187,35,778
"Westminster","08:00:00","2018-05-17",2364,335,69,893,202,3863
"Bexley","09:00:00","2018-05-17",53,0,0,11,0,64
"Enfield","09:00:00","2018-05-17",18,0,2,5,0,25
"Greenwich","09:00:00","2018-05-17",43,0,0,19,2,64
"Harrow","09:00:00","2018-05-17",119,0,2,16,0,137
"Havering","09:00:00","2018-05-17",98,0,0,15,0,113
"Hillingdon","09:00:00","2018-05-17",1822,16,20,239,53,2150
"Merton","09:00:00","2018-05-17",527,42,20,258,83,930
"Newham","09:00:00","2018-05-17",50,1,1,6,0,58
"Southwark","09:00:00","2018-05-17",414,68,50,202,37,771
"Westminster","09:00:00","2018-05-17",2237,263,68,790,222,3580
"Bexley","10:00:00","2018-05-17",23,0,0,6,0,29
"Enfield","10:00:00","2018-05-17",23,0,0,2,0,25
"Greenwich","10:00:00","2018-05-17",42,0,0,13,5,60
"Harrow","10:00:00","2018-05-17",53,0,1,18,2,74
"Havering","10:00:00","2018-05-17",62,1,0,10,0,73
"Hillingdon","10:00:00","2018-05-17",1516,14,14,185,47,1776
"Merton","10:00:00","2018-05-17",606,42,23,274,78,1023
"Newham","10:00:00","2018-05-17",31,0,0,14,3,48
"Southwark","10:00:00","2018-05-17",396,42,42,185,38,703
"Westminster","10:00:00","2018-05-17",2181,158,73,834,209,3455
"Bexley","11:00:00","2018-05-17",28,0,0,4,0,32
"Enfield","11:00:00","2018-05-17",19,0,0,4,0,23
"Greenwich","11:00:00","2018-05-17",58,0,0,16,1,75
"Harrow","11:00:00","2018-05-17",84,0,0,15,1,100
"Havering","11:00:00","2018-05-17",59,1,0,3,3,66
"Hillingdon","11:00:00","2018-05-17",1433,20,17,208,41,1719
"Merton","11:00:00","2018-05-17",575,40,18,268,73,974
"Newham","11:00:00","2018-05-17",56,2,0,11,0,69
"Southwark","11:00:00","2018-05-17",385,48,36,182,32,683
"Westminster","11:00:00","2018-05-17",2286,154,53,851,210,3554
"Bexley","12:00:00","2018-05-17",27,0,0,2,0,29
"Enfield","12:00:00","2018-05-17",20,0,0,7,0,27
"Greenwich","12:00:00","2018-05-17",42,0,0,16,1,59
"Harrow","12:00:00","2018-05-17",81,2,0,16,0,99
"Havering","12:00:00","2018-05-17",50,0,0,15,0,65
"Hillingdon","12:00:00","2018-05-17",1501,15,21,218,41,1796
"Merton","12:00:00","2018-05-17",623,41,17,267,80,1028
"Newham","12:00:00","2018-05-17",46,4,0,11,0,61
"Southwark","12:00:00","2018-05-17",389,37,55,158,34,673
"Westminster","12:00:00","2018-05-17",2335,172,72,981,219,3779
"Bexley","13:00:00","2018-05-17",18,0,0,4,0,22
"Enfield","13:00:00","2018-05-17",23,0,0,6,0,29
"Greenwich","13:00:00","2018-05-17",44,0,0,15,1,60
"Harrow","13:00:00","2018-05-17",74,2,0,13,0,89
"Havering","13:00:00","2018-05-17",60,1,0,10,0,71
"Hillingdon","13:00:00","2018-05-17",1546,22,16,224,31,1839
"Merton","13:00:00","2018-05-17",637,34,14,318,90,1093
"Newham","13:00:00","2018-05-17",43,1,0,9,0,53
"Southwark","13:00:00","2018-05-17",356,42,38,150,39,625
"Westminster","13:00:00","2018-05-17",2391,137,76,977,166,3747
"Bexley","14:00:00","2018-05-17",34,0,0,8,2,44
"Enfield","14:00:00","2018-05-17",29,0,0,2,0,31
"Greenwich","14:00:00","2018-05-17",53,0,0,15,2,70
"Harrow","14:00:00","2018-05-17",88,3,1,15,0,107
"Havering","14:00:00","2018-05-17",81,1,0,11,0,93
"Hillingdon","14:00:00","2018-05-17",1543,20,20,243,35,1861
"Merton","14:00:00","2018-05-17",709,53,19,327,99,1207
"Newham","14:00:00","2018-05-17",53,0,0,5,0,58
"Southwark","14:00:00","2018-05-17",389,52,38,130,33,642
"Westminster","14:00:00","2018-05-17",2446,193,69,909,185,3802
"Bexley","15:00:00","2018-05-17",32,0,0,9,0,41
"Enfield","15:00:00","2018-05-17",27,0,0,2,0,29
"Greenwich","15:00:00","2018-05-17",101,0,1,13,3,118
"Harrow","15:00:00","2018-05-17",152,3,1,24,0,180
"Havering","15:00:00","2018-05-17",95,1,0,15,0,111
"Hillingdon","15:00:00","2018-05-17",1940,20,23,229,32,2244
"Merton","15:00:00","2018-05-17",699,38,17,245,52,1051
"Newham","15:00:00","2018-05-17",115,0,1,14,1,131
"Southwark","15:00:00","2018-05-17",372,61,31,122,19,605
"Westminster","15:00:00","2018-05-17",2588,255,78,1004,144,4069
"Bexley","16:00:00","2018-05-17",39,0,0,13,0,52
"Enfield","16:00:00","2018-05-17",23,0,2,3,0,28
"Greenwich","16:00:00","2018-05-17",69,0,1,14,0,84
"Harrow","16:00:00","2018-05-17",142,1,4,15,1,163
"Havering","16:00:00","2018-05-17",130,1,0,19,1,151
"Hillingdon","16:00:00","2018-05-17",1552,21,17,173,22,1785
"Merton","16:00:00","2018-05-17",706,57,14,237,55,1069
"Newham","16:00:00","2018-05-17",88,1,0,10,0,99
"Southwark","16:00:00","2018-05-17",431,73,36,121,8,669
"Westminster","16:00:00","2018-05-17",2579,277,93,1004,96,4049
"Bexley","17:00:00","2018-05-17",52,2,0,10,1,65
"Enfield","17:00:00","2018-05-17",37,0,0,1,0,38
"Greenwich","17:00:00","2018-05-17",60,0,0,12,0,72
"Harrow","17:00:00","2018-05-17",152,2,0,18,0,172
"Havering","17:00:00","2018-05-17",99,1,0,13,0,113
"Hillingdon","17:00:00","2018-05-17",1597,24,13,173,13,1820
"Merton","17:00:00","2018-05-17",728,69,19,198,44,1058
"Newham","17:00:00","2018-05-17",66,3,0,10,0,79
"Southwark","17:00:00","2018-05-17",441,92,39,81,17,670
"Westminster","17:00:00","2018-05-17",3057,428,85,758,99,4427
"Bexley","18:00:00","2018-05-17",30,0,0,2,0,32
"Enfield","18:00:00","2018-05-17",29,0,0,6,0,35
"Greenwich","18:00:00","2018-05-17",43,0,0,6,0,49
"Harrow","18:00:00","2018-05-17",117,2,0,14,0,133
"Havering","18:00:00","2018-05-17",116,1,0,9,0,126
"Hillingdon","18:00:00","2018-05-17",1490,22,12,115,8,1647
"Merton","18:00:00","2018-05-17",786,55,17,113,12,983
"Newham","18:00:00","2018-05-17",70,1,0,6,0,77
"Southwark","18:00:00","2018-05-17",526,83,40,76,6,731
"Westminster","18:00:00","2018-05-17",3221,409,81,767,42,4520
"Barnet","07:00:00","2018-05-18",1142,49,32,412,65,1700
"Bromley","07:00:00","2018-05-18",21,1,0,3,0,25
"Enfield","07:00:00","2018-05-18",745,15,86,187,31,1064
"Havering","07:00:00","2018-05-18",452,0,3,69,5,529
"Hillingdon","07:00:00","2018-05-18",115,2,1,22,0,140
"Lewisham","07:00:00","2018-05-18",332,5,2,74,8,421
"Westminster","07:00:00","2018-05-18",355,19,159,87,26,646
"Barnet","08:00:00","2018-05-18",1545,41,41,320,66,2013
"Bromley","08:00:00","2018-05-18",50,0,0,8,0,58
"Enfield","08:00:00","2018-05-18",840,12,81,135,27,1095
"Havering","08:00:00","2018-05-18",546,0,2,52,7,607
"Hillingdon","08:00:00","2018-05-18",276,1,0,19,1,297
"Lewisham","08:00:00","2018-05-18",502,4,1,74,6,587
"Westminster","08:00:00","2018-05-18",308,20,167,96,25,616
"Barnet","09:00:00","2018-05-18",1352,21,25,307,79,1784
"Bromley","09:00:00","2018-05-18",31,0,0,8,3,42
"Enfield","09:00:00","2018-05-18",929,14,77,115,29,1164
"Havering","09:00:00","2018-05-18",387,0,0,55,7,449
"Hillingdon","09:00:00","2018-05-18",147,0,0,12,0,159
"Lewisham","09:00:00","2018-05-18",351,4,2,52,10,419
"Westminster","09:00:00","2018-05-18",319,21,149,98,25,612
"Barnet","10:00:00","2018-05-18",1076,23,38,322,80,1539
"Bromley","10:00:00","2018-05-18",28,0,0,4,0,32
"Enfield","10:00:00","2018-05-18",835,15,79,150,31,1110
"Havering","10:00:00","2018-05-18",218,0,1,28,5,252
"Hillingdon","10:00:00","2018-05-18",116,1,0,21,0,138
"Lewisham","10:00:00","2018-05-18",264,3,3,62,9,341
"Westminster","10:00:00","2018-05-18",328,13,161,78,19,599
"Barnet","11:00:00","2018-05-18",1220,43,35,346,69,1713
"Bromley","11:00:00","2018-05-18",36,0,0,12,1,49
"Enfield","11:00:00","2018-05-18",965,19,74,160,30,1248
"Havering","11:00:00","2018-05-18",237,2,0,35,3,277
"Hillingdon","11:00:00","2018-05-18",116,0,0,20,0,136
"Lewisham","11:00:00","2018-05-18",239,5,0,81,13,338
"Westminster","11:00:00","2018-05-18",280,9,136,95,25,545
"Barnet","12:00:00","2018-05-18",1469,37,29,286,65,1886
"Bromley","12:00:00","2018-05-18",33,3,0,9,0,45
"Enfield","12:00:00","2018-05-18",979,18,75,125,28,1225
"Havering","12:00:00","2018-05-18",275,1,0,44,6,326
"Hillingdon","12:00:00","2018-05-18",134,1,0,24,0,159
"Lewisham","12:00:00","2018-05-18",244,8,1,58,5,316
"Westminster","12:00:00","2018-05-18",284,20,151,86,16,557
"Barnet","13:00:00","2018-05-18",1377,32,33,275,61,1778
"Bromley","13:00:00","2018-05-18",30,0,0,12,0,42
"Enfield","13:00:00","2018-05-18",866,19,72,112,24,1093
"Havering","13:00:00","2018-05-18",292,0,0,50,8,350
"Hillingdon","13:00:00","2018-05-18",107,0,1,14,2,124
"Lewisham","13:00:00","2018-05-18",279,8,3,75,8,373
"Westminster","13:00:00","2018-05-18",331,16,148,108,28,631
"Barnet","14:00:00","2018-05-18",1520,50,41,287,49,1947
"Bromley","14:00:00","2018-05-18",34,0,0,11,0,45
"Enfield","14:00:00","2018-05-18",1014,24,76,116,38,1268
"Havering","14:00:00","2018-05-18",350,4,2,40,3,399
"Hillingdon","14:00:00","2018-05-18",123,0,0,9,1,133
"Lewisham","14:00:00","2018-05-18",299,14,0,69,7,389
"Westminster","14:00:00","2018-05-18",383,18,128,87,21,637
"Barnet","15:00:00","2018-05-18",1696,43,36,263,47,2085
"Bromley","15:00:00","2018-05-18",53,2,0,5,0,60
"Enfield","15:00:00","2018-05-18",902,22,71,85,29,1109
"Havering","15:00:00","2018-05-18",406,2,2,61,0,471
"Hillingdon","15:00:00","2018-05-18",188,1,1,23,0,213
"Lewisham","15:00:00","2018-05-18",362,7,1,75,5,450
"Westminster","15:00:00","2018-05-18",401,35,142,71,11,660
"Barnet","16:00:00","2018-05-18",1292,63,34,247,29,1665
"Bromley","16:00:00","2018-05-18",54,2,0,8,0,64
"Enfield","16:00:00","2018-05-18",809,28,67,110,22,1036
"Havering","16:00:00","2018-05-18",507,2,3,76,7,595
"Hillingdon","16:00:00","2018-05-18",233,0,1,25,0,259
"Lewisham","16:00:00","2018-05-18",387,8,8,87,4,494
"Westminster","16:00:00","2018-05-18",385,25,169,59,12,650
"Barnet","17:00:00","2018-05-18",1589,42,26,244,9,1910
"Bromley","17:00:00","2018-05-18",45,1,0,8,1,55
"Enfield","17:00:00","2018-05-18",979,31,66,73,23,1172
"Havering","17:00:00","2018-05-18",455,2,0,42,8,507
"Hillingdon","17:00:00","2018-05-18",181,1,0,16,0,198
"Lewisham","17:00:00","2018-05-18",382,12,0,64,2,460
"Westminster","17:00:00","2018-05-18",461,41,135,59,8,704
"Barnet","18:00:00","2018-05-18",1464,55,45,149,16,1729
"Bromley","18:00:00","2018-05-18",36,2,0,5,0,43
"Enfield","18:00:00","2018-05-18",1040,21,70,62,8,1201
"Havering","18:00:00","2018-05-18",443,1,3,39,2,488
"Hillingdon","18:00:00","2018-05-18",170,2,0,12,0,184
"Lewisham","18:00:00","2018-05-18",387,19,0,45,2,453
"Westminster","18:00:00","2018-05-18",520,41,167,31,7,766
"Bromley","07:00:00","2018-05-21",1315,49,13,374,19,1770
"Croydon","07:00:00","2018-05-21",962,11,18,164,11,1166
"Enfield","07:00:00","2018-05-21",257,1,9,40,1,308
"Greenwich","07:00:00","2018-05-21",406,6,22,46,3,483
"Islington","07:00:00","2018-05-21",218,33,3,95,5,354
"Newham","07:00:00","2018-05-21",4,0,2,1,0,7
"Richmond upon Thames","07:00:00","2018-05-21",11,0,0,3,0,14
"Southwark","07:00:00","2018-05-21",790,112,84,307,63,1356
"Westminster","07:00:00","2018-05-21",897,174,315,487,101,1974
"Bromley","08:00:00","2018-05-21",1440,38,17,283,22,1800
"Croydon","08:00:00","2018-05-21",1137,6,17,172,16,1348
"Enfield","08:00:00","2018-05-21",404,2,6,39,0,451
"Greenwich","08:00:00","2018-05-21",672,5,33,56,5,771
"Islington","08:00:00","2018-05-21",309,48,4,95,5,461
"Newham","08:00:00","2018-05-21",16,0,0,1,0,17
"Richmond upon Thames","08:00:00","2018-05-21",26,0,0,1,0,27
"Southwark","08:00:00","2018-05-21",903,71,97,278,79,1428
"Westminster","08:00:00","2018-05-21",1167,174,308,418,69,2136
"Bromley","09:00:00","2018-05-21",1047,22,15,291,30,1405
"Croydon","09:00:00","2018-05-21",912,10,22,125,33,1102
"Enfield","09:00:00","2018-05-21",269,0,9,50,2,330
"Greenwich","09:00:00","2018-05-21",495,5,25,58,2,585
"Islington","09:00:00","2018-05-21",295,39,6,110,7,457
"Newham","09:00:00","2018-05-21",9,0,0,1,0,10
"Richmond upon Thames","09:00:00","2018-05-21",24,0,0,3,0,27
"Southwark","09:00:00","2018-05-21",742,34,94,223,86,1179
"Westminster","09:00:00","2018-05-21",1168,100,338,438,72,2116
"Bromley","10:00:00","2018-05-21",943,15,13,242,31,1244
"Croydon","10:00:00","2018-05-21",801,11,19,150,26,1007
"Enfield","10:00:00","2018-05-21",190,1,8,33,1,233
"Greenwich","10:00:00","2018-05-21",298,2,20,42,3,365
"Islington","10:00:00","2018-05-21",307,23,8,137,9,484
"Newham","10:00:00","2018-05-21",8,0,0,1,0,9
"Richmond upon Thames","10:00:00","2018-05-21",25,0,0,6,0,31
"Southwark","10:00:00","2018-05-21",708,31,90,271,98,1198
"Westminster","10:00:00","2018-05-21",1285,61,320,485,83,2234
"Bromley","11:00:00","2018-05-21",1198,10,14,198,23,1443
"Croydon","11:00:00","2018-05-21",559,11,18,118,29,735
"Enfield","11:00:00","2018-05-21",226,6,8,32,4,276
"Greenwich","11:00:00","2018-05-21",353,3,22,36,7,421
"Islington","11:00:00","2018-05-21",292,26,4,137,7,466
"Newham","11:00:00","2018-05-21",15,0,0,3,0,18
"Richmond upon Thames","11:00:00","2018-05-21",31,0,0,2,0,33
"Southwark","11:00:00","2018-05-21",648,33,87,274,91,1133
"Westminster","11:00:00","2018-05-21",1251,72,318,489,101,2231
"Bromley","12:00:00","2018-05-21",1042,10,12,188,18,1270
"Croydon","12:00:00","2018-05-21",612,15,20,162,36,845
"Enfield","12:00:00","2018-05-21",238,3,8,35,1,285
"Greenwich","12:00:00","2018-05-21",423,2,25,70,3,523
"Islington","12:00:00","2018-05-21",249,33,8,143,9,442
"Newham","12:00:00","2018-05-21",13,2,0,1,0,16
"Richmond upon Thames","12:00:00","2018-05-21",12,3,0,2,0,17
"Southwark","12:00:00","2018-05-21",675,28,82,252,79,1116
"Westminster","12:00:00","2018-05-21",1253,91,304,440,67,2155
"Bromley","13:00:00","2018-05-21",1057,20,13,258,23,1371
"Croydon","13:00:00","2018-05-21",637,7,17,135,31,827
"Enfield","13:00:00","2018-05-21",205,3,9,33,3,253
"Greenwich","13:00:00","2018-05-21",343,11,23,53,5,435
"Islington","13:00:00","2018-05-21",266,34,7,147,10,464
"Newham","13:00:00","2018-05-21",8,0,0,2,0,10
"Richmond upon Thames","13:00:00","2018-05-21",19,0,0,3,0,22
"Southwark","13:00:00","2018-05-21",782,54,90,280,74,1280
"Westminster","13:00:00","2018-05-21",1217,109,307,407,73,2113
"Bromley","14:00:00","2018-05-21",1245,16,11,276,25,1573
"Croydon","14:00:00","2018-05-21",786,14,11,144,46,1001
"Enfield","14:00:00","2018-05-21",253,6,7,41,2,309
"Greenwich","14:00:00","2018-05-21",413,2,20,59,1,495
"Islington","14:00:00","2018-05-21",249,27,7,132,2,417
"Newham","14:00:00","2018-05-21",6,2,0,0,0,8
"Richmond upon Thames","14:00:00","2018-05-21",22,1,0,7,0,30
"Southwark","14:00:00","2018-05-21",742,43,97,251,77,1210
"Westminster","14:00:00","2018-05-21",1328,111,317,417,48,2221
"Bromley","15:00:00","2018-05-21",1310,26,15,241,22,1614
"Croydon","15:00:00","2018-05-21",872,5,17,163,19,1076
"Enfield","15:00:00","2018-05-21",395,3,13,41,1,453
"Greenwich","15:00:00","2018-05-21",661,6,27,57,3,754
"Islington","15:00:00","2018-05-21",302,44,14,139,4,503
"Newham","15:00:00","2018-05-21",21,0,1,1,0,23
"Richmond upon Thames","15:00:00","2018-05-21",34,0,0,6,0,40
"Southwark","15:00:00","2018-05-21",804,65,97,304,80,1350
"Westminster","15:00:00","2018-05-21",1416,130,302,418,54,2320
"Bromley","16:00:00","2018-05-21",1507,40,16,289,10,1862
"Croydon","16:00:00","2018-05-21",883,8,18,77,22,1008
"Enfield","16:00:00","2018-05-21",335,1,8,44,1,389
"Greenwich","16:00:00","2018-05-21",459,10,23,52,1,545
"Islington","16:00:00","2018-05-21",297,45,5,131,4,482
"Newham","16:00:00","2018-05-21",8,0,1,3,0,12
"Richmond upon Thames","16:00:00","2018-05-21",31,1,0,2,0,34
"Southwark","16:00:00","2018-05-21",1087,87,85,266,24,1549
"Westminster","16:00:00","2018-05-21",1421,184,341,353,39,2338
"Bromley","17:00:00","2018-05-21",1435,36,11,217,10,1709
"Croydon","17:00:00","2018-05-21",1167,11,15,190,7,1390
"Enfield","17:00:00","2018-05-21",387,9,9,41,0,446
"Greenwich","17:00:00","2018-05-21",565,8,22,56,0,651
"Islington","17:00:00","2018-05-21",268,72,3,112,1,456
"Newham","17:00:00","2018-05-21",4,0,0,4,0,8
"Richmond upon Thames","17:00:00","2018-05-21",23,0,0,1,0,24
"Southwark","17:00:00","2018-05-21",871,101,92,180,19,1263
"Westminster","17:00:00","2018-05-21",1496,291,332,249,14,2382
"Bromley","18:00:00","2018-05-21",1444,39,15,204,3,1705
"Croydon","18:00:00","2018-05-21",1180,13,14,131,2,1340
"Enfield","18:00:00","2018-05-21",334,7,8,30,0,379
"Greenwich","18:00:00","2018-05-21",620,16,20,29,0,685
"Islington","18:00:00","2018-05-21",437,68,2,81,4,592
"Newham","18:00:00","2018-05-21",7,0,0,3,0,10
"Richmond upon Thames","18:00:00","2018-05-21",21,0,0,1,0,22
"Southwark","18:00:00","2018-05-21",1138,114,88,136,14,1490
"Westminster","18:00:00","2018-05-21",1647,244,344,184,17,2436
"Bexley","07:00:00","2018-05-22",108,6,0,55,34,203
"Bromley","07:00:00","2018-05-22",211,2,3,29,3,248
"Croydon","07:00:00","2018-05-22",201,1,24,41,1,268
"Ealing","07:00:00","2018-05-22",2024,61,8,534,155,2782
"Greenwich","07:00:00","2018-05-22",37,0,0,4,1,42
"Hammersmith and Fulham","07:00:00","2018-05-22",1055,112,69,397,53,1686
"Harrow","07:00:00","2018-05-22",1626,26,11,193,37,1893
"Havering","07:00:00","2018-05-22",649,12,24,132,18,835
"Wandsworth","07:00:00","2018-05-22",1471,66,118,401,61,2117
"Bexley","08:00:00","2018-05-22",79,1,1,56,41,178
"Bromley","08:00:00","2018-05-22",226,1,1,29,0,257
"Croydon","08:00:00","2018-05-22",222,1,20,36,1,280
"Ealing","08:00:00","2018-05-22",1870,62,13,372,164,2481
"Greenwich","08:00:00","2018-05-22",43,0,1,8,0,52
"Hammersmith and Fulham","08:00:00","2018-05-22",963,119,70,274,56,1482
"Harrow","08:00:00","2018-05-22",1996,27,11,163,22,2219
"Havering","08:00:00","2018-05-22",868,2,27,140,24,1061
"Wandsworth","08:00:00","2018-05-22",1551,79,105,337,42,2114
"Bexley","09:00:00","2018-05-22",69,2,0,42,28,141
"Bromley","09:00:00","2018-05-22",159,0,0,20,0,179
"Croydon","09:00:00","2018-05-22",153,0,24,28,1,206
"Ealing","09:00:00","2018-05-22",1832,39,9,476,208,2564
"Greenwich","09:00:00","2018-05-22",23,0,0,6,2,31
"Hammersmith and Fulham","09:00:00","2018-05-22",993,83,72,352,70,1570
"Harrow","09:00:00","2018-05-22",1507,22,10,179,34,1752
"Havering","09:00:00","2018-05-22",641,2,27,89,26,785
"Wandsworth","09:00:00","2018-05-22",1549,54,98,375,64,2140
"Bexley","10:00:00","2018-05-22",93,1,0,59,49,202
"Bromley","10:00:00","2018-05-22",104,1,0,20,0,125
"Croydon","10:00:00","2018-05-22",114,0,26,27,1,168
"Ealing","10:00:00","2018-05-22",2007,25,7,551,261,2851
"Greenwich","10:00:00","2018-05-22",23,0,0,7,1,31
"Hammersmith and Fulham","10:00:00","2018-05-22",1012,72,49,405,73,1611
"Harrow","10:00:00","2018-05-22",1459,18,11,225,32,1745
"Havering","10:00:00","2018-05-22",479,4,26,77,17,603
"Wandsworth","10:00:00","2018-05-22",1433,47,106,407,70,2063
"Bexley","11:00:00","2018-05-22",69,3,0,75,29,176
"Bromley","11:00:00","2018-05-22",124,0,0,21,1,146
"Croydon","11:00:00","2018-05-22",91,3,24,13,2,133
"Ealing","11:00:00","2018-05-22",2131,19,10,537,287,2984
"Greenwich","11:00:00","2018-05-22",23,0,0,8,0,31
"Hammersmith and Fulham","11:00:00","2018-05-22",975,78,56,443,82,1634
"Harrow","11:00:00","2018-05-22",1269,19,4,193,45,1530
"Havering","11:00:00","2018-05-22",479,6,26,101,28,640
"Wandsworth","11:00:00","2018-05-22",1189,40,92,346,53,1720
"Bexley","12:00:00","2018-05-22",88,5,0,79,31,203
"Bromley","12:00:00","2018-05-22",113,1,0,17,0,131
"Croydon","12:00:00","2018-05-22",138,4,26,35,1,204
"Ealing","12:00:00","2018-05-22",2169,25,11,480,263,2948
"Greenwich","12:00:00","2018-05-22",31,0,0,2,1,34
"Hammersmith and Fulham","12:00:00","2018-05-22",915,88,46,371,82,1502
"Harrow","12:00:00","2018-05-22",1222,22,8,184,43,1479
"Havering","12:00:00","2018-05-22",534,1,18,80,21,654
"Wandsworth","12:00:00","2018-05-22",1318,62,102,375,57,1914
"Bexley","13:00:00","2018-05-22",108,5,0,58,32,203
"Bromley","13:00:00","2018-05-22",127,0,0,23,1,151
"Croydon","13:00:00","2018-05-22",142,1,23,39,0,205
"Ealing","13:00:00","2018-05-22",2054,26,7,483,260,2830
"Greenwich","13:00:00","2018-05-22",17,0,0,9,1,27
"Hammersmith and Fulham","13:00:00","2018-05-22",1002,93,41,398,61,1595
"Harrow","13:00:00","2018-05-22",1250,19,9,183,37,1498
"Havering","13:00:00","2018-05-22",500,5,17,106,20,648
"Wandsworth","13:00:00","2018-05-22",1349,71,104,368,33,1925
"Bexley","14:00:00","2018-05-22",122,5,0,58,40,225
"Bromley","14:00:00","2018-05-22",122,0,0,23,2,147
"Croydon","14:00:00","2018-05-22",219,6,19,41,1,286
"Ealing","14:00:00","2018-05-22",1829,30,13,463,233,2568
"Greenwich","14:00:00","2018-05-22",24,0,0,4,0,28
"Hammersmith and Fulham","14:00:00","2018-05-22",1010,94,61,353,60,1578
"Harrow","14:00:00","2018-05-22",1325,18,5,169,36,1553
"Havering","14:00:00","2018-05-22",608,1,21,100,19,749
"Wandsworth","14:00:00","2018-05-22",1215,60,81,354,34,1744
"Bexley","15:00:00","2018-05-22",97,2,0,28,36,163
"Bromley","15:00:00","2018-05-22",122,1,1,20,1,145
"Croydon","15:00:00","2018-05-22",270,2,23,29,0,324
"Ealing","15:00:00","2018-05-22",1714,28,8,407,238,2395
"Greenwich","15:00:00","2018-05-22",29,0,0,4,0,33
"Hammersmith and Fulham","15:00:00","2018-05-22",991,89,70,336,47,1533
"Harrow","15:00:00","2018-05-22",1508,25,14,171,30,1748
"Havering","15:00:00","2018-05-22",667,8,23,123,16,837
"Wandsworth","15:00:00","2018-05-22",1816,75,102,382,36,2411
"Bexley","16:00:00","2018-05-22",100,3,0,48,26,177
"Bromley","16:00:00","2018-05-22",190,0,4,39,1,234
"Croydon","16:00:00","2018-05-22",261,1,26,48,1,337
"Ealing","16:00:00","2018-05-22",1250,58,6,282,150,1746
"Greenwich","16:00:00","2018-05-22",41,1,0,6,1,49
"Hammersmith and Fulham","16:00:00","2018-05-22",795,119,54,237,33,1238
"Harrow","16:00:00","2018-05-22",2092,37,11,209,16,2365
"Havering","16:00:00","2018-05-22",725,7,34,156,15,937
"Wandsworth","16:00:00","2018-05-22",1740,97,116,383,17,2353
"Bexley","17:00:00","2018-05-22",138,5,0,50,14,207
"Bromley","17:00:00","2018-05-22",204,3,0,23,0,230
"Croydon","17:00:00","2018-05-22",222,5,16,34,0,277
"Ealing","17:00:00","2018-05-22",1376,75,4,229,96,1780
"Greenwich","17:00:00","2018-05-22",52,0,0,11,0,63
"Hammersmith and Fulham","17:00:00","2018-05-22",966,180,61,237,25,1469
"Harrow","17:00:00","2018-05-22",1828,31,4,147,15,2025
"Havering","17:00:00","2018-05-22",817,14,23,175,7,1036
"Wandsworth","17:00:00","2018-05-22",1733,126,96,290,19,2264
"Bexley","18:00:00","2018-05-22",118,5,0,41,20,184
"Bromley","18:00:00","2018-05-22",253,2,0,16,0,271
"Croydon","18:00:00","2018-05-22",248,0,24,51,0,323
"Ealing","18:00:00","2018-05-22",1543,71,13,247,105,1979
"Greenwich","18:00:00","2018-05-22",28,0,0,6,0,34
"Hammersmith and Fulham","18:00:00","2018-05-22",1027,181,61,154,17,1440
"Harrow","18:00:00","2018-05-22",1862,28,4,133,5,2032
"Havering","18:00:00","2018-05-22",708,12,18,108,4,850
"Wandsworth","18:00:00","2018-05-22",1821,169,105,211,10,2316
"Bromley","07:00:00","2018-05-23",81,0,0,4,0,85
"Croydon","07:00:00","2018-05-23",1194,57,56,321,18,1646
"Ealing","07:00:00","2018-05-23",1015,22,96,180,16,1329
"Harrow","07:00:00","2018-05-23",432,2,44,84,7,569
"Havering","07:00:00","2018-05-23",44,0,0,9,80,133
"Kensington and Chelsea","07:00:00","2018-05-23",1427,172,95,593,108,2395
"Newham","07:00:00","2018-05-23",316,14,3,102,12,447
"Richmond upon Thames","07:00:00","2018-05-23",578,31,103,151,27,890
"Waltham Forest","07:00:00","2018-05-23",680,46,26,249,32,1033
"Wandsworth","07:00:00","2018-05-23",616,38,6,189,3,852
"Bromley","08:00:00","2018-05-23",164,0,0,11,0,175
"Croydon","08:00:00","2018-05-23",1294,34,52,227,29,1636
"Ealing","08:00:00","2018-05-23",1126,24,79,93,6,1328
"Harrow","08:00:00","2018-05-23",561,4,37,76,9,687
"Havering","08:00:00","2018-05-23",30,0,0,15,64,109
"Kensington and Chelsea","08:00:00","2018-05-23",1581,208,115,567,116,2587
"Newham","08:00:00","2018-05-23",427,9,3,89,25,553
"Richmond upon Thames","08:00:00","2018-05-23",663,41,101,126,23,954
"Waltham Forest","08:00:00","2018-05-23",641,40,23,187,32,923
"Wandsworth","08:00:00","2018-05-23",705,28,7,120,10,870
"Bromley","09:00:00","2018-05-23",42,0,0,4,0,46
"Croydon","09:00:00","2018-05-23",1136,15,43,291,28,1513
"Ealing","09:00:00","2018-05-23",797,14,109,118,15,1053
"Harrow","09:00:00","2018-05-23",369,4,44,83,12,512
"Havering","09:00:00","2018-05-23",37,0,0,15,89,141
"Kensington and Chelsea","09:00:00","2018-05-23",1720,145,128,528,95,2616
"Newham","09:00:00","2018-05-23",371,17,4,113,18,523
"Richmond upon Thames","09:00:00","2018-05-23",576,20,98,126,18,838
"Waltham Forest","09:00:00","2018-05-23",633,19,21,224,33,930
"Wandsworth","09:00:00","2018-05-23",472,18,9,114,5,618
"Bromley","10:00:00","2018-05-23",43,0,0,6,1,50
"Croydon","10:00:00","2018-05-23",886,22,41,230,29,1208
"Ealing","10:00:00","2018-05-23",792,16,83,128,15,1034
"Harrow","10:00:00","2018-05-23",326,7,43,74,8,458
"Havering","10:00:00","2018-05-23",36,0,0,21,90,147
"Kensington and Chelsea","10:00:00","2018-05-23",1626,64,134,518,121,2463
"Newham","10:00:00","2018-05-23",307,19,1,99,17,443
"Richmond upon Thames","10:00:00","2018-05-23",509,18,88,127,19,761
"Waltham Forest","10:00:00","2018-05-23",658,25,22,238,48,991
"Wandsworth","10:00:00","2018-05-23",387,17,7,126,5,542
"Bromley","11:00:00","2018-05-23",31,0,0,3,0,34
"Croydon","11:00:00","2018-05-23",890,25,50,243,27,1235
"Ealing","11:00:00","2018-05-23",781,29,84,135,11,1040
"Harrow","11:00:00","2018-05-23",320,5,38,70,9,442
"Havering","11:00:00","2018-05-23",25,0,0,28,77,130
"Kensington and Chelsea","11:00:00","2018-05-23",1489,76,101,485,88,2239
"Newham","11:00:00","2018-05-23",268,15,0,113,15,411
"Richmond upon Thames","11:00:00","2018-05-23",606,40,105,169,16,936
"Waltham Forest","11:00:00","2018-05-23",630,19,30,227,56,962
"Wandsworth","11:00:00","2018-05-23",411,19,6,144,8,588
"Bromley","12:00:00","2018-05-23",55,1,0,4,0,60
"Croydon","12:00:00","2018-05-23",1011,21,40,281,23,1376
"Ealing","12:00:00","2018-05-23",753,44,81,134,14,1026
"Harrow","12:00:00","2018-05-23",321,4,37,92,10,464
"Havering","12:00:00","2018-05-23",29,0,0,17,68,114
"Kensington and Chelsea","12:00:00","2018-05-23",1703,103,119,455,76,2456
"Newham","12:00:00","2018-05-23",331,18,2,119,15,485
"Richmond upon Thames","12:00:00","2018-05-23",539,42,94,150,24,849
"Waltham Forest","12:00:00","2018-05-23",676,23,21,248,51,1019
"Wandsworth","12:00:00","2018-05-23",416,30,6,117,9,578
"Bromley","13:00:00","2018-05-23",57,0,0,4,2,63
"Croydon","13:00:00","2018-05-23",907,28,41,262,14,1252
"Ealing","13:00:00","2018-05-23",789,39,91,114,10,1043
"Harrow","13:00:00","2018-05-23",332,3,39,66,7,447
"Havering","13:00:00","2018-05-23",37,1,0,26,79,143
"Kensington and Chelsea","13:00:00","2018-05-23",1507,80,112,435,66,2200
"Newham","13:00:00","2018-05-23",396,15,3,117,16,547
"Richmond upon Thames","13:00:00","2018-05-23",588,44,109,114,18,873
"Waltham Forest","13:00:00","2018-05-23",790,21,21,208,40,1080
"Wandsworth","13:00:00","2018-05-23",402,24,6,135,4,571
"Bromley","14:00:00","2018-05-23",46,1,0,10,0,57
"Croydon","14:00:00","2018-05-23",1098,23,42,265,29,1457
"Ealing","14:00:00","2018-05-23",728,34,88,126,7,983
"Harrow","14:00:00","2018-05-23",343,4,40,63,4,454
"Havering","14:00:00","2018-05-23",52,2,0,25,96,175
"Kensington and Chelsea","14:00:00","2018-05-23",1518,80,100,477,84,2259
"Newham","14:00:00","2018-05-23",373,9,2,117,22,523
"Richmond upon Thames","14:00:00","2018-05-23",608,43,96,125,8,880
"Waltham Forest","14:00:00","2018-05-23",730,22,22,188,30,992
"Wandsworth","14:00:00","2018-05-23",497,19,5,120,9,650
"Bromley","15:00:00","2018-05-23",79,1,0,8,1,89
"Croydon","15:00:00","2018-05-23",1162,39,38,277,22,1538
"Ealing","15:00:00","2018-05-23",963,28,88,143,7,1229
"Harrow","15:00:00","2018-05-23",412,6,37,69,6,530
"Havering","15:00:00","2018-05-23",50,0,0,14,97,161
"Kensington and Chelsea","15:00:00","2018-05-23",1728,113,110,350,58,2359
"Newham","15:00:00","2018-05-23",528,13,3,158,22,724
"Richmond upon Thames","15:00:00","2018-05-23",644,39,97,103,9,892
"Waltham Forest","15:00:00","2018-05-23",776,24,21,178,34,1033
"Wandsworth","15:00:00","2018-05-23",592,35,6,152,10,795
"Bromley","16:00:00","2018-05-23",73,0,0,8,0,81
"Croydon","16:00:00","2018-05-23",1224,36,50,267,11,1588
"Ealing","16:00:00","2018-05-23",1000,32,87,104,6,1229
"Harrow","16:00:00","2018-05-23",444,14,44,68,7,577
"Havering","16:00:00","2018-05-23",60,2,0,19,37,118
"Kensington and Chelsea","16:00:00","2018-05-23",1600,87,109,346,40,2182
"Newham","16:00:00","2018-05-23",626,28,6,163,7,830
"Richmond upon Thames","16:00:00","2018-05-23",624,46,104,111,5,890
"Waltham Forest","16:00:00","2018-05-23",944,42,26,227,19,1258
"Wandsworth","16:00:00","2018-05-23",762,39,5,155,1,962
"Bromley","17:00:00","2018-05-23",93,0,0,5,0,98
"Croydon","17:00:00","2018-05-23",1324,50,45,245,4,1668
"Ealing","17:00:00","2018-05-23",1200,51,87,101,0,1439
"Harrow","17:00:00","2018-05-23",468,4,36,94,2,604
"Havering","17:00:00","2018-05-23",31,2,0,10,22,65
"Kensington and Chelsea","17:00:00","2018-05-23",1474,176,93,274,34,2051
"Newham","17:00:00","2018-05-23",691,31,0,151,11,884
"Richmond upon Thames","17:00:00","2018-05-23",757,62,97,93,6,1015
"Waltham Forest","17:00:00","2018-05-23",1005,55,18,208,22,1308
"Wandsworth","17:00:00","2018-05-23",844,74,5,152,3,1078
"Bromley","18:00:00","2018-05-23",93,0,0,4,0,97
"Croydon","18:00:00","2018-05-23",1274,59,49,166,1,1549
"Ealing","18:00:00","2018-05-23",1139,71,106,70,2,1388
"Harrow","18:00:00","2018-05-23",562,8,38,86,4,698
"Havering","18:00:00","2018-05-23",38,0,0,10,17,65
"Kensington and Chelsea","18:00:00","2018-05-23",1769,193,86,249,19,2316
"Newham","18:00:00","2018-05-23",583,24,3,118,3,731
"Richmond upon Thames","18:00:00","2018-05-23",813,67,98,64,4,1046
"Waltham Forest","18:00:00","2018-05-23",986,58,27,159,8,1238
"Wandsworth","18:00:00","2018-05-23",834,54,6,107,1,1002
"Brent","07:00:00","2018-05-24",420,11,66,83,13,593
"Enfield","07:00:00","2018-05-24",1461,11,5,407,64,1948
"Greenwich","07:00:00","2018-05-24",414,15,26,110,21,586
"Haringey","07:00:00","2018-05-24",4,0,0,1,0,5
"Hounslow","07:00:00","2018-05-24",393,6,8,84,9,500
"Kingston upon Thames","07:00:00","2018-05-24",244,7,3,27,3,284
"Southwark","07:00:00","2018-05-24",899,247,73,518,76,1813
"Westminster","07:00:00","2018-05-24",9,0,0,3,1,13
"Brent","08:00:00","2018-05-24",455,5,62,43,17,582
"Enfield","08:00:00","2018-05-24",1743,12,9,342,52,2158
"Greenwich","08:00:00","2018-05-24",671,21,29,125,19,865
"Haringey","08:00:00","2018-05-24",10,0,0,4,0,14
"Hounslow","08:00:00","2018-05-24",530,2,12,74,6,624
"Kingston upon Thames","08:00:00","2018-05-24",456,6,8,42,2,514
"Southwark","08:00:00","2018-05-24",904,297,79,460,88,1828
"Westminster","08:00:00","2018-05-24",27,1,0,5,0,33
"Brent","09:00:00","2018-05-24",363,13,63,54,25,518
"Enfield","09:00:00","2018-05-24",1161,7,3,261,55,1487
"Greenwich","09:00:00","2018-05-24",674,8,37,147,42,908
"Haringey","09:00:00","2018-05-24",2,0,0,3,0,5
"Hounslow","09:00:00","2018-05-24",373,5,15,41,12,446
"Kingston upon Thames","09:00:00","2018-05-24",247,3,1,36,2,289
"Southwark","09:00:00","2018-05-24",841,147,104,438,108,1638
"Westminster","09:00:00","2018-05-24",17,0,0,8,1,26
"Brent","10:00:00","2018-05-24",350,12,67,80,16,525
"Enfield","10:00:00","2018-05-24",1038,7,3,230,50,1328
"Greenwich","10:00:00","2018-05-24",455,2,32,150,42,681
"Haringey","10:00:00","2018-05-24",6,1,0,0,3,10
"Hounslow","10:00:00","2018-05-24",274,2,9,52,17,354
"Kingston upon Thames","10:00:00","2018-05-24",189,2,0,47,3,241
"Southwark","10:00:00","2018-05-24",1068,97,79,570,147,1961
"Westminster","10:00:00","2018-05-24",20,1,0,3,0,24
"Brent","11:00:00","2018-05-24",375,17,62,71,17,542
"Enfield","11:00:00","2018-05-24",1133,5,2,209,34,1383
"Greenwich","11:00:00","2018-05-24",398,7,31,150,36,622
"Haringey","11:00:00","2018-05-24",4,0,0,4,0,8
"Hounslow","11:00:00","2018-05-24",264,3,10,72,5,354
"Kingston upon Thames","11:00:00","2018-05-24",226,2,0,34,3,265
"Southwark","11:00:00","2018-05-24",991,95,70,615,148,1919
"Westminster","11:00:00","2018-05-24",29,0,0,4,2,35
"Brent","12:00:00","2018-05-24",405,26,60,67,12,570
"Enfield","12:00:00","2018-05-24",1179,5,3,236,50,1473
"Greenwich","12:00:00","2018-05-24",454,7,31,113,29,634
"Haringey","12:00:00","2018-05-24",5,0,0,1,0,6
"Hounslow","12:00:00","2018-05-24",321,10,12,60,15,418
"Kingston upon Thames","12:00:00","2018-05-24",228,5,0,23,3,259
"Southwark","12:00:00","2018-05-24",1000,111,70,553,123,1857
"Westminster","12:00:00","2018-05-24",15,0,0,11,1,27
"Brent","13:00:00","2018-05-24",457,25,64,82,11,639
"Enfield","13:00:00","2018-05-24",1157,10,4,216,51,1438
"Greenwich","13:00:00","2018-05-24",490,6,28,97,25,646
"Haringey","13:00:00","2018-05-24",3,0,0,4,0,7
"Hounslow","13:00:00","2018-05-24",289,8,10,50,13,370
"Kingston upon Thames","13:00:00","2018-05-24",229,2,0,26,1,258
"Southwark","13:00:00","2018-05-24",1045,95,88,585,111,1924
"Westminster","13:00:00","2018-05-24",14,4,0,6,0,24
"Brent","14:00:00","2018-05-24",455,27,61,59,10,612
"Enfield","14:00:00","2018-05-24",1259,10,3,260,54,1586
"Greenwich","14:00:00","2018-05-24",465,7,30,124,23,649
"Haringey","14:00:00","2018-05-24",7,0,0,3,0,10
"Hounslow","14:00:00","2018-05-24",394,7,8,67,9,485
"Kingston upon Thames","14:00:00","2018-05-24",259,1,2,42,2,306
"Southwark","14:00:00","2018-05-24",1074,100,76,538,98,1886
"Westminster","14:00:00","2018-05-24",17,0,0,12,0,29
"Brent","15:00:00","2018-05-24",406,29,61,39,10,545
"Enfield","15:00:00","2018-05-24",1308,6,0,278,55,1647
"Greenwich","15:00:00","2018-05-24",578,9,27,163,22,799
"Haringey","15:00:00","2018-05-24",8,0,0,2,0,10
"Hounslow","15:00:00","2018-05-24",472,6,17,83,11,589
"Kingston upon Thames","15:00:00","2018-05-24",377,6,3,48,2,436
"Southwark","15:00:00","2018-05-24",1155,143,87,559,76,2020
"Westminster","15:00:00","2018-05-24",17,0,0,8,0,25
"Brent","16:00:00","2018-05-24",434,31,67,40,10,582
"Enfield","16:00:00","2018-05-24",1580,10,5,391,44,2030
"Greenwich","16:00:00","2018-05-24",679,19,33,111,15,857
"Haringey","16:00:00","2018-05-24",14,0,0,0,0,14
"Hounslow","16:00:00","2018-05-24",510,5,11,73,7,606
"Kingston upon Thames","16:00:00","2018-05-24",284,2,0,40,1,327
"Southwark","16:00:00","2018-05-24",1203,187,85,606,62,2143
"Westminster","16:00:00","2018-05-24",15,0,0,3,0,18
"Brent","17:00:00","2018-05-24",472,42,59,52,0,625
"Enfield","17:00:00","2018-05-24",1602,16,4,323,22,1967
"Greenwich","17:00:00","2018-05-24",1008,19,35,106,8,1176
"Haringey","17:00:00","2018-05-24",12,1,0,1,0,14
"Hounslow","17:00:00","2018-05-24",650,9,14,83,8,764
"Kingston upon Thames","17:00:00","2018-05-24",429,3,2,30,0,464
"Southwark","17:00:00","2018-05-24",1264,352,76,453,42,2187
"Westminster","17:00:00","2018-05-24",13,0,0,6,0,19
"Brent","18:00:00","2018-05-24",475,28,71,36,1,611
"Enfield","18:00:00","2018-05-24",1114,13,1,171,12,1311
"Greenwich","18:00:00","2018-05-24",964,11,33,69,5,1082
"Haringey","18:00:00","2018-05-24",7,1,0,0,0,8
"Hounslow","18:00:00","2018-05-24",500,16,10,61,2,589
"Kingston upon Thames","18:00:00","2018-05-24",360,2,0,30,0,392
"Southwark","18:00:00","2018-05-24",1290,329,64,373,27,2083
"Westminster","18:00:00","2018-05-24",26,6,0,3,0,35
"Barnet","07:00:00","2018-05-25",484,0,0,118,4,606
"Camden","07:00:00","2018-05-25",956,130,36,350,66,1538
"Croydon","07:00:00","2018-05-25",667,26,20,170,4,887
"Ealing","07:00:00","2018-05-25",3979,247,101,1558,334,6219
"Hillingdon","07:00:00","2018-05-25",338,1,2,53,3,397
"Redbridge","07:00:00","2018-05-25",36,0,0,14,2,52
"Sutton","07:00:00","2018-05-25",6,0,0,1,0,7
"Barnet","08:00:00","2018-05-25",602,4,0,79,0,685
"Camden","08:00:00","2018-05-25",1025,131,48,362,54,1620
"Croydon","08:00:00","2018-05-25",989,16,21,140,11,1177
"Ealing","08:00:00","2018-05-25",4331,253,93,1724,355,6756
"Hillingdon","08:00:00","2018-05-25",484,8,1,34,4,531
"Redbridge","08:00:00","2018-05-25",98,0,1,7,1,107
"Sutton","08:00:00","2018-05-25",5,0,0,0,0,5
"Barnet","09:00:00","2018-05-25",285,1,0,58,4,348
"Camden","09:00:00","2018-05-25",991,103,58,409,63,1624
"Croydon","09:00:00","2018-05-25",687,15,16,135,16,869
"Ealing","09:00:00","2018-05-25",3820,170,93,1314,426,5823
"Hillingdon","09:00:00","2018-05-25",276,5,0,33,11,325
"Redbridge","09:00:00","2018-05-25",65,0,1,11,0,77
"Sutton","09:00:00","2018-05-25",6,0,0,0,0,6
"Barnet","10:00:00","2018-05-25",208,1,2,55,1,267
"Camden","10:00:00","2018-05-25",879,81,57,413,72,1502
"Croydon","10:00:00","2018-05-25",545,8,17,135,14,719
"Ealing","10:00:00","2018-05-25",3934,115,77,1414,405,5945
"Hillingdon","10:00:00","2018-05-25",233,1,0,43,6,283
"Redbridge","10:00:00","2018-05-25",48,0,0,7,0,55
"Sutton","10:00:00","2018-05-25",3,0,0,4,0,7
"Barnet","11:00:00","2018-05-25",233,1,2,51,2,289
"Camden","11:00:00","2018-05-25",893,70,54,440,69,1526
"Croydon","11:00:00","2018-05-25",577,18,16,127,17,755
"Ealing","11:00:00","2018-05-25",3847,141,69,1352,415,5824
"Hillingdon","11:00:00","2018-05-25",286,2,0,48,1,337
"Redbridge","11:00:00","2018-05-25",59,0,0,9,0,68
"Sutton","11:00:00","2018-05-25",3,0,0,1,0,4
"Barnet","12:00:00","2018-05-25",264,1,2,46,1,314
"Camden","12:00:00","2018-05-25",933,75,49,375,84,1516
"Croydon","12:00:00","2018-05-25",652,10,15,131,11,819
"Ealing","12:00:00","2018-05-25",3642,130,50,1495,375,5692
"Hillingdon","12:00:00","2018-05-25",286,0,3,32,14,335
"Redbridge","12:00:00","2018-05-25",62,0,0,15,0,77
"Sutton","12:00:00","2018-05-25",3,0,0,6,0,9
"Barnet","13:00:00","2018-05-25",244,1,2,43,1,291
"Camden","13:00:00","2018-05-25",790,86,51,401,72,1400
"Croydon","13:00:00","2018-05-25",645,18,15,123,10,811
"Ealing","13:00:00","2018-05-25",3626,119,73,1377,337,5532
"Hillingdon","13:00:00","2018-05-25",337,3,1,28,2,371
"Redbridge","13:00:00","2018-05-25",91,0,0,6,2,99
"Sutton","13:00:00","2018-05-25",2,0,0,0,0,2
"Barnet","14:00:00","2018-05-25",259,6,2,57,2,326
"Camden","14:00:00","2018-05-25",914,110,53,323,67,1467
"Croydon","14:00:00","2018-05-25",778,15,19,145,9,966
"Ealing","14:00:00","2018-05-25",3755,126,80,1350,291,5602
"Hillingdon","14:00:00","2018-05-25",388,0,0,39,9,436
"Redbridge","14:00:00","2018-05-25",110,0,0,12,1,123
"Sutton","14:00:00","2018-05-25",1,0,0,0,0,1
"Barnet","15:00:00","2018-05-25",379,3,3,76,1,462
"Camden","15:00:00","2018-05-25",1064,80,52,338,42,1576
"Croydon","15:00:00","2018-05-25",970,23,14,157,11,1175
"Ealing","15:00:00","2018-05-25",4064,130,68,1164,227,5653
"Hillingdon","15:00:00","2018-05-25",496,3,2,59,7,567
"Redbridge","15:00:00","2018-05-25",88,1,0,8,1,98
"Sutton","15:00:00","2018-05-25",6,0,0,1,0,7
"Barnet","16:00:00","2018-05-25",503,3,3,92,5,606
"Camden","16:00:00","2018-05-25",1126,152,45,388,23,1734
"Croydon","16:00:00","2018-05-25",1042,26,17,149,4,1238
"Ealing","16:00:00","2018-05-25",4727,222,69,1443,144,6605
"Hillingdon","16:00:00","2018-05-25",492,5,1,56,6,560
"Redbridge","16:00:00","2018-05-25",95,0,1,7,0,103
"Sutton","16:00:00","2018-05-25",3,0,0,2,0,5
"Barnet","17:00:00","2018-05-25",496,4,0,75,0,575
"Camden","17:00:00","2018-05-25",1447,200,54,263,19,1983
"Croydon","17:00:00","2018-05-25",991,33,15,145,7,1191
"Ealing","17:00:00","2018-05-25",4594,299,81,892,136,6002
"Hillingdon","17:00:00","2018-05-25",557,3,1,50,2,613
"Redbridge","17:00:00","2018-05-25",101,2,0,5,0,108
"Sutton","17:00:00","2018-05-25",5,0,0,4,0,9
"Barnet","18:00:00","2018-05-25",424,5,0,35,0,464
"Camden","18:00:00","2018-05-25",1612,180,54,189,12,2047
"Croydon","18:00:00","2018-05-25",1040,35,18,141,0,1234
"Ealing","18:00:00","2018-05-25",5233,330,101,964,119,6747
"Hillingdon","18:00:00","2018-05-25",422,11,2,41,2,478
"Redbridge","18:00:00","2018-05-25",80,0,0,9,0,89
"Sutton","18:00:00","2018-05-25",8,2,0,0,0,10
"Brent","07:00:00","2018-06-04",437,24,43,190,26,720
"Camden","07:00:00","2018-06-04",200,26,92,125,17,460
"Croydon","07:00:00","2018-06-04",659,20,12,161,4,856
"Enfield","07:00:00","2018-06-04",710,8,19,140,16,893
"Haringey","07:00:00","2018-06-04",593,16,11,207,5,832
"Havering","07:00:00","2018-06-04",444,4,2,111,20,581
"Kensington and Chelsea","07:00:00","2018-06-04",496,66,31,152,16,761
"Kingston upon Thames","07:00:00","2018-06-04",424,3,15,57,0,499
"Tower Hamlets","07:00:00","2018-06-04",82,2,10,24,7,125
"Wandsworth","07:00:00","2018-06-04",37,2,1,10,1,51
"Brent","08:00:00","2018-06-04",506,19,34,141,28,728
"Camden","08:00:00","2018-06-04",249,59,77,126,17,528
"Croydon","08:00:00","2018-06-04",738,17,15,126,10,906
"Enfield","08:00:00","2018-06-04",720,2,14,111,13,860
"Haringey","08:00:00","2018-06-04",702,21,6,173,7,909
"Havering","08:00:00","2018-06-04",619,1,4,90,24,738
"Kensington and Chelsea","08:00:00","2018-06-04",700,116,29,116,19,980
"Kingston upon Thames","08:00:00","2018-06-04",560,10,15,52,1,638
"Tower Hamlets","08:00:00","2018-06-04",138,1,11,33,11,194
"Wandsworth","08:00:00","2018-06-04",93,3,1,12,0,109
"Brent","09:00:00","2018-06-04",425,15,44,167,21,672
"Camden","09:00:00","2018-06-04",272,38,82,113,15,520
"Croydon","09:00:00","2018-06-04",575,12,19,173,8,787
"Enfield","09:00:00","2018-06-04",763,7,25,120,22,937
"Haringey","09:00:00","2018-06-04",705,14,7,206,10,942
"Havering","09:00:00","2018-06-04",692,3,4,102,17,818
"Kensington and Chelsea","09:00:00","2018-06-04",572,79,30,190,17,888
"Kingston upon Thames","09:00:00","2018-06-04",351,3,11,55,0,420
"Tower Hamlets","09:00:00","2018-06-04",93,2,9,39,3,146
"Wandsworth","09:00:00","2018-06-04",60,3,1,6,1,71
"Brent","10:00:00","2018-06-04",417,21,39,159,12,648
"Camden","10:00:00","2018-06-04",278,31,81,143,32,565
"Croydon","10:00:00","2018-06-04",517,9,14,145,5,690
"Enfield","10:00:00","2018-06-04",518,7,15,109,19,668
"Haringey","10:00:00","2018-06-04",655,14,8,197,14,888
"Havering","10:00:00","2018-06-04",733,3,0,82,19,837
"Kensington and Chelsea","10:00:00","2018-06-04",482,30,30,162,23,727
"Kingston upon Thames","10:00:00","2018-06-04",304,4,12,34,1,355
"Tower Hamlets","10:00:00","2018-06-04",118,3,10,58,8,197
"Wandsworth","10:00:00","2018-06-04",59,2,0,7,1,69
"Brent","11:00:00","2018-06-04",416,20,34,141,20,631
"Camden","11:00:00","2018-06-04",252,32,75,125,27,511
"Croydon","11:00:00","2018-06-04",493,18,13,156,7,687
"Enfield","11:00:00","2018-06-04",568,1,12,137,23,741
"Haringey","11:00:00","2018-06-04",658,21,3,188,17,887
"Havering","11:00:00","2018-06-04",730,4,0,84,12,830
"Kensington and Chelsea","11:00:00","2018-06-04",422,26,27,129,21,625
"Kingston upon Thames","11:00:00","2018-06-04",279,8,10,32,4,333
"Tower Hamlets","11:00:00","2018-06-04",127,5,10,40,15,197
"Wandsworth","11:00:00","2018-06-04",47,2,0,13,1,63
"Brent","12:00:00","2018-06-04",455,24,33,140,18,670
"Camden","12:00:00","2018-06-04",278,27,86,118,21,530
"Croydon","12:00:00","2018-06-04",576,17,14,121,7,735
"Enfield","12:00:00","2018-06-04",531,1,19,105,19,675
"Haringey","12:00:00","2018-06-04",661,19,5,197,7,889
"Havering","12:00:00","2018-06-04",716,1,0,77,10,804
"Kensington and Chelsea","12:00:00","2018-06-04",493,27,30,151,18,719
"Kingston upon Thames","12:00:00","2018-06-04",284,4,12,42,3,345
"Tower Hamlets","12:00:00","2018-06-04",184,6,8,46,16,260
"Wandsworth","12:00:00","2018-06-04",52,2,0,11,2,67
"Brent","13:00:00","2018-06-04",476,34,36,146,11,703
"Camden","13:00:00","2018-06-04",279,42,87,135,16,559
"Croydon","13:00:00","2018-06-04",549,17,11,111,6,694
"Enfield","13:00:00","2018-06-04",596,3,15,133,5,752
"Haringey","13:00:00","2018-06-04",743,24,1,178,13,959
"Havering","13:00:00","2018-06-04",684,1,1,91,4,781
"Kensington and Chelsea","13:00:00","2018-06-04",499,26,32,124,14,695
"Kingston upon Thames","13:00:00","2018-06-04",299,3,12,40,1,355
"Tower Hamlets","13:00:00","2018-06-04",171,2,10,44,10,237
"Wandsworth","13:00:00","2018-06-04",63,5,0,8,0,76
"Brent","14:00:00","2018-06-04",490,36,38,153,13,730
"Camden","14:00:00","2018-06-04",282,44,73,113,19,531
"Croydon","14:00:00","2018-06-04",676,15,12,147,11,861
"Enfield","14:00:00","2018-06-04",636,2,16,100,6,760
"Haringey","14:00:00","2018-06-04",737,30,4,202,7,980
"Havering","14:00:00","2018-06-04",824,6,6,114,11,961
"Kensington and Chelsea","14:00:00","2018-06-04",443,26,22,100,12,603
"Kingston upon Thames","14:00:00","2018-06-04",347,7,16,55,2,427
"Tower Hamlets","14:00:00","2018-06-04",168,2,9,43,4,226
"Wandsworth","14:00:00","2018-06-04",53,0,1,14,1,69
"Brent","15:00:00","2018-06-04",544,38,37,162,14,795
"Camden","15:00:00","2018-06-04",254,32,70,119,17,492
"Croydon","15:00:00","2018-06-04",755,24,15,130,3,927
"Enfield","15:00:00","2018-06-04",651,4,18,118,5,796
"Haringey","15:00:00","2018-06-04",811,17,10,222,6,1066
"Havering","15:00:00","2018-06-04",733,2,2,102,5,844
"Kensington and Chelsea","15:00:00","2018-06-04",577,38,31,146,14,806
"Kingston upon Thames","15:00:00","2018-06-04",408,5,12,47,4,476
"Tower Hamlets","15:00:00","2018-06-04",197,3,9,46,5,260
"Wandsworth","15:00:00","2018-06-04",43,3,0,7,0,53
"Brent","16:00:00","2018-06-04",533,53,41,144,9,780
"Camden","16:00:00","2018-06-04",278,41,74,94,10,497
"Croydon","16:00:00","2018-06-04",613,30,11,138,3,795
"Enfield","16:00:00","2018-06-04",713,7,20,125,4,869
"Haringey","16:00:00","2018-06-04",862,31,10,215,10,1128
"Havering","16:00:00","2018-06-04",853,2,1,92,2,950
"Kensington and Chelsea","16:00:00","2018-06-04",541,45,31,106,7,730
"Kingston upon Thames","16:00:00","2018-06-04",521,6,16,36,2,581
"Tower Hamlets","16:00:00","2018-06-04",211,5,9,34,9,268
"Wandsworth","16:00:00","2018-06-04",68,7,1,6,0,82
"Brent","17:00:00","2018-06-04",551,81,46,123,4,805
"Camden","17:00:00","2018-06-04",326,64,82,64,12,548
"Croydon","17:00:00","2018-06-04",781,40,11,134,0,966
"Enfield","17:00:00","2018-06-04",782,10,21,93,3,909
"Haringey","17:00:00","2018-06-04",986,28,2,185,4,1205
"Havering","17:00:00","2018-06-04",832,7,0,98,2,939
"Kensington and Chelsea","17:00:00","2018-06-04",560,72,26,67,3,728
"Kingston upon Thames","17:00:00","2018-06-04",504,9,12,41,0,566
"Tower Hamlets","17:00:00","2018-06-04",245,3,9,26,3,286
"Wandsworth","17:00:00","2018-06-04",84,4,0,7,0,95
"Brent","18:00:00","2018-06-04",594,42,36,85,1,758
"Camden","18:00:00","2018-06-04",348,60,84,73,9,574
"Croydon","18:00:00","2018-06-04",740,30,13,87,0,870
"Enfield","18:00:00","2018-06-04",777,15,11,90,6,899
"Haringey","18:00:00","2018-06-04",1014,47,1,154,3,1219
"Havering","18:00:00","2018-06-04",775,11,0,57,2,845
"Kensington and Chelsea","18:00:00","2018-06-04",565,100,30,44,2,741
"Kingston upon Thames","18:00:00","2018-06-04",456,5,14,28,0,503
"Tower Hamlets","18:00:00","2018-06-04",203,11,10,24,1,249
"Wandsworth","18:00:00","2018-06-04",84,1,0,7,0,92
"Brent","07:00:00","2018-06-05",338,14,36,100,18,506
"Camden","07:00:00","2018-06-05",157,17,50,83,25,332
"Hammersmith and Fulham","07:00:00","2018-06-05",2363,236,46,1021,234,3900
"Haringey","07:00:00","2018-06-05",48,2,6,5,3,64
"Havering","07:00:00","2018-06-05",367,1,16,78,5,467
"Hillingdon","07:00:00","2018-06-05",106,0,0,16,0,122
"Lambeth","07:00:00","2018-06-05",395,105,68,246,45,859
"Lewisham","07:00:00","2018-06-05",362,9,11,147,8,537
"Sutton","07:00:00","2018-06-05",637,10,6,143,22,818
"Westminster","07:00:00","2018-06-05",2413,368,262,1161,269,4473
"Brent","08:00:00","2018-06-05",543,9,29,76,19,676
"Camden","08:00:00","2018-06-05",279,19,40,131,25,494
"Hammersmith and Fulham","08:00:00","2018-06-05",2314,230,55,779,269,3647
"Haringey","08:00:00","2018-06-05",81,2,6,11,2,102
"Havering","08:00:00","2018-06-05",570,2,24,74,11,681
"Hillingdon","08:00:00","2018-06-05",155,0,0,12,1,168
"Lambeth","08:00:00","2018-06-05",400,164,81,191,39,875
"Lewisham","08:00:00","2018-06-05",445,7,15,100,6,573
"Sutton","08:00:00","2018-06-05",679,9,4,110,27,829
"Brent","09:00:00","2018-06-05",351,9,33,76,15,484
"Camden","09:00:00","2018-06-05",297,19,45,125,21,507
"Hammersmith and Fulham","09:00:00","2018-06-05",2341,152,48,829,295,3665
"Haringey","09:00:00","2018-06-05",68,1,5,16,1,91
"Havering","09:00:00","2018-06-05",421,1,12,83,9,526
"Hillingdon","09:00:00","2018-06-05",45,0,0,5,2,52
"Lambeth","09:00:00","2018-06-05",402,103,85,193,29,812
"Lewisham","09:00:00","2018-06-05",366,8,16,111,7,508
"Sutton","09:00:00","2018-06-05",598,5,2,114,23,742
"Westminster","09:00:00","2018-06-05",2994,253,326,882,275,4730
"Brent","10:00:00","2018-06-05",300,16,31,81,13,441
"Camden","10:00:00","2018-06-05",286,15,56,162,29,548
"Hammersmith and Fulham","10:00:00","2018-06-05",2220,100,39,804,316,3479
"Haringey","10:00:00","2018-06-05",77,1,5,15,2,100
"Havering","10:00:00","2018-06-05",254,1,19,57,6,337
"Hillingdon","10:00:00","2018-06-05",47,0,0,7,0,54
"Lambeth","10:00:00","2018-06-05",421,43,72,217,35,788
"Lewisham","10:00:00","2018-06-05",251,5,11,83,5,355
"Sutton","10:00:00","2018-06-05",570,3,4,126,24,727
"Westminster","10:00:00","2018-06-05",2989,184,326,878,277,4654
"Brent","11:00:00","2018-06-05",290,8,35,76,29,438
"Camden","11:00:00","2018-06-05",319,35,53,152,33,592
"Hammersmith and Fulham","11:00:00","2018-06-05",2177,94,30,792,306,3399
"Haringey","11:00:00","2018-06-05",64,2,5,15,2,88
"Havering","11:00:00","2018-06-05",258,4,12,40,10,324
"Hillingdon","11:00:00","2018-06-05",94,0,0,5,1,100
"Lambeth","11:00:00","2018-06-05",398,56,67,215,33,769
"Lewisham","11:00:00","2018-06-05",245,6,13,66,3,333
"Sutton","11:00:00","2018-06-05",593,8,2,149,29,781
"Westminster","11:00:00","2018-06-05",3135,173,304,871,255,4738
"Brent","12:00:00","2018-06-05",288,22,28,66,13,417
"Camden","12:00:00","2018-06-05",344,39,37,178,33,631
"Hammersmith and Fulham","12:00:00","2018-06-05",2280,109,30,780,272,3471
"Haringey","12:00:00","2018-06-05",70,4,5,21,0,100
"Havering","12:00:00","2018-06-05",331,1,16,51,7,406
"Hillingdon","12:00:00","2018-06-05",85,0,0,10,0,95
"Lambeth","12:00:00","2018-06-05",463,33,75,241,43,855
"Lewisham","12:00:00","2018-06-05",255,2,12,68,8,345
"Sutton","12:00:00","2018-06-05",589,9,3,99,24,724
"Brent","13:00:00","2018-06-05",344,21,33,89,17,504
"Camden","13:00:00","2018-06-05",383,20,53,194,23,673
"Hammersmith and Fulham","13:00:00","2018-06-05",2285,96,25,755,247,3408
"Haringey","13:00:00","2018-06-05",83,2,4,15,1,105
"Havering","13:00:00","2018-06-05",298,2,15,55,6,376
"Hillingdon","13:00:00","2018-06-05",85,2,0,12,1,100
"Lambeth","13:00:00","2018-06-05",480,50,72,209,38,849
"Lewisham","13:00:00","2018-06-05",264,4,10,96,7,381
"Sutton","13:00:00","2018-06-05",588,8,5,93,24,718
"Brent","14:00:00","2018-06-05",369,17,29,73,18,506
"Camden","14:00:00","2018-06-05",408,35,57,177,38,715
"Hammersmith and Fulham","14:00:00","2018-06-05",2422,106,23,731,240,3522
"Haringey","14:00:00","2018-06-05",75,2,6,11,2,96
"Havering","14:00:00","2018-06-05",348,1,14,51,4,418
"Hillingdon","14:00:00","2018-06-05",105,2,0,12,1,120
"Lambeth","14:00:00","2018-06-05",431,54,72,229,34,820
"Lewisham","14:00:00","2018-06-05",350,10,11,106,9,486
"Sutton","14:00:00","2018-06-05",598,7,1,119,23,748
"Brent","15:00:00","2018-06-05",436,17,33,75,25,586
"Camden","15:00:00","2018-06-05",359,39,53,155,30,636
"Hammersmith and Fulham","15:00:00","2018-06-05",2636,144,30,760,201,3771
"Haringey","15:00:00","2018-06-05",93,1,4,19,2,119
"Havering","15:00:00","2018-06-05",496,2,26,59,4,587
"Hillingdon","15:00:00","2018-06-05",164,1,0,14,0,179
"Lambeth","15:00:00","2018-06-05",458,63,67,207,24,819
"Lewisham","15:00:00","2018-06-05",403,5,13,123,5,549
"Sutton","15:00:00","2018-06-05",677,12,2,108,20,819
"Westminster","15:00:00","2018-06-05",3205,195,325,706,132,4563
"Brent","16:00:00","2018-06-05",499,22,29,82,16,648
"Camden","16:00:00","2018-06-05",401,56,45,186,11,699
"Hammersmith and Fulham","16:00:00","2018-06-05",2737,187,37,712,122,3795
"Haringey","16:00:00","2018-06-05",94,2,6,13,1,116
"Havering","16:00:00","2018-06-05",430,4,16,78,5,533
"Hillingdon","16:00:00","2018-06-05",169,3,0,12,1,185
"Lambeth","16:00:00","2018-06-05",497,113,70,219,10,909
"Lewisham","16:00:00","2018-06-05",403,11,16,123,7,560
"Sutton","16:00:00","2018-06-05",756,10,4,146,7,923
"Brent","17:00:00","2018-06-05",524,32,31,75,14,676
"Camden","17:00:00","2018-06-05",480,118,58,110,12,778
"Hammersmith and Fulham","17:00:00","2018-06-05",2913,275,35,571,99,3893
"Haringey","17:00:00","2018-06-05",121,8,4,12,0,145
"Havering","17:00:00","2018-06-05",502,3,17,58,0,580
"Hillingdon","17:00:00","2018-06-05",182,0,0,21,0,203
"Lambeth","17:00:00","2018-06-05",483,137,70,159,12,861
"Lewisham","17:00:00","2018-06-05",501,8,12,119,3,643
"Sutton","17:00:00","2018-06-05",709,14,3,110,4,840
"Brent","18:00:00","2018-06-05",450,35,30,71,8,594
"Camden","18:00:00","2018-06-05",470,100,40,104,6,720
"Hammersmith and Fulham","18:00:00","2018-06-05",3098,275,43,425,65,3906
"Haringey","18:00:00","2018-06-05",84,6,3,8,1,102
"Havering","18:00:00","2018-06-05",462,5,17,40,1,525
"Hillingdon","18:00:00","2018-06-05",112,3,0,17,0,132
"Lambeth","18:00:00","2018-06-05",699,142,74,137,2,1054
"Lewisham","18:00:00","2018-06-05",458,19,10,73,0,560
"Sutton","18:00:00","2018-06-05",620,10,1,83,11,725
"Barking and Dagenham","07:00:00","2018-06-06",1059,12,79,236,8,1394
"Brent","07:00:00","2018-06-06",404,13,52,146,2,617
"Camden","07:00:00","2018-06-06",191,28,31,80,19,349
"Croydon","07:00:00","2018-06-06",1770,91,31,441,140,2473
"Kingston upon Thames","07:00:00","2018-06-06",120,2,11,21,3,157
"Lewisham","07:00:00","2018-06-06",647,14,11,241,14,927
"Richmond upon Thames","07:00:00","2018-06-06",698,16,23,123,11,871
"Sutton","07:00:00","2018-06-06",24,0,6,11,1,42
"Waltham Forest","07:00:00","2018-06-06",14,0,1,3,0,18
"Wandsworth","07:00:00","2018-06-06",827,129,44,316,47,1363
"Barking and Dagenham","08:00:00","2018-06-06",1016,7,76,152,18,1269
"Brent","08:00:00","2018-06-06",616,14,46,123,9,808
"Camden","08:00:00","2018-06-06",217,30,23,103,22,395
"Croydon","08:00:00","2018-06-06",1658,56,39,391,175,2319
"Kingston upon Thames","08:00:00","2018-06-06",197,6,14,14,3,234
"Lewisham","08:00:00","2018-06-06",671,14,12,170,20,887
"Richmond upon Thames","08:00:00","2018-06-06",868,22,22,97,14,1023
"Sutton","08:00:00","2018-06-06",71,2,8,11,0,92
"Waltham Forest","08:00:00","2018-06-06",34,0,1,3,1,39
"Wandsworth","08:00:00","2018-06-06",960,101,48,295,32,1436
"Barking and Dagenham","09:00:00","2018-06-06",970,5,69,159,15,1218
"Brent","09:00:00","2018-06-06",473,14,61,113,10,671
"Camden","09:00:00","2018-06-06",292,32,38,90,32,484
"Croydon","09:00:00","2018-06-06",1449,43,27,496,207,2222
"Kingston upon Thames","09:00:00","2018-06-06",114,6,11,37,3,171
"Lewisham","09:00:00","2018-06-06",495,13,13,137,34,692
"Richmond upon Thames","09:00:00","2018-06-06",714,16,22,133,25,910
"Sutton","09:00:00","2018-06-06",17,0,9,4,0,30
"Waltham Forest","09:00:00","2018-06-06",24,0,0,2,2,28
"Wandsworth","09:00:00","2018-06-06",750,77,49,312,74,1262
"Barking and Dagenham","10:00:00","2018-06-06",850,5,63,158,18,1094
"Brent","10:00:00","2018-06-06",314,19,48,106,10,497
"Camden","10:00:00","2018-06-06",282,16,26,103,19,446
"Croydon","10:00:00","2018-06-06",1531,29,28,473,207,2268
"Kingston upon Thames","10:00:00","2018-06-06",116,1,13,19,3,152
"Lewisham","10:00:00","2018-06-06",360,10,10,137,18,535
"Richmond upon Thames","10:00:00","2018-06-06",563,23,21,131,15,753
"Sutton","10:00:00","2018-06-06",23,0,8,7,0,38
"Waltham Forest","10:00:00","2018-06-06",18,1,0,4,3,26
"Wandsworth","10:00:00","2018-06-06",796,63,41,340,69,1309
"Barking and Dagenham","11:00:00","2018-06-06",906,10,65,165,15,1161
"Brent","11:00:00","2018-06-06",342,20,45,105,5,517
"Camden","11:00:00","2018-06-06",250,19,34,88,26,417
"Croydon","11:00:00","2018-06-06",1566,42,27,437,176,2248
"Kingston upon Thames","11:00:00","2018-06-06",92,0,12,20,2,126
"Lewisham","11:00:00","2018-06-06",386,12,7,127,24,556
"Richmond upon Thames","11:00:00","2018-06-06",500,19,20,99,17,655
"Sutton","11:00:00","2018-06-06",26,1,8,6,0,41
"Waltham Forest","11:00:00","2018-06-06",24,0,0,2,0,26
"Wandsworth","11:00:00","2018-06-06",787,75,39,367,49,1317
"Barking and Dagenham","12:00:00","2018-06-06",851,21,62,137,7,1078
"Brent","12:00:00","2018-06-06",356,21,49,87,8,521
"Camden","12:00:00","2018-06-06",257,24,34,102,23,440
"Croydon","12:00:00","2018-06-06",1587,45,21,416,142,2211
"Kingston upon Thames","12:00:00","2018-06-06",113,8,13,25,2,161
"Lewisham","12:00:00","2018-06-06",411,16,12,115,13,567
"Richmond upon Thames","12:00:00","2018-06-06",489,14,22,95,28,648
"Sutton","12:00:00","2018-06-06",22,1,6,6,0,35
"Waltham Forest","12:00:00","2018-06-06",23,0,0,8,0,31
"Wandsworth","12:00:00","2018-06-06",767,68,41,282,47,1205
"Barking and Dagenham","13:00:00","2018-06-06",963,14,58,147,7,1189
"Brent","13:00:00","2018-06-06",350,28,44,107,11,540
"Camden","13:00:00","2018-06-06",292,23,26,84,21,446
"Croydon","13:00:00","2018-06-06",1644,36,25,355,155,2215
"Kingston upon Thames","13:00:00","2018-06-06",89,4,12,12,6,123
"Lewisham","13:00:00","2018-06-06",443,18,6,139,21,627
"Richmond upon Thames","13:00:00","2018-06-06",501,18,22,101,9,651
"Sutton","13:00:00","2018-06-06",22,0,8,6,0,36
"Waltham Forest","13:00:00","2018-06-06",21,2,0,1,0,24
"Wandsworth","13:00:00","2018-06-06",889,81,38,297,48,1353
"Barking and Dagenham","14:00:00","2018-06-06",965,7,64,143,15,1194
"Brent","14:00:00","2018-06-06",431,35,40,107,12,625
"Camden","14:00:00","2018-06-06",301,27,31,93,17,469
"Croydon","14:00:00","2018-06-06",1750,39,35,343,159,2326
"Kingston upon Thames","14:00:00","2018-06-06",101,4,12,23,6,146
"Lewisham","14:00:00","2018-06-06",494,14,7,182,22,719
"Richmond upon Thames","14:00:00","2018-06-06",561,15,20,100,19,715
"Sutton","14:00:00","2018-06-06",29,0,8,8,1,46
"Waltham Forest","14:00:00","2018-06-06",27,0,0,8,0,35
"Wandsworth","14:00:00","2018-06-06",788,83,38,277,42,1228
"Barking and Dagenham","15:00:00","2018-06-06",1069,16,66,160,17,1328
"Brent","15:00:00","2018-06-06",687,38,54,120,2,901
"Camden","15:00:00","2018-06-06",343,42,30,86,13,514
"Croydon","15:00:00","2018-06-06",1775,44,36,316,123,2294
"Kingston upon Thames","15:00:00","2018-06-06",131,3,13,22,1,170
"Lewisham","15:00:00","2018-06-06",573,15,11,155,13,767
"Richmond upon Thames","15:00:00","2018-06-06",705,19,29,126,8,887
"Sutton","15:00:00","2018-06-06",63,2,10,6,0,81
"Waltham Forest","15:00:00","2018-06-06",26,2,0,5,1,34
"Wandsworth","15:00:00","2018-06-06",921,91,47,238,30,1327
"Barking and Dagenham","16:00:00","2018-06-06",1173,9,71,153,11,1417
"Brent","16:00:00","2018-06-06",569,40,40,121,3,773
"Camden","16:00:00","2018-06-06",331,59,27,76,7,500
"Croydon","16:00:00","2018-06-06",1786,59,25,362,87,2319
"Kingston upon Thames","16:00:00","2018-06-06",149,8,13,21,0,191
"Lewisham","16:00:00","2018-06-06",594,31,18,172,13,828
"Richmond upon Thames","16:00:00","2018-06-06",798,26,23,131,5,983
"Sutton","16:00:00","2018-06-06",40,0,7,9,0,56
"Waltham Forest","16:00:00","2018-06-06",30,0,0,6,0,36
"Wandsworth","16:00:00","2018-06-06",1022,111,41,249,19,1442
"Barking and Dagenham","17:00:00","2018-06-06",1108,21,66,139,5,1339
"Brent","17:00:00","2018-06-06",629,38,56,128,1,852
"Camden","17:00:00","2018-06-06",351,61,37,49,9,507
"Croydon","17:00:00","2018-06-06",1989,90,20,288,68,2455
"Kingston upon Thames","17:00:00","2018-06-06",168,3,10,17,0,198
"Lewisham","17:00:00","2018-06-06",687,31,7,165,14,904
"Richmond upon Thames","17:00:00","2018-06-06",945,21,25,83,9,1083
"Sutton","17:00:00","2018-06-06",51,4,6,14,0,75
"Waltham Forest","17:00:00","2018-06-06",25,1,0,2,0,28
"Wandsworth","17:00:00","2018-06-06",1120,168,36,213,14,1551
"Barking and Dagenham","18:00:00","2018-06-06",1081,29,59,135,5,1309
"Brent","18:00:00","2018-06-06",594,34,49,95,1,773
"Camden","18:00:00","2018-06-06",376,80,32,44,9,541
"Croydon","18:00:00","2018-06-06",1879,82,25,236,46,2268
"Kingston upon Thames","18:00:00","2018-06-06",176,1,14,13,0,204
"Lewisham","18:00:00","2018-06-06",674,31,7,121,6,839
"Richmond upon Thames","18:00:00","2018-06-06",847,34,23,73,1,978
"Sutton","18:00:00","2018-06-06",54,1,8,14,0,77
"Waltham Forest","18:00:00","2018-06-06",20,4,0,5,0,29
"Wandsworth","18:00:00","2018-06-06",1187,185,42,130,11,1555
"Barnet","07:00:00","2018-06-07",1301,12,8,406,58,1785
"Bexley","07:00:00","2018-06-07",761,9,67,137,9,983
"Camden","07:00:00","2018-06-07",356,23,39,167,18,603
"Ealing","07:00:00","2018-06-07",1126,27,69,208,28,1458
"Greenwich","07:00:00","2018-06-07",554,10,26,150,25,765
"Hackney","07:00:00","2018-06-07",44,1,0,12,3,60
"Harrow","07:00:00","2018-06-07",758,5,41,134,15,953
"Hounslow","07:00:00","2018-06-07",238,11,0,54,2,305
"Islington","07:00:00","2018-06-07",581,86,32,485,76,1260
"Lewisham","07:00:00","2018-06-07",299,6,0,65,2,372
"Redbridge","07:00:00","2018-06-07",65,1,0,15,0,81
"Southwark","07:00:00","2018-06-07",168,13,43,75,21,320
"Barnet","08:00:00","2018-06-07",1489,10,3,214,58,1774
"Bexley","08:00:00","2018-06-07",787,9,63,107,20,986
"Camden","08:00:00","2018-06-07",367,18,35,137,19,576
"Ealing","08:00:00","2018-06-07",1376,30,94,200,31,1731
"Greenwich","08:00:00","2018-06-07",719,8,30,117,23,897
"Hackney","08:00:00","2018-06-07",58,0,2,21,1,82
"Harrow","08:00:00","2018-06-07",836,4,33,100,17,990
"Hounslow","08:00:00","2018-06-07",328,7,2,39,0,376
"Islington","08:00:00","2018-06-07",579,89,54,303,51,1076
"Lewisham","08:00:00","2018-06-07",334,6,1,60,2,403
"Redbridge","08:00:00","2018-06-07",165,0,0,25,1,191
"Southwark","08:00:00","2018-06-07",195,25,44,55,34,353
"Barnet","09:00:00","2018-06-07",1075,6,5,235,47,1368
"Bexley","09:00:00","2018-06-07",690,6,73,89,19,877
"Camden","09:00:00","2018-06-07",434,15,31,112,20,612
"Ealing","09:00:00","2018-06-07",1036,22,93,205,33,1389
"Greenwich","09:00:00","2018-06-07",586,6,25,129,15,761
"Hackney","09:00:00","2018-06-07",48,1,0,13,4,66
"Harrow","09:00:00","2018-06-07",784,5,28,108,10,935
"Hounslow","09:00:00","2018-06-07",189,6,0,38,0,233
"Islington","09:00:00","2018-06-07",537,30,40,325,74,1006
"Lewisham","09:00:00","2018-06-07",258,4,0,54,2,318
"Redbridge","09:00:00","2018-06-07",119,0,0,29,1,149
"Southwark","09:00:00","2018-06-07",244,19,59,73,18,413
"Barnet","10:00:00","2018-06-07",809,8,1,176,52,1046
"Bexley","10:00:00","2018-06-07",692,15,61,95,21,884
"Camden","10:00:00","2018-06-07",413,9,31,150,11,614
"Ealing","10:00:00","2018-06-07",947,16,114,238,38,1353
"Greenwich","10:00:00","2018-06-07",479,7,26,84,14,610
"Hackney","10:00:00","2018-06-07",30,4,1,11,4,50
"Harrow","10:00:00","2018-06-07",676,9,38,105,11,839
"Hounslow","10:00:00","2018-06-07",107,5,0,43,0,155
"Islington","10:00:00","2018-06-07",455,35,38,333,69,930
"Lewisham","10:00:00","2018-06-07",219,5,0,85,2,311
"Redbridge","10:00:00","2018-06-07",106,1,1,22,1,131
"Southwark","10:00:00","2018-06-07",196,26,65,75,18,380
"Barnet","11:00:00","2018-06-07",737,5,2,183,42,969
"Bexley","11:00:00","2018-06-07",728,17,67,108,13,933
"Camden","11:00:00","2018-06-07",490,11,26,129,26,682
"Ealing","11:00:00","2018-06-07",1026,29,72,221,44,1392
"Greenwich","11:00:00","2018-06-07",531,15,25,118,16,705
"Hackney","11:00:00","2018-06-07",42,2,0,15,2,61
"Harrow","11:00:00","2018-06-07",678,7,37,110,19,851
"Hounslow","11:00:00","2018-06-07",103,8,0,29,1,141
"Islington","11:00:00","2018-06-07",367,15,40,270,61,753
"Lewisham","11:00:00","2018-06-07",239,1,0,65,3,308
"Redbridge","11:00:00","2018-06-07",57,0,0,13,1,71
"Southwark","11:00:00","2018-06-07",230,25,66,65,19,405
"Barnet","12:00:00","2018-06-07",760,3,2,170,39,974
"Bexley","12:00:00","2018-06-07",720,14,60,104,11,909
"Camden","12:00:00","2018-06-07",537,24,27,144,28,760
"Ealing","12:00:00","2018-06-07",998,38,70,180,33,1319
"Greenwich","12:00:00","2018-06-07",585,7,30,121,19,762
"Hackney","12:00:00","2018-06-07",34,2,3,16,1,56
"Harrow","12:00:00","2018-06-07",599,4,33,94,10,740
"Hounslow","12:00:00","2018-06-07",134,4,0,29,5,172
"Islington","12:00:00","2018-06-07",546,23,32,313,69,983
"Lewisham","12:00:00","2018-06-07",263,6,0,69,2,340
"Redbridge","12:00:00","2018-06-07",90,1,1,13,3,108
"Southwark","12:00:00","2018-06-07",258,53,69,91,14,485
"Barnet","13:00:00","2018-06-07",826,10,3,156,43,1038
"Bexley","13:00:00","2018-06-07",735,11,65,113,10,934
"Camden","13:00:00","2018-06-07",463,22,33,141,30,689
"Ealing","13:00:00","2018-06-07",1000,35,67,170,26,1298
"Greenwich","13:00:00","2018-06-07",509,15,25,102,11,662
"Hackney","13:00:00","2018-06-07",38,3,0,13,0,54
"Harrow","13:00:00","2018-06-07",596,15,35,83,11,740
"Hounslow","13:00:00","2018-06-07",129,2,0,29,1,161
"Islington","13:00:00","2018-06-07",459,32,40,225,49,805
"Lewisham","13:00:00","2018-06-07",222,7,0,63,3,295
"Redbridge","13:00:00","2018-06-07",88,4,0,14,0,106
"Southwark","13:00:00","2018-06-07",293,35,76,72,13,489
"Barnet","14:00:00","2018-06-07",875,5,3,156,50,1089
"Bexley","14:00:00","2018-06-07",753,11,79,121,17,981
"Camden","14:00:00","2018-06-07",431,15,28,103,19,596
"Ealing","14:00:00","2018-06-07",1121,38,92,195,33,1479
"Greenwich","14:00:00","2018-06-07",591,16,23,116,12,758
"Hackney","14:00:00","2018-06-07",29,1,0,6,1,37
"Harrow","14:00:00","2018-06-07",780,12,36,87,9,924
"Hounslow","14:00:00","2018-06-07",155,11,0,26,1,193
"Islington","14:00:00","2018-06-07",355,21,34,209,34,653
"Lewisham","14:00:00","2018-06-07",297,4,0,86,1,388
"Redbridge","14:00:00","2018-06-07",129,4,0,22,1,156
"Southwark","14:00:00","2018-06-07",221,28,61,68,8,386
"Barnet","15:00:00","2018-06-07",978,7,6,225,48,1264
"Bexley","15:00:00","2018-06-07",754,9,71,93,9,936
"Camden","15:00:00","2018-06-07",595,18,27,144,15,799
"Ealing","15:00:00","2018-06-07",1210,24,73,158,21,1486
"Greenwich","15:00:00","2018-06-07",696,8,25,122,13,864
"Hackney","15:00:00","2018-06-07",44,4,1,12,0,61
"Harrow","15:00:00","2018-06-07",715,10,35,97,7,864
"Hounslow","15:00:00","2018-06-07",217,5,1,29,1,253
"Islington","15:00:00","2018-06-07",448,41,33,215,49,786
"Lewisham","15:00:00","2018-06-07",310,4,1,85,0,400
"Redbridge","15:00:00","2018-06-07",158,1,1,21,1,182
"Southwark","15:00:00","2018-06-07",259,26,70,97,13,465
"Barnet","16:00:00","2018-06-07",1264,12,5,239,36,1556
"Bexley","16:00:00","2018-06-07",741,11,65,103,10,930
"Camden","16:00:00","2018-06-07",562,31,27,133,9,762
"Ealing","16:00:00","2018-06-07",1231,45,92,173,13,1554
"Greenwich","16:00:00","2018-06-07",674,17,23,131,4,849
"Hackney","16:00:00","2018-06-07",45,1,0,12,0,58
"Harrow","16:00:00","2018-06-07",790,13,37,104,7,951
"Hounslow","16:00:00","2018-06-07",175,5,0,30,0,210
"Islington","16:00:00","2018-06-07",651,40,44,152,22,909
"Lewisham","16:00:00","2018-06-07",318,11,0,78,2,409
"Redbridge","16:00:00","2018-06-07",221,3,1,40,1,266
"Southwark","16:00:00","2018-06-07",265,45,55,94,5,464
"Barnet","17:00:00","2018-06-07",1469,13,5,218,25,1730
"Bexley","17:00:00","2018-06-07",624,17,55,72,5,773
"Camden","17:00:00","2018-06-07",625,44,24,105,8,806
"Ealing","17:00:00","2018-06-07",1502,40,72,164,21,1799
"Greenwich","17:00:00","2018-06-07",729,14,33,132,4,912
"Hackney","17:00:00","2018-06-07",48,4,0,10,0,62
"Harrow","17:00:00","2018-06-07",913,20,34,109,1,1077
"Hounslow","17:00:00","2018-06-07",263,5,0,29,1,298
"Islington","17:00:00","2018-06-07",553,28,51,170,14,816
"Lewisham","17:00:00","2018-06-07",372,4,0,90,0,466
"Redbridge","17:00:00","2018-06-07",253,0,0,47,0,300
"Southwark","17:00:00","2018-06-07",269,56,87,84,7,503
"Barnet","18:00:00","2018-06-07",1138,12,2,144,24,1320
"Bexley","18:00:00","2018-06-07",756,18,70,51,2,897
"Camden","18:00:00","2018-06-07",690,41,27,107,2,867
"Ealing","18:00:00","2018-06-07",1178,31,67,105,4,1385
"Greenwich","18:00:00","2018-06-07",585,8,23,85,3,704
"Hackney","18:00:00","2018-06-07",42,4,0,9,0,55
"Harrow","18:00:00","2018-06-07",977,20,31,96,0,1124
"Hounslow","18:00:00","2018-06-07",235,11,0,34,0,280
"Islington","18:00:00","2018-06-07",932,73,49,113,17,1184
"Lewisham","18:00:00","2018-06-07",294,2,0,48,1,345
"Redbridge","18:00:00","2018-06-07",166,6,0,14,1,187
"Southwark","18:00:00","2018-06-07",349,63,66,36,5,519
"Camden","07:00:00","2018-06-08",203,31,44,182,87,547
"Ealing","07:00:00","2018-06-08",487,25,12,217,43,784
"Greenwich","07:00:00","2018-06-08",864,29,73,194,17,1177
"Harrow","07:00:00","2018-06-08",979,7,21,206,17,1230
"Hillingdon","07:00:00","2018-06-08",6093,126,54,1418,595,8286
"Lewisham","07:00:00","2018-06-08",623,13,43,104,10,793
"Merton","07:00:00","2018-06-08",311,13,0,92,2,418
"Redbridge","07:00:00","2018-06-08",1893,24,91,589,40,2637
"Westminster","07:00:00","2018-06-08",521,49,64,412,74,1120
"Camden","08:00:00","2018-06-08",281,43,52,204,63,643
"Ealing","08:00:00","2018-06-08",629,25,18,175,85,932
"Greenwich","08:00:00","2018-06-08",719,8,53,127,21,928
"Harrow","08:00:00","2018-06-08",1285,5,26,160,30,1506
"Hillingdon","08:00:00","2018-06-08",5896,77,67,1057,595,7692
"Lewisham","08:00:00","2018-06-08",775,11,43,98,9,936
"Merton","08:00:00","2018-06-08",413,13,1,68,3,498
"Redbridge","08:00:00","2018-06-08",2313,21,111,514,56,3015
"Westminster","08:00:00","2018-06-08",575,42,60,356,91,1124
"Camden","09:00:00","2018-06-08",294,45,57,216,65,677
"Ealing","09:00:00","2018-06-08",520,23,11,220,71,845
"Greenwich","09:00:00","2018-06-08",733,7,69,153,38,1000
"Harrow","09:00:00","2018-06-08",985,12,30,180,31,1238
"Hillingdon","09:00:00","2018-06-08",4983,60,81,1122,667,6913
"Lewisham","09:00:00","2018-06-08",605,11,33,106,18,773
"Merton","09:00:00","2018-06-08",339,4,0,69,9,421
"Redbridge","09:00:00","2018-06-08",1953,13,134,367,70,2537
"Westminster","09:00:00","2018-06-08",622,29,58,407,102,1218
"Camden","10:00:00","2018-06-08",349,35,42,203,71,700
"Ealing","10:00:00","2018-06-08",466,23,10,199,52,750
"Greenwich","10:00:00","2018-06-08",604,5,63,141,18,831
"Harrow","10:00:00","2018-06-08",777,8,18,181,29,1013
"Hillingdon","10:00:00","2018-06-08",4399,58,67,1098,685,6307
"Lewisham","10:00:00","2018-06-08",697,10,47,154,18,926
"Merton","10:00:00","2018-06-08",274,4,0,75,9,362
"Redbridge","10:00:00","2018-06-08",1975,20,136,390,79,2600
"Westminster","10:00:00","2018-06-08",635,34,60,391,75,1195
"Camden","11:00:00","2018-06-08",361,53,59,207,56,736
"Ealing","11:00:00","2018-06-08",552,40,15,209,88,904
"Greenwich","11:00:00","2018-06-08",555,5,52,127,19,758
"Harrow","11:00:00","2018-06-08",868,12,17,180,30,1107
"Hillingdon","11:00:00","2018-06-08",4705,52,53,1144,687,6641
"Lewisham","11:00:00","2018-06-08",651,15,34,142,12,854
"Merton","11:00:00","2018-06-08",266,3,0,79,9,357
"Redbridge","11:00:00","2018-06-08",1988,26,123,410,74,2621
"Westminster","11:00:00","2018-06-08",749,44,62,345,89,1289
"Camden","12:00:00","2018-06-08",415,73,55,189,62,794
"Ealing","12:00:00","2018-06-08",422,27,11,191,68,719
"Greenwich","12:00:00","2018-06-08",646,10,62,116,19,853
"Harrow","12:00:00","2018-06-08",988,15,17,180,28,1228
"Hillingdon","12:00:00","2018-06-08",4905,57,53,1181,629,6825
"Lewisham","12:00:00","2018-06-08",608,20,40,149,14,831
"Merton","12:00:00","2018-06-08",287,8,0,90,7,392
"Redbridge","12:00:00","2018-06-08",2051,39,136,390,49,2665
"Westminster","12:00:00","2018-06-08",729,31,57,375,64,1256
"Camden","13:00:00","2018-06-08",370,62,52,135,53,672
"Ealing","13:00:00","2018-06-08",581,33,10,218,46,888
"Greenwich","13:00:00","2018-06-08",758,16,58,142,20,994
"Harrow","13:00:00","2018-06-08",1018,11,14,152,26,1221
"Hillingdon","13:00:00","2018-06-08",4953,67,61,1204,638,6923
"Lewisham","13:00:00","2018-06-08",644,21,33,152,12,862
"Merton","13:00:00","2018-06-08",280,7,0,101,3,391
"Redbridge","13:00:00","2018-06-08",2049,23,132,362,56,2622
"Westminster","13:00:00","2018-06-08",752,61,61,401,69,1344
"Camden","14:00:00","2018-06-08",396,72,51,156,40,715
"Ealing","14:00:00","2018-06-08",601,49,10,179,90,929
"Greenwich","14:00:00","2018-06-08",744,10,72,122,18,966
"Harrow","14:00:00","2018-06-08",1114,18,21,192,20,1365
"Hillingdon","14:00:00","2018-06-08",5507,66,61,1207,567,7408
"Lewisham","14:00:00","2018-06-08",748,15,34,134,16,947
"Merton","14:00:00","2018-06-08",321,6,1,92,11,431
"Redbridge","14:00:00","2018-06-08",2242,29,117,349,58,2795
"Westminster","14:00:00","2018-06-08",796,54,70,340,55,1315
"Camden","15:00:00","2018-06-08",483,63,56,168,33,803
"Ealing","15:00:00","2018-06-08",576,29,12,175,40,832
"Greenwich","15:00:00","2018-06-08",991,16,90,139,20,1256
"Harrow","15:00:00","2018-06-08",1097,8,27,151,7,1290
"Hillingdon","15:00:00","2018-06-08",6151,104,65,1292,526,8138
"Lewisham","15:00:00","2018-06-08",826,20,30,131,15,1022
"Merton","15:00:00","2018-06-08",293,6,0,85,11,395
"Redbridge","15:00:00","2018-06-08",2737,38,137,370,29,3311
"Westminster","15:00:00","2018-06-08",932,52,76,376,39,1475
"Camden","16:00:00","2018-06-08",416,72,51,92,34,665
"Ealing","16:00:00","2018-06-08",690,48,11,155,39,943
"Greenwich","16:00:00","2018-06-08",1042,17,67,168,19,1313
"Harrow","16:00:00","2018-06-08",1258,9,24,143,6,1440
"Lewisham","16:00:00","2018-06-08",903,26,41,176,8,1154
"Merton","16:00:00","2018-06-08",364,10,0,114,3,491
"Redbridge","16:00:00","2018-06-08",2806,39,141,377,31,3394
"Westminster","16:00:00","2018-06-08",860,125,74,351,15,1425
"Camden","17:00:00","2018-06-08",387,102,48,101,30,668
"Ealing","17:00:00","2018-06-08",783,72,11,129,29,1024
"Greenwich","17:00:00","2018-06-08",991,33,63,112,26,1225
"Harrow","17:00:00","2018-06-08",1124,20,21,120,5,1290
"Lewisham","17:00:00","2018-06-08",939,39,34,137,4,1153
"Merton","17:00:00","2018-06-08",267,7,0,61,0,335
"Redbridge","17:00:00","2018-06-08",2859,76,120,383,13,3451
"Westminster","17:00:00","2018-06-08",985,113,78,199,28,1403
"Camden","18:00:00","2018-06-08",433,100,59,98,29,719
"Ealing","18:00:00","2018-06-08",1052,58,10,103,8,1231
"Greenwich","18:00:00","2018-06-08",984,15,64,74,10,1147
"Harrow","18:00:00","2018-06-08",1255,24,15,118,4,1416
"Hillingdon","18:00:00","2018-06-08",7064,113,69,757,216,8219
"Lewisham","18:00:00","2018-06-08",983,37,43,121,3,1187
"Merton","18:00:00","2018-06-08",303,5,0,56,0,364
"Redbridge","18:00:00","2018-06-08",2326,42,119,322,16,2825
"Westminster","18:00:00","2018-06-08",1194,67,70,167,11,1509
"Barnet","07:00:00","2018-06-11",235,5,1,52,4,297
"Bexley","07:00:00","2018-06-11",1863,35,39,535,255,2727
"Brent","07:00:00","2018-06-11",588,48,86,262,61,1045
"Bromley","07:00:00","2018-06-11",387,3,4,96,5,495
"Croydon","07:00:00","2018-06-11",1399,26,23,363,53,1864
"Enfield","07:00:00","2018-06-11",1086,57,23,321,57,1544
"Greenwich","07:00:00","2018-06-11",31,1,0,8,0,40
"Havering","07:00:00","2018-06-11",796,5,3,246,11,1061
"Westminster","07:00:00","2018-06-11",40,1,0,8,2,51
"Barnet","08:00:00","2018-06-11",397,6,2,41,5,451
"Bexley","08:00:00","2018-06-11",2051,16,29,546,267,2909
"Brent","08:00:00","2018-06-11",596,39,99,239,44,1017
"Bromley","08:00:00","2018-06-11",532,2,4,102,13,653
"Croydon","08:00:00","2018-06-11",1265,18,22,284,73,1662
"Enfield","08:00:00","2018-06-11",1004,41,19,298,47,1409
"Greenwich","08:00:00","2018-06-11",32,0,1,5,0,38
"Havering","08:00:00","2018-06-11",829,5,3,136,20,993
"Westminster","08:00:00","2018-06-11",47,2,1,17,1,68
"Barnet","09:00:00","2018-06-11",298,6,0,54,7,365
"Bexley","09:00:00","2018-06-11",1293,17,29,493,343,2175
"Brent","09:00:00","2018-06-11",617,39,92,269,55,1072
"Bromley","09:00:00","2018-06-11",256,1,7,50,4,318
"Croydon","09:00:00","2018-06-11",1090,14,23,254,63,1444
"Enfield","09:00:00","2018-06-11",856,22,17,310,87,1292
"Greenwich","09:00:00","2018-06-11",23,0,0,4,0,27
"Havering","09:00:00","2018-06-11",482,2,3,88,22,597
"Westminster","09:00:00","2018-06-11",30,1,0,17,0,48
"Barnet","10:00:00","2018-06-11",256,2,0,33,10,301
"Bexley","10:00:00","2018-06-11",1294,14,33,494,328,2163
"Brent","10:00:00","2018-06-11",572,34,98,250,60,1014
"Bromley","10:00:00","2018-06-11",196,5,6,67,9,283
"Croydon","10:00:00","2018-06-11",857,11,22,231,71,1192
"Enfield","10:00:00","2018-06-11",813,16,23,355,94,1301
"Greenwich","10:00:00","2018-06-11",22,0,0,1,0,23
"Havering","10:00:00","2018-06-11",374,2,3,80,12,471
"Westminster","10:00:00","2018-06-11",25,0,0,12,1,38
"Barnet","11:00:00","2018-06-11",290,6,0,45,7,348
"Bexley","11:00:00","2018-06-11",1374,20,32,507,364,2297
"Brent","11:00:00","2018-06-11",609,33,106,237,47,1032
"Bromley","11:00:00","2018-06-11",264,2,9,45,7,327
"Croydon","11:00:00","2018-06-11",926,9,24,266,37,1262
"Enfield","11:00:00","2018-06-11",995,24,15,342,122,1498
"Greenwich","11:00:00","2018-06-11",23,0,0,2,0,25
"Havering","11:00:00","2018-06-11",346,6,2,71,10,435
"Westminster","11:00:00","2018-06-11",25,1,0,15,1,42
"Barnet","12:00:00","2018-06-11",327,7,0,44,16,394
"Bexley","12:00:00","2018-06-11",1368,31,26,466,345,2236
"Brent","12:00:00","2018-06-11",675,48,76,287,46,1132
"Bromley","12:00:00","2018-06-11",239,1,6,47,12,305
"Croydon","12:00:00","2018-06-11",919,13,19,264,59,1274
"Enfield","12:00:00","2018-06-11",1077,19,19,330,93,1538
"Greenwich","12:00:00","2018-06-11",24,3,0,11,0,38
"Havering","12:00:00","2018-06-11",386,9,3,104,6,508
"Westminster","12:00:00","2018-06-11",30,2,0,16,1,49
"Barnet","13:00:00","2018-06-11",263,9,0,36,12,320
"Bexley","13:00:00","2018-06-11",1504,20,31,485,343,2383
"Brent","13:00:00","2018-06-11",634,47,87,263,30,1061
"Bromley","13:00:00","2018-06-11",239,1,5,54,7,306
"Croydon","13:00:00","2018-06-11",1013,14,19,252,45,1343
"Enfield","13:00:00","2018-06-11",1067,28,21,300,100,1516
"Greenwich","13:00:00","2018-06-11",18,1,0,6,0,25
"Havering","13:00:00","2018-06-11",394,9,3,92,13,511
"Westminster","13:00:00","2018-06-11",25,4,0,10,2,41
"Barnet","14:00:00","2018-06-11",352,5,0,43,2,402
"Bexley","14:00:00","2018-06-11",1537,25,37,498,363,2460
"Brent","14:00:00","2018-06-11",595,32,86,237,34,984
"Bromley","14:00:00","2018-06-11",273,2,11,58,10,354
"Croydon","14:00:00","2018-06-11",1053,18,26,264,50,1411
"Enfield","14:00:00","2018-06-11",910,26,24,259,71,1290
"Greenwich","14:00:00","2018-06-11",18,0,1,4,0,23
"Havering","14:00:00","2018-06-11",470,8,2,85,11,576
"Westminster","14:00:00","2018-06-11",36,5,0,12,0,53
"Barnet","15:00:00","2018-06-11",371,7,4,53,2,437
"Bexley","15:00:00","2018-06-11",1656,26,28,451,281,2442
"Brent","15:00:00","2018-06-11",722,57,93,223,26,1121
"Bromley","15:00:00","2018-06-11",324,0,6,68,7,405
"Croydon","15:00:00","2018-06-11",1074,13,22,303,32,1444
"Enfield","15:00:00","2018-06-11",1007,23,12,262,66,1370
"Greenwich","15:00:00","2018-06-11",20,1,0,4,0,25
"Havering","15:00:00","2018-06-11",478,15,3,89,10,595
"Westminster","15:00:00","2018-06-11",35,5,0,8,0,48
"Barnet","16:00:00","2018-06-11",392,12,0,31,8,443
"Bexley","16:00:00","2018-06-11",1795,46,34,453,191,2519
"Brent","16:00:00","2018-06-11",701,68,100,203,23,1095
"Bromley","16:00:00","2018-06-11",388,10,5,87,2,492
"Croydon","16:00:00","2018-06-11",1295,26,19,302,25,1667
"Enfield","16:00:00","2018-06-11",1052,29,23,255,44,1403
"Greenwich","16:00:00","2018-06-11",27,0,0,6,0,33
"Havering","16:00:00","2018-06-11",713,6,2,167,7,895
"Westminster","16:00:00","2018-06-11",27,3,0,5,0,35
"Barnet","17:00:00","2018-06-11",430,9,0,54,1,494
"Bexley","17:00:00","2018-06-11",2198,57,32,417,189,2893
"Brent","17:00:00","2018-06-11",734,80,97,153,18,1082
"Bromley","17:00:00","2018-06-11",454,10,8,63,3,538
"Croydon","17:00:00","2018-06-11",1480,36,17,239,18,1790
"Enfield","17:00:00","2018-06-11",1372,38,17,239,41,1707
"Greenwich","17:00:00","2018-06-11",28,0,0,1,0,29
"Havering","17:00:00","2018-06-11",849,10,3,146,1,1009
"Westminster","17:00:00","2018-06-11",34,4,0,7,1,46
"Barnet","18:00:00","2018-06-11",411,8,0,46,2,467
"Bexley","18:00:00","2018-06-11",1986,31,31,278,114,2440
"Brent","18:00:00","2018-06-11",764,79,86,106,10,1045
"Bromley","18:00:00","2018-06-11",347,1,5,36,7,396
"Croydon","18:00:00","2018-06-11",1474,28,15,166,10,1693
"Enfield","18:00:00","2018-06-11",1176,27,14,168,15,1400
"Greenwich","18:00:00","2018-06-11",30,0,0,4,0,34
"Havering","18:00:00","2018-06-11",562,6,1,73,3,645
"Westminster","18:00:00","2018-06-11",41,3,0,5,0,49
"Barking and Dagenham","07:00:00","2018-06-12",3354,224,13,1133,817,5541
"Barnet","07:00:00","2018-06-12",237,6,0,38,0,281
"Brent","07:00:00","2018-06-12",22,0,0,6,0,28
"Hillingdon","07:00:00","2018-06-12",483,7,17,79,2,588
"Sutton","07:00:00","2018-06-12",18,3,0,2,0,23
"Wandsworth","07:00:00","2018-06-12",632,103,99,254,31,1119
"Barking and Dagenham","08:00:00","2018-06-12",3458,161,9,1051,796,5475
"Barnet","08:00:00","2018-06-12",372,2,0,30,1,405
"Brent","08:00:00","2018-06-12",58,0,0,4,1,63
"Hillingdon","08:00:00","2018-06-12",724,11,19,53,3,810
"Sutton","08:00:00","2018-06-12",20,0,0,1,0,21
"Wandsworth","08:00:00","2018-06-12",599,106,90,205,40,1040
"Barking and Dagenham","09:00:00","2018-06-12",2830,62,19,1033,1015,4959
"Barnet","09:00:00","2018-06-12",290,5,0,16,0,311
"Brent","09:00:00","2018-06-12",28,1,0,8,0,37
"Hillingdon","09:00:00","2018-06-12",384,5,24,52,10,475
"Sutton","09:00:00","2018-06-12",16,1,0,6,0,23
"Wandsworth","09:00:00","2018-06-12",568,55,108,203,45,979
"Barking and Dagenham","10:00:00","2018-06-12",2726,48,8,1044,1019,4845
"Barnet","10:00:00","2018-06-12",221,4,0,19,3,247
"Brent","10:00:00","2018-06-12",33,1,0,3,0,37
"Hillingdon","10:00:00","2018-06-12",315,4,19,65,9,412
"Sutton","10:00:00","2018-06-12",11,0,0,1,0,12
"Wandsworth","10:00:00","2018-06-12",561,48,91,219,40,959
"Barking and Dagenham","11:00:00","2018-06-12",2746,22,6,1006,1053,4833
"Barnet","11:00:00","2018-06-12",226,5,0,29,0,260
"Brent","11:00:00","2018-06-12",36,1,0,2,0,39
"Hillingdon","11:00:00","2018-06-12",320,4,20,66,10,420
"Sutton","11:00:00","2018-06-12",4,0,0,1,0,5
"Wandsworth","11:00:00","2018-06-12",624,42,93,238,41,1038
"Barking and Dagenham","12:00:00","2018-06-12",3008,37,5,1112,1048,5210
"Barnet","12:00:00","2018-06-12",221,5,0,19,0,245
"Brent","12:00:00","2018-06-12",29,1,0,5,0,35
"Hillingdon","12:00:00","2018-06-12",403,3,20,57,7,490
"Sutton","12:00:00","2018-06-12",6,0,0,5,0,11
"Wandsworth","12:00:00","2018-06-12",585,55,77,215,31,963
"Barking and Dagenham","13:00:00","2018-06-12",3161,50,12,1132,1112,5467
"Barnet","13:00:00","2018-06-12",250,4,0,28,4,286
"Brent","13:00:00","2018-06-12",29,1,1,5,0,36
"Hillingdon","13:00:00","2018-06-12",367,8,18,55,4,452
"Sutton","13:00:00","2018-06-12",6,0,0,1,0,7
"Wandsworth","13:00:00","2018-06-12",612,56,97,203,27,995
"Barking and Dagenham","14:00:00","2018-06-12",3628,74,18,1243,1005,5968
"Barnet","14:00:00","2018-06-12",262,2,0,38,0,302
"Brent","14:00:00","2018-06-12",39,1,0,4,0,44
"Hillingdon","14:00:00","2018-06-12",376,8,21,78,6,489
"Sutton","14:00:00","2018-06-12",13,1,0,3,0,17
"Wandsworth","14:00:00","2018-06-12",652,59,101,199,37,1048
"Barking and Dagenham","15:00:00","2018-06-12",3806,91,25,1374,887,6183
"Barnet","15:00:00","2018-06-12",342,7,0,49,1,399
"Brent","15:00:00","2018-06-12",72,1,1,7,0,81
"Hillingdon","15:00:00","2018-06-12",547,3,19,58,5,632
"Sutton","15:00:00","2018-06-12",8,0,0,1,0,9
"Wandsworth","15:00:00","2018-06-12",685,49,86,147,16,983
"Barking and Dagenham","16:00:00","2018-06-12",4840,162,15,1463,585,7065
"Barnet","16:00:00","2018-06-12",390,11,2,35,2,440
"Brent","16:00:00","2018-06-12",57,0,0,10,0,67
"Hillingdon","16:00:00","2018-06-12",525,14,20,90,4,653
"Sutton","16:00:00","2018-06-12",14,0,0,3,0,17
"Wandsworth","16:00:00","2018-06-12",716,87,93,172,17,1085
"Barking and Dagenham","17:00:00","2018-06-12",5506,241,18,1187,411,7363
"Barnet","17:00:00","2018-06-12",390,6,0,37,0,433
"Brent","17:00:00","2018-06-12",50,0,0,6,0,56
"Hillingdon","17:00:00","2018-06-12",636,9,20,79,3,747
"Sutton","17:00:00","2018-06-12",16,0,0,2,0,18
"Wandsworth","17:00:00","2018-06-12",772,146,89,138,9,1154
"Barking and Dagenham","18:00:00","2018-06-12",4943,206,16,876,348,6389
"Barnet","18:00:00","2018-06-12",292,1,0,28,0,321
"Brent","18:00:00","2018-06-12",38,1,0,2,0,41
"Hillingdon","18:00:00","2018-06-12",502,10,20,47,1,580
"Sutton","18:00:00","2018-06-12",20,0,0,1,0,21
"Wandsworth","18:00:00","2018-06-12",748,124,87,101,9,1069
"Barnet","07:00:00","2018-06-13",3890,170,25,1413,407,5905
"Bexley","07:00:00","2018-06-13",1350,15,21,260,14,1660
"Bromley","07:00:00","2018-06-13",370,3,9,78,5,465
"Camden","07:00:00","2018-06-13",617,67,18,219,35,956
"Havering","07:00:00","2018-06-13",12,1,1,3,0,17
"Hounslow","07:00:00","2018-06-13",1333,23,0,210,14,1580
"Lewisham","07:00:00","2018-06-13",527,146,72,215,105,1065
"Richmond upon Thames","07:00:00","2018-06-13",467,18,10,61,10,566
"Wandsworth","07:00:00","2018-06-13",65,1,0,10,2,78
"Barnet","08:00:00","2018-06-13",4108,127,40,929,364,5568
"Bexley","08:00:00","2018-06-13",1472,43,31,212,24,1782
"Bromley","08:00:00","2018-06-13",546,5,13,86,5,655
"Camden","08:00:00","2018-06-13",679,99,26,267,27,1098
"Havering","08:00:00","2018-06-13",29,0,0,9,1,39
"Hounslow","08:00:00","2018-06-13",1438,15,2,174,29,1658
"Lewisham","08:00:00","2018-06-13",631,114,67,226,97,1135
"Richmond upon Thames","08:00:00","2018-06-13",576,28,12,43,7,666
"Wandsworth","08:00:00","2018-06-13",124,1,0,21,0,146
"Barnet","09:00:00","2018-06-13",3424,61,40,949,432,4906
"Bexley","09:00:00","2018-06-13",1469,18,32,252,28,1799
"Bromley","09:00:00","2018-06-13",404,7,7,77,7,502
"Camden","09:00:00","2018-06-13",785,72,20,220,51,1148
"Havering","09:00:00","2018-06-13",21,0,0,3,0,24
"Hounslow","09:00:00","2018-06-13",915,17,0,149,23,1104
"Lewisham","09:00:00","2018-06-13",587,41,66,211,92,997
"Richmond upon Thames","09:00:00","2018-06-13",350,14,9,55,13,441
"Wandsworth","09:00:00","2018-06-13",56,0,0,14,0,70
"Barnet","10:00:00","2018-06-13",3255,37,22,977,503,4794
"Bexley","10:00:00","2018-06-13",1238,14,24,215,27,1518
"Bromley","10:00:00","2018-06-13",225,5,5,29,5,269
"Camden","10:00:00","2018-06-13",768,49,30,261,58,1166
"Havering","10:00:00","2018-06-13",27,0,0,5,2,34
"Hounslow","10:00:00","2018-06-13",650,5,1,122,16,794
"Lewisham","10:00:00","2018-06-13",697,32,65,228,107,1129
"Richmond upon Thames","10:00:00","2018-06-13",286,12,8,59,16,381
"Wandsworth","10:00:00","2018-06-13",68,1,0,12,0,81
"Barnet","11:00:00","2018-06-13",3141,62,26,990,461,4680
"Bexley","11:00:00","2018-06-13",1368,17,24,199,33,1641
"Bromley","11:00:00","2018-06-13",243,6,7,44,7,307
"Camden","11:00:00","2018-06-13",728,42,25,270,45,1110
"Havering","11:00:00","2018-06-13",23,0,0,3,2,28
"Hounslow","11:00:00","2018-06-13",574,4,1,169,18,766
"Lewisham","11:00:00","2018-06-13",677,40,49,244,92,1102
"Richmond upon Thames","11:00:00","2018-06-13",260,11,11,58,11,351
"Wandsworth","11:00:00","2018-06-13",57,1,0,11,1,70
"Barnet","12:00:00","2018-06-13",3213,61,26,1019,463,4782
"Bexley","12:00:00","2018-06-13",1311,20,26,200,18,1575
"Bromley","12:00:00","2018-06-13",347,2,7,38,2,396
"Camden","12:00:00","2018-06-13",741,37,21,234,54,1087
"Havering","12:00:00","2018-06-13",19,0,0,0,0,19
"Hounslow","12:00:00","2018-06-13",655,11,0,134,14,814
"Lewisham","12:00:00","2018-06-13",642,43,47,243,116,1091
"Richmond upon Thames","12:00:00","2018-06-13",338,10,8,68,14,438
"Wandsworth","12:00:00","2018-06-13",49,2,0,10,1,62
"Barnet","13:00:00","2018-06-13",3703,82,25,1169,504,5483
"Bexley","13:00:00","2018-06-13",1281,17,23,210,21,1552
"Bromley","13:00:00","2018-06-13",254,5,7,61,0,327
"Camden","13:00:00","2018-06-13",803,53,24,270,54,1204
"Havering","13:00:00","2018-06-13",16,0,0,4,2,22
"Hounslow","13:00:00","2018-06-13",726,7,0,137,23,893
"Lewisham","13:00:00","2018-06-13",823,37,51,240,109,1260
"Richmond upon Thames","13:00:00","2018-06-13",299,9,11,48,11,378
"Wandsworth","13:00:00","2018-06-13",60,2,0,7,0,69
"Barnet","14:00:00","2018-06-13",3765,87,32,1141,450,5475
"Bexley","14:00:00","2018-06-13",1417,15,32,222,24,1710
"Bromley","14:00:00","2018-06-13",328,6,8,43,6,391
"Camden","14:00:00","2018-06-13",722,43,32,269,32,1098
"Havering","14:00:00","2018-06-13",19,3,0,8,0,30
"Hounslow","14:00:00","2018-06-13",850,13,1,193,16,1073
"Lewisham","14:00:00","2018-06-13",882,44,70,247,70,1313
"Richmond upon Thames","14:00:00","2018-06-13",265,16,10,51,15,357
"Wandsworth","14:00:00","2018-06-13",55,1,0,12,0,68
"Barnet","15:00:00","2018-06-13",4008,93,41,1041,337,5520
"Bexley","15:00:00","2018-06-13",1531,18,27,233,20,1829
"Bromley","15:00:00","2018-06-13",425,3,5,78,2,513
"Camden","15:00:00","2018-06-13",862,67,23,161,31,1144
"Havering","15:00:00","2018-06-13",12,0,0,11,3,26
"Hounslow","15:00:00","2018-06-13",990,15,1,200,16,1222
"Lewisham","15:00:00","2018-06-13",714,54,68,255,52,1143
"Richmond upon Thames","15:00:00","2018-06-13",517,16,13,79,2,627
"Wandsworth","15:00:00","2018-06-13",68,2,1,7,1,79
"Barnet","16:00:00","2018-06-13",4218,126,30,1171,190,5735
"Bexley","16:00:00","2018-06-13",1607,24,24,244,8,1907
"Bromley","16:00:00","2018-06-13",429,3,7,42,1,482
"Camden","16:00:00","2018-06-13",926,100,28,186,31,1271
"Havering","16:00:00","2018-06-13",27,1,1,11,2,42
"Hounslow","16:00:00","2018-06-13",1618,25,1,225,16,1885
"Lewisham","16:00:00","2018-06-13",884,101,66,263,45,1359
"Richmond upon Thames","16:00:00","2018-06-13",558,20,15,68,2,663
"Wandsworth","16:00:00","2018-06-13",79,2,1,4,0,86
"Barnet","17:00:00","2018-06-13",4346,176,28,986,164,5700
"Bexley","17:00:00","2018-06-13",1757,38,21,210,10,2036
"Bromley","17:00:00","2018-06-13",417,3,8,32,1,461
"Camden","17:00:00","2018-06-13",937,105,25,176,17,1260
"Havering","17:00:00","2018-06-13",26,0,2,2,0,30
"Hounslow","17:00:00","2018-06-13",1834,24,1,194,16,2069
"Lewisham","17:00:00","2018-06-13",994,165,67,192,22,1440
"Richmond upon Thames","17:00:00","2018-06-13",651,35,9,73,1,769
"Wandsworth","17:00:00","2018-06-13",78,2,0,8,0,88
"Barnet","18:00:00","2018-06-13",5151,169,27,827,149,6323
"Bexley","18:00:00","2018-06-13",1557,30,22,169,8,1786
"Bromley","18:00:00","2018-06-13",439,3,9,25,0,476
"Camden","18:00:00","2018-06-13",1018,153,17,100,16,1304
"Havering","18:00:00","2018-06-13",39,0,0,2,0,41
"Hounslow","18:00:00","2018-06-13",1322,29,2,116,7,1476
"Lewisham","18:00:00","2018-06-13",1035,145,72,131,18,1401
"Richmond upon Thames","18:00:00","2018-06-13",648,34,10,45,1,738
"Wandsworth","18:00:00","2018-06-13",65,4,0,4,0,73
"Barnet","07:00:00","2018-06-14",134,0,2,14,6,156
"Hillingdon","07:00:00","2018-06-14",848,9,9,163,35,1064
"Islington","07:00:00","2018-06-14",633,109,49,308,104,1203
"Kensington and Chelsea","07:00:00","2018-06-14",662,78,42,297,63,1142
"Kingston upon Thames","07:00:00","2018-06-14",109,0,18,24,1,152
"Redbridge","07:00:00","2018-06-14",73,2,1,10,0,86
"Richmond upon Thames","07:00:00","2018-06-14",1966,144,95,613,28,2846
"Wandsworth","07:00:00","2018-06-14",1155,99,9,341,48,1652
"Barnet","08:00:00","2018-06-14",202,1,0,16,2,221
"Hillingdon","08:00:00","2018-06-14",1283,5,15,168,24,1495
"Islington","08:00:00","2018-06-14",690,122,50,292,94,1248
"Kensington and Chelsea","08:00:00","2018-06-14",807,65,35,359,84,1350
"Kingston upon Thames","08:00:00","2018-06-14",226,1,18,21,1,267
"Redbridge","08:00:00","2018-06-14",145,0,1,13,0,159
"Richmond upon Thames","08:00:00","2018-06-14",1935,144,111,412,47,2649
"Wandsworth","08:00:00","2018-06-14",1259,92,2,302,48,1703
"Barnet","09:00:00","2018-06-14",83,0,0,27,0,110
"Hillingdon","09:00:00","2018-06-14",870,9,13,157,41,1090
"Islington","09:00:00","2018-06-14",724,106,48,318,88,1284
"Kensington and Chelsea","09:00:00","2018-06-14",742,51,57,365,83,1298
"Kingston upon Thames","09:00:00","2018-06-14",106,1,19,21,0,147
"Redbridge","09:00:00","2018-06-14",112,0,0,22,0,134
"Richmond upon Thames","09:00:00","2018-06-14",1996,85,115,427,39,2662
"Wandsworth","09:00:00","2018-06-14",1054,39,9,321,60,1483
"Barnet","10:00:00","2018-06-14",77,0,0,24,1,102
"Hillingdon","10:00:00","2018-06-14",676,9,9,136,38,868
"Islington","10:00:00","2018-06-14",755,76,50,364,85,1330
"Kensington and Chelsea","10:00:00","2018-06-14",782,37,34,366,68,1287
"Kingston upon Thames","10:00:00","2018-06-14",107,0,16,25,0,148
"Redbridge","10:00:00","2018-06-14",81,0,0,18,3,102
"Richmond upon Thames","10:00:00","2018-06-14",1677,40,104,433,46,2300
"Wandsworth","10:00:00","2018-06-14",970,36,5,368,66,1445
"Barnet","11:00:00","2018-06-14",87,0,3,19,3,112
"Hillingdon","11:00:00","2018-06-14",614,2,17,147,41,821
"Islington","11:00:00","2018-06-14",682,61,41,335,100,1219
"Kensington and Chelsea","11:00:00","2018-06-14",711,58,34,338,99,1240
"Kingston upon Thames","11:00:00","2018-06-14",119,0,15,17,0,151
"Redbridge","11:00:00","2018-06-14",104,0,0,8,4,116
"Richmond upon Thames","11:00:00","2018-06-14",1493,56,109,362,47,2067
"Wandsworth","11:00:00","2018-06-14",992,50,3,404,77,1526
"Barnet","12:00:00","2018-06-14",93,1,2,18,3,117
"Hillingdon","12:00:00","2018-06-14",829,4,11,145,27,1016
"Islington","12:00:00","2018-06-14",629,60,50,277,88,1104
"Kensington and Chelsea","12:00:00","2018-06-14",724,56,37,359,74,1250
"Kingston upon Thames","12:00:00","2018-06-14",110,0,16,18,2,146
"Redbridge","12:00:00","2018-06-14",104,6,0,7,0,117
"Richmond upon Thames","12:00:00","2018-06-14",1593,60,95,353,43,2144
"Wandsworth","12:00:00","2018-06-14",1170,77,3,413,57,1720
"Barnet","13:00:00","2018-06-14",91,2,0,20,3,116
"Hillingdon","13:00:00","2018-06-14",890,2,14,187,33,1126
"Islington","13:00:00","2018-06-14",762,78,39,295,67,1241
"Kensington and Chelsea","13:00:00","2018-06-14",855,82,31,410,69,1447
"Kingston upon Thames","13:00:00","2018-06-14",94,0,17,13,2,126
"Redbridge","13:00:00","2018-06-14",113,0,0,8,0,121
"Richmond upon Thames","13:00:00","2018-06-14",1644,70,112,369,42,2237
"Wandsworth","13:00:00","2018-06-14",1035,65,3,376,47,1526
"Barnet","14:00:00","2018-06-14",88,3,0,23,2,116
"Hillingdon","14:00:00","2018-06-14",794,9,16,193,35,1047
"Islington","14:00:00","2018-06-14",649,65,49,243,72,1078
"Kensington and Chelsea","14:00:00","2018-06-14",806,76,42,305,74,1303
"Kingston upon Thames","14:00:00","2018-06-14",145,0,19,16,1,181
"Redbridge","14:00:00","2018-06-14",98,0,0,16,3,117
"Richmond upon Thames","14:00:00","2018-06-14",1926,63,122,463,35,2609
"Wandsworth","14:00:00","2018-06-14",1109,67,4,435,51,1666
"Barnet","15:00:00","2018-06-14",149,3,1,21,0,174
"Hillingdon","15:00:00","2018-06-14",1021,7,12,170,23,1233
"Islington","15:00:00","2018-06-14",768,94,42,278,49,1231
"Kensington and Chelsea","15:00:00","2018-06-14",725,52,52,342,57,1228
"Kingston upon Thames","15:00:00","2018-06-14",145,0,17,23,1,186
"Redbridge","15:00:00","2018-06-14",182,0,1,22,0,205
"Richmond upon Thames","15:00:00","2018-06-14",1584,54,97,344,38,2117
"Wandsworth","15:00:00","2018-06-14",1258,85,9,401,35,1788
"Barnet","16:00:00","2018-06-14",184,0,1,29,1,215
"Hillingdon","16:00:00","2018-06-14",1250,7,15,232,25,1529
"Islington","16:00:00","2018-06-14",983,128,46,371,48,1576
"Kensington and Chelsea","16:00:00","2018-06-14",943,112,47,261,46,1409
"Kingston upon Thames","16:00:00","2018-06-14",151,6,20,18,0,195
"Redbridge","16:00:00","2018-06-14",131,0,0,15,0,146
"Richmond upon Thames","16:00:00","2018-06-14",1733,54,99,351,23,2260
"Wandsworth","16:00:00","2018-06-14",1263,157,4,422,38,1884
"Barnet","17:00:00","2018-06-14",204,2,2,22,2,232
"Hillingdon","17:00:00","2018-06-14",1288,12,9,148,12,1469
"Islington","17:00:00","2018-06-14",1104,179,48,294,37,1662
"Kensington and Chelsea","17:00:00","2018-06-14",922,140,38,189,26,1315
"Kingston upon Thames","17:00:00","2018-06-14",161,3,18,15,0,197
"Redbridge","17:00:00","2018-06-14",125,1,0,15,0,141
"Richmond upon Thames","17:00:00","2018-06-14",2186,147,107,294,15,2749
"Wandsworth","17:00:00","2018-06-14",1255,223,8,286,17,1789
"Barnet","18:00:00","2018-06-14",193,0,1,13,0,207
"Hillingdon","18:00:00","2018-06-14",1203,7,13,106,7,1336
"Islington","18:00:00","2018-06-14",1168,188,41,201,20,1618
"Kensington and Chelsea","18:00:00","2018-06-14",1128,105,32,90,23,1378
"Kingston upon Thames","18:00:00","2018-06-14",176,4,13,13,0,206
"Redbridge","18:00:00","2018-06-14",122,2,0,10,0,134
"Richmond upon Thames","18:00:00","2018-06-14",1762,92,117,250,11,2232
"Wandsworth","18:00:00","2018-06-14",1406,239,6,176,8,1835
"Brent","07:00:00","2018-06-15",985,27,71,106,28,1217
"Croydon","07:00:00","2018-06-15",289,5,0,63,14,371
"Havering","07:00:00","2018-06-15",217,1,9,50,8,285
"Hillingdon","07:00:00","2018-06-15",46,0,0,9,0,55
"Kingston upon Thames","07:00:00","2018-06-15",1400,37,44,318,30,1829
"Lewisham","07:00:00","2018-06-15",400,24,6,138,5,573
"Sutton","07:00:00","2018-06-15",712,16,27,226,35,1016
"Tower Hamlets","07:00:00","2018-06-15",4242,291,84,2002,453,7072
"Wandsworth","07:00:00","2018-06-15",759,20,0,169,7,955
"Westminster","07:00:00","2018-06-15",349,72,174,271,76,942
"Brent","08:00:00","2018-06-15",1220,22,74,90,21,1427
"Croydon","08:00:00","2018-06-15",255,2,1,54,8,320
"Havering","08:00:00","2018-06-15",305,4,11,43,5,368
"Hillingdon","08:00:00","2018-06-15",89,3,0,9,2,103
"Kingston upon Thames","08:00:00","2018-06-15",1659,30,45,243,24,2001
"Lewisham","08:00:00","2018-06-15",481,6,9,64,4,564
"Sutton","08:00:00","2018-06-15",705,15,22,165,37,944
"Tower Hamlets","08:00:00","2018-06-15",4062,221,80,1528,475,6366
"Wandsworth","08:00:00","2018-06-15",754,19,0,131,4,908
"Westminster","08:00:00","2018-06-15",361,112,194,273,60,1000
"Brent","09:00:00","2018-06-15",1138,22,61,115,21,1357
"Croydon","09:00:00","2018-06-15",164,2,0,35,28,229
"Havering","09:00:00","2018-06-15",218,3,8,56,8,293
"Hillingdon","09:00:00","2018-06-15",59,0,0,8,1,68
"Kingston upon Thames","09:00:00","2018-06-15",1376,26,61,259,39,1761
"Lewisham","09:00:00","2018-06-15",427,4,5,77,7,520
"Sutton","09:00:00","2018-06-15",660,8,37,197,44,946
"Tower Hamlets","09:00:00","2018-06-15",3928,148,70,1386,524,6056
"Wandsworth","09:00:00","2018-06-15",779,10,3,151,0,943
"Westminster","09:00:00","2018-06-15",342,98,206,272,50,968
"Brent","10:00:00","2018-06-15",1105,20,66,91,32,1314
"Croydon","10:00:00","2018-06-15",112,0,0,35,11,158
"Havering","10:00:00","2018-06-15",225,1,11,41,6,284
"Hillingdon","10:00:00","2018-06-15",39,1,1,11,0,52
"Kingston upon Thames","10:00:00","2018-06-15",1232,25,48,244,30,1579
"Lewisham","10:00:00","2018-06-15",390,8,8,72,8,486
"Sutton","10:00:00","2018-06-15",545,10,25,176,52,808
"Tower Hamlets","10:00:00","2018-06-15",3982,116,72,1398,586,6154
"Wandsworth","10:00:00","2018-06-15",676,17,1,148,3,845
"Westminster","10:00:00","2018-06-15",459,77,193,268,41,1038
"Brent","11:00:00","2018-06-15",1229,32,61,115,15,1452
"Croydon","11:00:00","2018-06-15",92,3,0,31,9,135
"Havering","11:00:00","2018-06-15",222,0,11,59,6,298
"Hillingdon","11:00:00","2018-06-15",50,0,0,8,1,59
"Kingston upon Thames","11:00:00","2018-06-15",1327,31,48,265,29,1700
"Lewisham","11:00:00","2018-06-15",362,6,5,70,4,447
"Sutton","11:00:00","2018-06-15",600,11,25,204,42,882
"Tower Hamlets","11:00:00","2018-06-15",4059,160,65,1353,486,6123
"Wandsworth","11:00:00","2018-06-15",711,17,1,138,3,870
"Westminster","11:00:00","2018-06-15",538,67,210,238,21,1074
"Brent","12:00:00","2018-06-15",1333,27,69,127,20,1576
"Croydon","12:00:00","2018-06-15",117,4,1,30,11,163
"Havering","12:00:00","2018-06-15",235,5,13,43,0,296
"Hillingdon","12:00:00","2018-06-15",42,0,2,9,2,55
"Kingston upon Thames","12:00:00","2018-06-15",1369,34,52,250,38,1743
"Lewisham","12:00:00","2018-06-15",375,4,3,57,5,444
"Sutton","12:00:00","2018-06-15",679,12,26,205,49,971
"Tower Hamlets","12:00:00","2018-06-15",4526,153,72,1381,513,6645
"Wandsworth","12:00:00","2018-06-15",784,15,1,179,2,981
"Westminster","12:00:00","2018-06-15",437,62,199,210,30,938
"Brent","13:00:00","2018-06-15",1186,49,55,79,19,1388
"Croydon","13:00:00","2018-06-15",135,4,0,27,10,176
"Havering","13:00:00","2018-06-15",280,1,10,60,1,352
"Hillingdon","13:00:00","2018-06-15",45,3,1,10,1,60
"Kingston upon Thames","13:00:00","2018-06-15",1318,34,45,242,34,1673
"Lewisham","13:00:00","2018-06-15",460,12,8,84,1,565
"Sutton","13:00:00","2018-06-15",723,15,25,198,41,1002
"Tower Hamlets","13:00:00","2018-06-15",4610,163,80,1378,444,6675
"Wandsworth","13:00:00","2018-06-15",753,13,0,155,3,924
"Westminster","13:00:00","2018-06-15",465,66,218,228,43,1020
"Brent","14:00:00","2018-06-15",1254,38,53,89,24,1458
"Croydon","14:00:00","2018-06-15",154,2,2,40,14,212
"Havering","14:00:00","2018-06-15",299,0,8,49,4,360
"Hillingdon","14:00:00","2018-06-15",48,0,0,5,1,54
"Kingston upon Thames","14:00:00","2018-06-15",1341,33,58,242,21,1695
"Lewisham","14:00:00","2018-06-15",404,15,3,59,4,485
"Sutton","14:00:00","2018-06-15",752,15,26,213,32,1038
"Tower Hamlets","14:00:00","2018-06-15",4974,179,66,1369,449,7037
"Wandsworth","14:00:00","2018-06-15",855,21,1,168,3,1048
"Westminster","14:00:00","2018-06-15",537,60,203,195,26,1021
"Brent","15:00:00","2018-06-15",1292,28,63,122,11,1516
"Croydon","15:00:00","2018-06-15",265,3,2,42,7,319
"Havering","15:00:00","2018-06-15",373,2,8,59,13,455
"Hillingdon","15:00:00","2018-06-15",100,5,1,9,1,116
"Kingston upon Thames","15:00:00","2018-06-15",1601,51,46,237,16,1951
"Lewisham","15:00:00","2018-06-15",533,10,7,74,2,626
"Sutton","15:00:00","2018-06-15",793,17,26,186,31,1053
"Tower Hamlets","15:00:00","2018-06-15",4910,216,82,1265,322,6795
"Wandsworth","15:00:00","2018-06-15",977,27,3,165,1,1173
"Westminster","15:00:00","2018-06-15",437,82,200,152,23,894
"Brent","16:00:00","2018-06-15",1340,41,51,100,2,1534
"Croydon","16:00:00","2018-06-15",265,6,1,55,1,328
"Havering","16:00:00","2018-06-15",298,1,8,44,4,355
"Hillingdon","16:00:00","2018-06-15",74,2,0,7,0,83
"Kingston upon Thames","16:00:00","2018-06-15",1506,47,45,252,5,1855
"Lewisham","16:00:00","2018-06-15",624,18,12,95,4,753
"Sutton","16:00:00","2018-06-15",937,21,22,217,14,1211
"Tower Hamlets","16:00:00","2018-06-15",5090,254,70,1133,183,6730
"Wandsworth","16:00:00","2018-06-15",799,29,1,140,1,970
"Westminster","16:00:00","2018-06-15",599,125,221,194,20,1159
"Brent","17:00:00","2018-06-15",1413,39,60,99,7,1618
"Croydon","17:00:00","2018-06-15",271,2,0,49,1,323
"Havering","17:00:00","2018-06-15",309,2,9,50,5,375
"Hillingdon","17:00:00","2018-06-15",89,4,0,15,0,108
"Kingston upon Thames","17:00:00","2018-06-15",1494,57,44,160,4,1759
"Lewisham","17:00:00","2018-06-15",631,22,11,78,0,742
"Sutton","17:00:00","2018-06-15",940,22,26,178,13,1179
"Tower Hamlets","17:00:00","2018-06-15",5160,319,63,825,120,6487
"Wandsworth","17:00:00","2018-06-15",947,25,2,125,0,1099
"Westminster","17:00:00","2018-06-15",531,126,210,106,6,979
"Brent","18:00:00","2018-06-15",1262,37,48,59,2,1408
"Croydon","18:00:00","2018-06-15",356,4,1,37,1,399
"Havering","18:00:00","2018-06-15",140,1,9,34,1,185
"Hillingdon","18:00:00","2018-06-15",78,2,0,7,0,87
"Kingston upon Thames","18:00:00","2018-06-15",1456,53,43,141,2,1695
"Lewisham","18:00:00","2018-06-15",688,8,6,69,1,772
"Sutton","18:00:00","2018-06-15",923,11,21,101,3,1059
"Tower Hamlets","18:00:00","2018-06-15",5606,244,72,666,95,6683
"Wandsworth","18:00:00","2018-06-15",948,24,1,64,1,1038
"Westminster","18:00:00","2018-06-15",836,118,204,81,7,1246
"Barnet","07:00:00","2018-06-18",26,0,0,4,1,31
"Brent","07:00:00","2018-06-18",1155,52,34,321,31,1593
"Camden","07:00:00","2018-06-18",78,15,0,92,20,205
"Greenwich","07:00:00","2018-06-18",20,1,0,0,0,21
"Haringey","07:00:00","2018-06-18",789,41,74,301,30,1235
"Harrow","07:00:00","2018-06-18",1074,8,38,162,25,1307
"Havering","07:00:00","2018-06-18",76,1,0,15,1,93
"Newham","07:00:00","2018-06-18",1293,33,24,234,128,1712
"Richmond upon Thames","07:00:00","2018-06-18",107,1,0,14,0,122
"Barnet","08:00:00","2018-06-18",47,0,0,3,0,50
"Brent","08:00:00","2018-06-18",1315,52,32,261,40,1700
"Camden","08:00:00","2018-06-18",135,28,1,111,19,294
"Greenwich","08:00:00","2018-06-18",21,0,1,5,0,27
"Haringey","08:00:00","2018-06-18",976,41,83,246,22,1368
"Harrow","08:00:00","2018-06-18",1151,7,35,105,24,1322
"Havering","08:00:00","2018-06-18",191,2,0,21,1,215
"Newham","08:00:00","2018-06-18",1192,16,19,192,136,1555
"Richmond upon Thames","08:00:00","2018-06-18",298,0,1,20,0,319
"Barnet","09:00:00","2018-06-18",10,0,0,6,0,16
"Brent","09:00:00","2018-06-18",1262,26,45,250,38,1621
"Camden","09:00:00","2018-06-18",193,33,0,118,27,371
"Greenwich","09:00:00","2018-06-18",12,0,0,3,0,15
"Haringey","09:00:00","2018-06-18",897,32,79,243,32,1283
"Harrow","09:00:00","2018-06-18",850,2,39,129,29,1049
"Havering","09:00:00","2018-06-18",88,0,0,13,0,101
"Newham","09:00:00","2018-06-18",827,17,16,171,222,1253
"Richmond upon Thames","09:00:00","2018-06-18",83,2,0,22,0,107
"Barnet","10:00:00","2018-06-18",7,0,0,1,1,9
"Brent","10:00:00","2018-06-18",955,19,32,248,51,1305
"Camden","10:00:00","2018-06-18",199,22,0,156,24,401
"Greenwich","10:00:00","2018-06-18",11,0,0,1,0,12
"Haringey","10:00:00","2018-06-18",708,32,68,238,38,1084
"Harrow","10:00:00","2018-06-18",805,4,26,141,27,1003
"Havering","10:00:00","2018-06-18",42,0,0,9,0,51
"Newham","10:00:00","2018-06-18",749,16,18,186,232,1201
"Richmond upon Thames","10:00:00","2018-06-18",40,0,0,5,0,45
"Barnet","11:00:00","2018-06-18",11,0,0,3,0,14
"Brent","11:00:00","2018-06-18",1016,21,29,250,41,1357
"Camden","11:00:00","2018-06-18",240,29,0,154,9,432
"Greenwich","11:00:00","2018-06-18",15,0,0,3,0,18
"Haringey","11:00:00","2018-06-18",818,35,63,231,59,1206
"Harrow","11:00:00","2018-06-18",766,3,33,177,29,1008
"Havering","11:00:00","2018-06-18",60,1,0,8,0,69
"Newham","11:00:00","2018-06-18",784,11,13,201,194,1203
"Richmond upon Thames","11:00:00","2018-06-18",28,1,0,8,0,37
"Barnet","12:00:00","2018-06-18",14,0,0,3,0,17
"Brent","12:00:00","2018-06-18",1119,28,29,253,35,1464
"Camden","12:00:00","2018-06-18",280,36,0,149,16,481
"Greenwich","12:00:00","2018-06-18",10,1,0,5,0,16
"Haringey","12:00:00","2018-06-18",737,30,59,207,31,1064
"Harrow","12:00:00","2018-06-18",780,5,27,160,31,1003
"Havering","12:00:00","2018-06-18",72,0,0,10,0,82
"Newham","12:00:00","2018-06-18",850,20,14,195,168,1247
"Richmond upon Thames","12:00:00","2018-06-18",29,0,0,8,1,38
"Barnet","13:00:00","2018-06-18",18,0,0,2,0,20
"Brent","13:00:00","2018-06-18",1127,24,34,254,35,1474
"Camden","13:00:00","2018-06-18",307,29,0,156,9,501
"Greenwich","13:00:00","2018-06-18",16,1,0,7,2,26
"Haringey","13:00:00","2018-06-18",760,40,61,198,25,1084
"Harrow","13:00:00","2018-06-18",790,9,22,114,29,964
"Havering","13:00:00","2018-06-18",66,0,0,7,0,73
"Newham","13:00:00","2018-06-18",841,29,15,198,190,1273
"Richmond upon Thames","13:00:00","2018-06-18",21,1,0,0,0,22
"Barnet","14:00:00","2018-06-18",17,0,0,3,0,20
"Brent","14:00:00","2018-06-18",1228,27,38,269,33,1595
"Camden","14:00:00","2018-06-18",285,22,0,142,7,456
"Greenwich","14:00:00","2018-06-18",15,0,0,4,0,19
"Haringey","14:00:00","2018-06-18",841,59,71,209,28,1208
"Harrow","14:00:00","2018-06-18",1066,12,28,133,35,1274
"Havering","14:00:00","2018-06-18",77,1,0,6,0,84
"Newham","14:00:00","2018-06-18",838,26,15,188,186,1253
"Richmond upon Thames","14:00:00","2018-06-18",67,0,0,7,0,74
"Barnet","15:00:00","2018-06-18",17,0,0,2,0,19
"Brent","15:00:00","2018-06-18",1332,35,30,285,26,1708
"Camden","15:00:00","2018-06-18",236,39,0,108,9,392
"Greenwich","15:00:00","2018-06-18",15,0,1,3,0,19
"Haringey","15:00:00","2018-06-18",800,54,69,204,25,1152
"Harrow","15:00:00","2018-06-18",972,9,32,92,17,1122
"Havering","15:00:00","2018-06-18",87,0,0,10,0,97
"Newham","15:00:00","2018-06-18",1016,33,15,202,151,1417
"Richmond upon Thames","15:00:00","2018-06-18",43,1,0,5,0,49
"Barnet","16:00:00","2018-06-18",33,0,0,1,0,34
"Brent","16:00:00","2018-06-18",1493,48,33,281,15,1870
"Camden","16:00:00","2018-06-18",228,38,0,96,3,365
"Greenwich","16:00:00","2018-06-18",12,0,0,3,1,16
"Haringey","16:00:00","2018-06-18",917,57,69,244,13,1300
"Harrow","16:00:00","2018-06-18",1013,12,31,121,21,1198
"Havering","16:00:00","2018-06-18",61,0,0,12,0,73
"Newham","16:00:00","2018-06-18",1318,47,16,220,116,1717
"Richmond upon Thames","16:00:00","2018-06-18",102,0,1,11,0,114
"Barnet","17:00:00","2018-06-18",18,0,0,4,0,22
"Brent","17:00:00","2018-06-18",1604,79,39,292,6,2020
"Camden","17:00:00","2018-06-18",212,55,1,71,0,339
"Greenwich","17:00:00","2018-06-18",23,0,0,1,0,24
"Haringey","17:00:00","2018-06-18",1106,65,70,171,2,1414
"Harrow","17:00:00","2018-06-18",1072,13,25,86,10,1206
"Havering","17:00:00","2018-06-18",159,1,0,16,0,176
"Newham","17:00:00","2018-06-18",1586,36,15,183,64,1884
"Richmond upon Thames","17:00:00","2018-06-18",114,1,0,7,1,123
"Barnet","18:00:00","2018-06-18",42,0,0,2,0,44
"Brent","18:00:00","2018-06-18",1602,57,35,223,12,1929
"Camden","18:00:00","2018-06-18",159,48,1,47,0,255
"Greenwich","18:00:00","2018-06-18",12,0,0,2,0,14
"Haringey","18:00:00","2018-06-18",1171,109,83,120,5,1488
"Harrow","18:00:00","2018-06-18",1228,22,30,81,5,1366
"Havering","18:00:00","2018-06-18",122,0,0,9,1,132
"Newham","18:00:00","2018-06-18",1723,51,17,152,54,1997
"Richmond upon Thames","18:00:00","2018-06-18",106,1,0,6,0,113
"Barnet","07:00:00","2018-06-19",3726,185,114,1254,185,5464
"Camden","07:00:00","2018-06-19",334,62,106,281,27,810
"Greenwich","07:00:00","2018-06-19",31,1,0,9,0,41
"Hillingdon","07:00:00","2018-06-19",262,1,0,49,5,317
"Lambeth","07:00:00","2018-06-19",856,77,57,502,80,1572
"Newham","07:00:00","2018-06-19",94,1,0,24,0,119
"Redbridge","07:00:00","2018-06-19",3215,198,34,1250,310,5007
"Barnet","08:00:00","2018-06-19",4056,173,98,943,150,5420
"Camden","08:00:00","2018-06-19",414,99,96,260,39,908
"Greenwich","08:00:00","2018-06-19",74,0,1,15,0,90
"Hillingdon","08:00:00","2018-06-19",417,4,0,58,6,485
"Lambeth","08:00:00","2018-06-19",1023,84,74,493,105,1779
"Newham","08:00:00","2018-06-19",245,2,0,23,2,272
"Redbridge","08:00:00","2018-06-19",3578,139,28,1037,328,5110
"Barnet","09:00:00","2018-06-19",3659,93,102,1056,233,5143
"Camden","09:00:00","2018-06-19",525,88,104,289,24,1030
"Greenwich","09:00:00","2018-06-19",56,1,0,14,1,72
"Hillingdon","09:00:00","2018-06-19",226,2,0,38,18,284
"Lambeth","09:00:00","2018-06-19",904,84,73,476,160,1697
"Newham","09:00:00","2018-06-19",151,0,4,28,2,185
"Redbridge","09:00:00","2018-06-19",3115,75,39,907,372,4508
"Barnet","10:00:00","2018-06-19",3638,56,102,932,213,4941
"Camden","10:00:00","2018-06-19",494,80,105,312,32,1023
"Greenwich","10:00:00","2018-06-19",32,0,0,6,0,38
"Hillingdon","10:00:00","2018-06-19",197,10,0,42,13,262
"Lambeth","10:00:00","2018-06-19",921,56,75,658,164,1874
"Newham","10:00:00","2018-06-19",138,1,0,21,3,163
"Redbridge","10:00:00","2018-06-19",2861,60,37,1040,407,4405
"Barnet","11:00:00","2018-06-19",3234,70,101,955,176,4536
"Camden","11:00:00","2018-06-19",585,79,87,312,45,1108
"Greenwich","11:00:00","2018-06-19",46,2,0,8,0,56
"Hillingdon","11:00:00","2018-06-19",212,2,0,55,7,276
"Lambeth","11:00:00","2018-06-19",999,67,72,653,138,1929
"Newham","11:00:00","2018-06-19",117,3,0,28,1,149
"Redbridge","11:00:00","2018-06-19",2726,56,26,1002,416,4226
"Barnet","12:00:00","2018-06-19",3540,81,85,993,210,4909
"Camden","12:00:00","2018-06-19",600,82,95,306,16,1099
"Greenwich","12:00:00","2018-06-19",50,1,1,8,2,62
"Hillingdon","12:00:00","2018-06-19",176,2,0,32,14,224
"Lambeth","12:00:00","2018-06-19",1024,123,61,639,144,1991
"Newham","12:00:00","2018-06-19",193,0,0,22,2,217
"Redbridge","12:00:00","2018-06-19",3015,42,22,1016,392,4487
"Barnet","13:00:00","2018-06-19",3315,78,86,941,166,4586
"Camden","13:00:00","2018-06-19",562,91,95,258,21,1027
"Greenwich","13:00:00","2018-06-19",34,1,0,16,1,52
"Hillingdon","13:00:00","2018-06-19",185,5,0,37,8,235
"Lambeth","13:00:00","2018-06-19",1018,53,59,767,148,2045
"Newham","13:00:00","2018-06-19",184,1,0,19,0,204
"Redbridge","13:00:00","2018-06-19",3154,55,32,1082,382,4705
"Barnet","14:00:00","2018-06-19",3537,87,96,874,139,4733
"Camden","14:00:00","2018-06-19",590,100,85,289,14,1078
"Greenwich","14:00:00","2018-06-19",39,0,0,12,1,52
"Hillingdon","14:00:00","2018-06-19",172,3,1,41,3,220
"Lambeth","14:00:00","2018-06-19",1123,129,65,664,119,2100
"Newham","14:00:00","2018-06-19",218,5,1,25,0,249
"Redbridge","14:00:00","2018-06-19",3204,60,31,1159,331,4785
"Barnet","15:00:00","2018-06-19",3993,94,110,1128,175,5500
"Camden","15:00:00","2018-06-19",618,97,87,269,22,1093
"Greenwich","15:00:00","2018-06-19",75,2,2,9,0,88
"Hillingdon","15:00:00","2018-06-19",260,3,0,50,6,319
"Lambeth","15:00:00","2018-06-19",1144,165,62,709,70,2150
"Newham","15:00:00","2018-06-19",323,2,4,30,0,359
"Redbridge","15:00:00","2018-06-19",3418,99,33,1212,282,5044
"Barnet","16:00:00","2018-06-19",4375,124,128,1113,103,5843
"Camden","16:00:00","2018-06-19",609,117,89,233,8,1056
"Greenwich","16:00:00","2018-06-19",49,2,1,9,0,61
"Hillingdon","16:00:00","2018-06-19",191,6,0,51,2,250
"Lambeth","16:00:00","2018-06-19",1316,109,66,600,57,2148
"Newham","16:00:00","2018-06-19",260,2,4,26,0,292
"Redbridge","16:00:00","2018-06-19",3722,119,22,1215,187,5265
"Barnet","17:00:00","2018-06-19",4143,160,105,967,61,5436
"Camden","17:00:00","2018-06-19",699,144,101,209,3,1156
"Greenwich","17:00:00","2018-06-19",50,2,0,4,0,56
"Hillingdon","17:00:00","2018-06-19",287,6,0,38,0,331
"Lambeth","17:00:00","2018-06-19",1642,265,75,437,37,2456
"Newham","17:00:00","2018-06-19",261,3,1,26,1,292
"Redbridge","17:00:00","2018-06-19",3867,201,27,977,145,5217
"Barnet","18:00:00","2018-06-19",4950,150,111,623,80,5914
"Camden","18:00:00","2018-06-19",724,155,94,115,5,1093
"Greenwich","18:00:00","2018-06-19",53,0,0,8,0,61
"Hillingdon","18:00:00","2018-06-19",184,3,0,31,0,218
"Lambeth","18:00:00","2018-06-19",1762,338,81,350,27,2558
"Newham","18:00:00","2018-06-19",221,2,0,16,0,239
"Redbridge","18:00:00","2018-06-19",4266,183,27,737,128,5341
"Barnet","07:00:00","2018-06-20",22,0,0,5,0,27
"Bexley","07:00:00","2018-06-20",12,1,0,6,0,19
"Hounslow","07:00:00","2018-06-20",604,9,22,120,13,768
"Kensington and Chelsea","07:00:00","2018-06-20",12,1,0,13,0,26
"Lambeth","07:00:00","2018-06-20",141,4,10,35,4,194
"Lewisham","07:00:00","2018-06-20",129,1,0,16,1,147
"Southwark","07:00:00","2018-06-20",3,2,0,4,0,9
"Westminster","07:00:00","2018-06-20",393,54,58,152,32,689
"Barnet","08:00:00","2018-06-20",26,0,0,4,0,30
"Bexley","08:00:00","2018-06-20",17,0,0,4,0,21
"Hounslow","08:00:00","2018-06-20",702,10,35,100,14,861
"Kensington and Chelsea","08:00:00","2018-06-20",31,1,1,14,1,48
"Lambeth","08:00:00","2018-06-20",202,4,9,31,3,249
"Lewisham","08:00:00","2018-06-20",216,0,0,13,0,229
"Southwark","08:00:00","2018-06-20",2,2,0,5,1,10
"Westminster","08:00:00","2018-06-20",477,62,45,160,37,781
"Barnet","09:00:00","2018-06-20",19,0,0,3,0,22
"Bexley","09:00:00","2018-06-20",17,1,1,3,0,22
"Hounslow","09:00:00","2018-06-20",571,11,30,121,18,751
"Kensington and Chelsea","09:00:00","2018-06-20",36,1,0,19,2,58
"Lambeth","09:00:00","2018-06-20",196,5,10,48,7,266
"Lewisham","09:00:00","2018-06-20",140,0,0,18,0,158
"Southwark","09:00:00","2018-06-20",3,4,0,3,0,10
"Westminster","09:00:00","2018-06-20",474,38,54,169,41,776
"Barnet","10:00:00","2018-06-20",18,0,0,0,0,18
"Bexley","10:00:00","2018-06-20",6,1,0,1,0,8
"Hounslow","10:00:00","2018-06-20",519,12,28,91,23,673
"Kensington and Chelsea","10:00:00","2018-06-20",25,0,0,25,1,51
"Lambeth","10:00:00","2018-06-20",121,2,11,42,9,185
"Lewisham","10:00:00","2018-06-20",95,2,0,22,1,120
"Southwark","10:00:00","2018-06-20",5,0,0,7,0,12
"Westminster","10:00:00","2018-06-20",424,33,46,172,50,725
"Barnet","11:00:00","2018-06-20",20,0,0,3,0,23
"Bexley","11:00:00","2018-06-20",15,0,2,5,0,22
"Hounslow","11:00:00","2018-06-20",587,6,30,120,18,761
"Kensington and Chelsea","11:00:00","2018-06-20",25,2,0,21,1,49
"Lambeth","11:00:00","2018-06-20",131,6,12,31,5,185
"Lewisham","11:00:00","2018-06-20",94,0,0,18,2,114
"Southwark","11:00:00","2018-06-20",8,2,0,9,1,20
"Westminster","11:00:00","2018-06-20",456,38,47,173,35,749
"Barnet","12:00:00","2018-06-20",16,0,0,0,0,16
"Bexley","12:00:00","2018-06-20",18,1,0,6,0,25
"Hounslow","12:00:00","2018-06-20",661,12,35,114,18,840
"Kensington and Chelsea","12:00:00","2018-06-20",30,5,0,16,2,53
"Lambeth","12:00:00","2018-06-20",121,3,11,30,7,172
"Lewisham","12:00:00","2018-06-20",88,2,0,16,4,110
"Southwark","12:00:00","2018-06-20",3,0,0,2,0,5
"Westminster","12:00:00","2018-06-20",531,60,55,193,32,871
"Barnet","13:00:00","2018-06-20",20,0,0,4,0,24
"Bexley","13:00:00","2018-06-20",13,2,0,2,0,17
"Hounslow","13:00:00","2018-06-20",673,15,33,102,22,845
"Kensington and Chelsea","13:00:00","2018-06-20",32,4,0,25,2,63
"Lambeth","13:00:00","2018-06-20",123,5,10,28,5,171
"Lewisham","13:00:00","2018-06-20",96,1,0,21,1,119
"Southwark","13:00:00","2018-06-20",3,3,0,4,0,10
"Westminster","13:00:00","2018-06-20",484,49,48,163,44,788
"Barnet","14:00:00","2018-06-20",20,0,0,7,0,27
"Bexley","14:00:00","2018-06-20",17,0,0,5,0,22
"Hounslow","14:00:00","2018-06-20",777,10,25,149,9,970
"Kensington and Chelsea","14:00:00","2018-06-20",28,1,0,13,1,43
"Lambeth","14:00:00","2018-06-20",150,4,12,39,4,209
"Lewisham","14:00:00","2018-06-20",114,0,0,14,0,128
"Southwark","14:00:00","2018-06-20",4,3,0,7,0,14
"Westminster","14:00:00","2018-06-20",553,78,51,188,30,900
"Barnet","15:00:00","2018-06-20",29,0,0,6,0,35
"Bexley","15:00:00","2018-06-20",16,0,0,2,0,18
"Hounslow","15:00:00","2018-06-20",749,17,33,111,31,941
"Kensington and Chelsea","15:00:00","2018-06-20",28,1,0,15,1,45
"Lambeth","15:00:00","2018-06-20",164,3,10,27,4,208
"Lewisham","15:00:00","2018-06-20",143,0,0,22,0,165
"Southwark","15:00:00","2018-06-20",6,3,0,3,0,12
"Westminster","15:00:00","2018-06-20",795,72,50,178,33,1128
"Barnet","16:00:00","2018-06-20",21,0,0,4,0,25
"Bexley","16:00:00","2018-06-20",26,1,0,10,0,37
"Hounslow","16:00:00","2018-06-20",853,9,29,109,8,1008
"Kensington and Chelsea","16:00:00","2018-06-20",31,1,1,11,0,44
"Lambeth","16:00:00","2018-06-20",185,7,9,32,2,235
"Lewisham","16:00:00","2018-06-20",185,0,0,36,0,221
"Southwark","16:00:00","2018-06-20",2,2,0,2,0,6
"Westminster","16:00:00","2018-06-20",672,85,49,206,24,1036
"Barnet","17:00:00","2018-06-20",21,0,0,2,0,23
"Bexley","17:00:00","2018-06-20",19,0,0,4,0,23
"Hounslow","17:00:00","2018-06-20",833,22,34,102,19,1010
"Kensington and Chelsea","17:00:00","2018-06-20",34,1,2,9,1,47
"Lambeth","17:00:00","2018-06-20",191,5,10,18,1,225
"Lewisham","17:00:00","2018-06-20",148,1,0,34,0,183
"Southwark","17:00:00","2018-06-20",11,5,0,3,0,19
"Westminster","17:00:00","2018-06-20",678,93,54,169,7,1001
"Barnet","18:00:00","2018-06-20",21,0,0,1,0,22
"Bexley","18:00:00","2018-06-20",15,0,0,2,0,17
"Hounslow","18:00:00","2018-06-20",785,13,25,90,2,915
"Kensington and Chelsea","18:00:00","2018-06-20",33,4,0,3,0,40
"Lambeth","18:00:00","2018-06-20",174,4,9,15,0,202
"Lewisham","18:00:00","2018-06-20",127,0,0,18,0,145
"Southwark","18:00:00","2018-06-20",6,7,0,0,0,13
"Westminster","18:00:00","2018-06-20",726,106,63,106,3,1004
"Brent","07:00:00","2018-06-21",34,0,0,4,0,38
"Greenwich","07:00:00","2018-06-21",537,39,44,176,39,835
"Hackney","07:00:00","2018-06-21",1089,95,91,506,70,1851
"Harrow","07:00:00","2018-06-21",538,4,1,43,0,586
"Hillingdon","07:00:00","2018-06-21",311,1,0,65,2,379
"Wandsworth","07:00:00","2018-06-21",952,185,50,483,57,1727
"Brent","08:00:00","2018-06-21",67,0,0,5,0,72
"Greenwich","08:00:00","2018-06-21",792,22,52,137,43,1046
"Hackney","08:00:00","2018-06-21",1307,81,97,351,45,1881
"Harrow","08:00:00","2018-06-21",663,4,0,28,0,695
"Hillingdon","08:00:00","2018-06-21",375,2,0,99,0,476
"Wandsworth","08:00:00","2018-06-21",971,219,45,341,64,1640
"Brent","09:00:00","2018-06-21",29,2,0,2,0,33
"Greenwich","09:00:00","2018-06-21",775,32,65,140,39,1051
"Hackney","09:00:00","2018-06-21",1278,68,99,401,44,1890
"Harrow","09:00:00","2018-06-21",321,1,0,22,0,344
"Hillingdon","09:00:00","2018-06-21",269,1,0,69,4,343
"Wandsworth","09:00:00","2018-06-21",1078,126,60,335,80,1679
"Brent","10:00:00","2018-06-21",19,0,0,1,0,20
"Greenwich","10:00:00","2018-06-21",633,19,49,146,44,891
"Hackney","10:00:00","2018-06-21",1127,50,91,370,71,1709
"Harrow","10:00:00","2018-06-21",241,7,0,13,1,262
"Hillingdon","10:00:00","2018-06-21",165,2,0,48,1,216
"Wandsworth","10:00:00","2018-06-21",1042,62,47,429,103,1683
"Brent","11:00:00","2018-06-21",20,0,0,2,0,22
"Greenwich","11:00:00","2018-06-21",637,24,46,130,37,874
"Hackney","11:00:00","2018-06-21",1088,51,70,386,43,1638
"Harrow","11:00:00","2018-06-21",222,0,0,28,0,250
"Hillingdon","11:00:00","2018-06-21",203,1,0,56,1,261
"Wandsworth","11:00:00","2018-06-21",954,53,35,428,98,1568
"Brent","12:00:00","2018-06-21",29,0,0,4,0,33
"Greenwich","12:00:00","2018-06-21",739,22,45,141,33,980
"Hackney","12:00:00","2018-06-21",1221,54,94,365,65,1799
"Harrow","12:00:00","2018-06-21",226,0,0,25,0,251
"Hillingdon","12:00:00","2018-06-21",224,4,0,44,1,273
"Wandsworth","12:00:00","2018-06-21",969,69,47,305,85,1475
"Brent","13:00:00","2018-06-21",36,0,0,0,0,36
"Greenwich","13:00:00","2018-06-21",763,25,46,146,40,1020
"Hackney","13:00:00","2018-06-21",1275,61,84,351,69,1840
"Harrow","13:00:00","2018-06-21",272,4,0,23,0,299
"Hillingdon","13:00:00","2018-06-21",212,5,0,33,3,253
"Wandsworth","13:00:00","2018-06-21",1016,72,43,377,70,1578
"Brent","14:00:00","2018-06-21",33,0,0,3,0,36
"Greenwich","14:00:00","2018-06-21",757,24,61,187,31,1060
"Hackney","14:00:00","2018-06-21",1306,61,86,412,40,1905
"Harrow","14:00:00","2018-06-21",261,6,0,20,0,287
"Hillingdon","14:00:00","2018-06-21",270,3,0,57,1,331
"Wandsworth","14:00:00","2018-06-21",1036,72,36,294,47,1485
"Brent","15:00:00","2018-06-21",52,0,0,10,0,62
"Greenwich","15:00:00","2018-06-21",876,22,50,188,28,1164
"Hackney","15:00:00","2018-06-21",1189,83,87,372,43,1774
"Harrow","15:00:00","2018-06-21",371,8,0,39,0,418
"Hillingdon","15:00:00","2018-06-21",293,0,0,72,0,365
"Wandsworth","15:00:00","2018-06-21",1119,58,49,233,53,1512
"Brent","16:00:00","2018-06-21",29,0,0,10,0,39
"Greenwich","16:00:00","2018-06-21",982,37,44,184,21,1268
"Hackney","16:00:00","2018-06-21",1340,80,86,302,40,1848
"Harrow","16:00:00","2018-06-21",421,3,0,23,0,447
"Hillingdon","16:00:00","2018-06-21",327,4,0,67,4,402
"Wandsworth","16:00:00","2018-06-21",1109,90,51,301,32,1583
"Brent","17:00:00","2018-06-21",44,1,0,8,0,53
"Greenwich","17:00:00","2018-06-21",1059,40,42,166,12,1319
"Hackney","17:00:00","2018-06-21",1353,79,90,341,22,1885
"Harrow","17:00:00","2018-06-21",496,4,0,42,0,542
"Hillingdon","17:00:00","2018-06-21",297,5,0,53,0,355
"Wandsworth","17:00:00","2018-06-21",1220,107,41,239,30,1637
"Brent","18:00:00","2018-06-21",50,1,0,7,0,58
"Greenwich","18:00:00","2018-06-21",988,49,47,103,8,1195
"Hackney","18:00:00","2018-06-21",1563,90,77,223,11,1964
"Harrow","18:00:00","2018-06-21",461,4,1,26,0,492
"Hillingdon","18:00:00","2018-06-21",334,2,0,50,2,388
"Wandsworth","18:00:00","2018-06-21",1286,105,49,173,18,1631
"Barnet","07:00:00","2018-06-22",561,8,34,82,17,702
"Bromley","07:00:00","2018-06-22",1219,17,24,287,36,1583
"Croydon","07:00:00","2018-06-22",294,2,0,80,2,378
"Ealing","07:00:00","2018-06-22",955,39,0,180,4,1178
"Enfield","07:00:00","2018-06-22",4726,160,67,1597,510,7060
"Greenwich","07:00:00","2018-06-22",25,0,0,17,7,49
"Richmond upon Thames","07:00:00","2018-06-22",2218,105,29,506,55,2913
"Westminster","07:00:00","2018-06-22",18,1,0,5,2,26
"Barnet","08:00:00","2018-06-22",845,9,26,75,17,972
"Bromley","08:00:00","2018-06-22",965,19,21,217,31,1253
"Croydon","08:00:00","2018-06-22",345,2,1,73,4,425
"Ealing","08:00:00","2018-06-22",1094,19,2,150,3,1268
"Enfield","08:00:00","2018-06-22",4382,99,58,1148,521,6208
"Greenwich","08:00:00","2018-06-22",13,2,0,20,10,45
"Richmond upon Thames","08:00:00","2018-06-22",2478,89,31,334,49,2981
"Westminster","08:00:00","2018-06-22",68,0,1,11,0,80
"Barnet","09:00:00","2018-06-22",423,1,21,53,23,521
"Bromley","09:00:00","2018-06-22",1056,11,28,218,35,1348
"Croydon","09:00:00","2018-06-22",312,2,0,79,5,398
"Ealing","09:00:00","2018-06-22",761,9,2,138,13,923
"Enfield","09:00:00","2018-06-22",3842,79,59,1075,592,5647
"Greenwich","09:00:00","2018-06-22",28,0,0,20,10,58
"Richmond upon Thames","09:00:00","2018-06-22",2306,42,23,389,64,2824
"Westminster","09:00:00","2018-06-22",63,2,0,19,2,86
"Barnet","10:00:00","2018-06-22",394,1,26,57,20,498
"Bromley","10:00:00","2018-06-22",951,6,26,240,49,1272
"Croydon","10:00:00","2018-06-22",291,4,0,50,7,352
"Ealing","10:00:00","2018-06-22",560,12,1,121,8,702
"Enfield","10:00:00","2018-06-22",3931,44,58,1122,606,5761
"Greenwich","10:00:00","2018-06-22",9,0,0,8,26,43
"Richmond upon Thames","10:00:00","2018-06-22",2006,23,27,371,68,2495
"Westminster","10:00:00","2018-06-22",34,4,0,18,1,57
"Barnet","11:00:00","2018-06-22",414,2,21,56,25,518
"Bromley","11:00:00","2018-06-22",959,13,18,227,35,1252
"Croydon","11:00:00","2018-06-22",257,2,0,54,9,322
"Ealing","11:00:00","2018-06-22",697,13,0,83,3,796
"Enfield","11:00:00","2018-06-22",4211,62,55,1227,666,6221
"Greenwich","11:00:00","2018-06-22",5,0,0,31,12,48
"Richmond upon Thames","11:00:00","2018-06-22",2131,32,23,389,71,2646
"Westminster","11:00:00","2018-06-22",46,1,0,16,1,64
"Barnet","12:00:00","2018-06-22",421,7,21,64,15,528
"Bromley","12:00:00","2018-06-22",989,8,23,213,38,1271
"Croydon","12:00:00","2018-06-22",289,4,0,63,5,361
"Ealing","12:00:00","2018-06-22",740,10,0,130,16,896
"Enfield","12:00:00","2018-06-22",4075,79,48,1058,679,5939
"Greenwich","12:00:00","2018-06-22",23,1,0,22,15,61
"Richmond upon Thames","12:00:00","2018-06-22",2036,33,22,386,59,2536
"Westminster","12:00:00","2018-06-22",35,4,0,19,1,59
"Barnet","13:00:00","2018-06-22",448,3,23,69,21,564
"Bromley","13:00:00","2018-06-22",997,10,22,239,37,1305
"Croydon","13:00:00","2018-06-22",282,3,0,60,2,347
"Ealing","13:00:00","2018-06-22",939,13,0,148,10,1110
"Enfield","13:00:00","2018-06-22",4564,68,42,1153,644,6471
"Greenwich","13:00:00","2018-06-22",13,0,0,8,4,25
"Richmond upon Thames","13:00:00","2018-06-22",1954,40,34,358,63,2449
"Westminster","13:00:00","2018-06-22",45,2,0,15,1,63
"Barnet","14:00:00","2018-06-22",409,4,22,51,6,492
"Bromley","14:00:00","2018-06-22",1066,8,29,214,23,1340
"Croydon","14:00:00","2018-06-22",341,5,1,72,3,422
"Ealing","14:00:00","2018-06-22",902,11,4,196,7,1120
"Enfield","14:00:00","2018-06-22",4473,49,54,1165,531,6272
"Greenwich","14:00:00","2018-06-22",20,0,0,20,4,44
"Richmond upon Thames","14:00:00","2018-06-22",2053,34,31,313,44,2475
"Westminster","14:00:00","2018-06-22",58,7,0,10,0,75
"Barnet","15:00:00","2018-06-22",641,4,30,71,6,752
"Bromley","15:00:00","2018-06-22",979,17,21,239,22,1278
"Croydon","15:00:00","2018-06-22",431,4,0,52,4,491
"Ealing","15:00:00","2018-06-22",1039,20,1,191,11,1262
"Enfield","15:00:00","2018-06-22",4340,92,59,1145,442,6078
"Greenwich","15:00:00","2018-06-22",14,0,0,12,10,36
"Richmond upon Thames","15:00:00","2018-06-22",2255,41,32,285,34,2647
"Westminster","15:00:00","2018-06-22",94,2,1,10,0,107
"Barnet","16:00:00","2018-06-22",595,9,35,74,4,717
"Bromley","16:00:00","2018-06-22",1073,15,20,188,12,1308
"Croydon","16:00:00","2018-06-22",437,7,1,86,2,533
"Ealing","16:00:00","2018-06-22",984,7,3,196,2,1192
"Enfield","16:00:00","2018-06-22",4471,129,53,1044,351,6048
"Greenwich","16:00:00","2018-06-22",5,0,0,14,6,25
"Richmond upon Thames","16:00:00","2018-06-22",2452,59,34,409,30,2984
"Westminster","16:00:00","2018-06-22",83,4,0,12,0,99
"Barnet","17:00:00","2018-06-22",603,6,27,49,4,689
"Bromley","17:00:00","2018-06-22",1081,13,20,139,9,1262
"Croydon","17:00:00","2018-06-22",432,11,0,54,1,498
"Ealing","17:00:00","2018-06-22",996,26,0,145,5,1172
"Enfield","17:00:00","2018-06-22",5093,111,39,860,230,6333
"Greenwich","17:00:00","2018-06-22",18,0,0,4,4,26
"Richmond upon Thames","17:00:00","2018-06-22",2619,87,22,290,22,3040
"Westminster","17:00:00","2018-06-22",52,3,1,12,1,69
"Barnet","18:00:00","2018-06-22",609,13,22,41,1,686
"Bromley","18:00:00","2018-06-22",1207,13,24,132,6,1382
"Croydon","18:00:00","2018-06-22",365,8,0,39,0,412
"Ealing","18:00:00","2018-06-22",894,28,0,101,2,1025
"Enfield","18:00:00","2018-06-22",5446,133,30,679,144,6432
"Greenwich","18:00:00","2018-06-22",2,0,0,2,3,7
"Richmond upon Thames","18:00:00","2018-06-22",2194,75,24,169,12,2474
"Westminster","18:00:00","2018-06-22",67,2,0,12,0,81
"Hackney","07:00:00","2018-06-25",708,134,85,374,118,1419
"Havering","07:00:00","2018-06-25",934,7,1,173,4,1119
"Hillingdon","07:00:00","2018-06-25",1387,7,24,202,24,1644
"Kingston upon Thames","07:00:00","2018-06-25",1364,32,6,281,39,1722
"Merton","07:00:00","2018-06-25",423,8,7,93,1,532
"Newham","07:00:00","2018-06-25",103,4,27,17,5,156
"Redbridge","07:00:00","2018-06-25",465,5,16,54,10,550
"Tower Hamlets","07:00:00","2018-06-25",3967,444,95,1688,492,6686
"Hackney","08:00:00","2018-06-25",595,128,99,313,100,1235
"Havering","08:00:00","2018-06-25",1447,3,4,168,5,1627
"Hillingdon","08:00:00","2018-06-25",1082,7,25,131,27,1272
"Kingston upon Thames","08:00:00","2018-06-25",1370,37,12,239,46,1704
"Merton","08:00:00","2018-06-25",539,15,12,76,2,644
"Newham","08:00:00","2018-06-25",146,0,31,26,6,209
"Redbridge","08:00:00","2018-06-25",588,0,16,63,10,677
"Tower Hamlets","08:00:00","2018-06-25",4462,404,78,1321,520,6785
"Hackney","09:00:00","2018-06-25",691,126,87,381,102,1387
"Havering","09:00:00","2018-06-25",873,0,7,135,4,1019
"Hillingdon","09:00:00","2018-06-25",924,6,34,140,19,1123
"Kingston upon Thames","09:00:00","2018-06-25",1385,29,16,208,35,1673
"Merton","09:00:00","2018-06-25",397,15,10,57,4,483
"Newham","09:00:00","2018-06-25",83,1,27,16,4,131
"Redbridge","09:00:00","2018-06-25",444,4,15,67,13,543
"Tower Hamlets","09:00:00","2018-06-25",3657,223,98,1342,599,5919
"Hackney","10:00:00","2018-06-25",600,61,92,317,91,1161
"Havering","10:00:00","2018-06-25",888,3,1,123,2,1017
"Hillingdon","10:00:00","2018-06-25",692,7,22,137,34,892
"Kingston upon Thames","10:00:00","2018-06-25",1255,12,18,240,36,1561
"Merton","10:00:00","2018-06-25",330,1,8,57,5,401
"Newham","10:00:00","2018-06-25",79,3,23,22,5,132
"Redbridge","10:00:00","2018-06-25",402,2,14,59,11,488
"Tower Hamlets","10:00:00","2018-06-25",3469,137,98,1331,664,5699
"Hackney","11:00:00","2018-06-25",688,80,77,378,92,1315
"Havering","11:00:00","2018-06-25",903,4,2,133,7,1049
"Hillingdon","11:00:00","2018-06-25",619,4,31,129,32,815
"Kingston upon Thames","11:00:00","2018-06-25",1100,15,9,258,59,1441
"Merton","11:00:00","2018-06-25",347,4,9,69,6,435
"Newham","11:00:00","2018-06-25",73,0,24,19,4,120
"Redbridge","11:00:00","2018-06-25",451,2,14,73,7,547
"Tower Hamlets","11:00:00","2018-06-25",3325,147,78,1429,614,5593
"Hackney","12:00:00","2018-06-25",763,58,79,301,107,1308
"Havering","12:00:00","2018-06-25",847,6,3,116,6,978
"Hillingdon","12:00:00","2018-06-25",662,1,24,106,34,827
"Kingston upon Thames","12:00:00","2018-06-25",1478,14,15,214,63,1784
"Merton","12:00:00","2018-06-25",319,10,7,65,4,405
"Newham","12:00:00","2018-06-25",87,4,23,18,6,138
"Redbridge","12:00:00","2018-06-25",442,1,9,74,13,539
"Tower Hamlets","12:00:00","2018-06-25",3472,192,96,1420,579,5759
"Hackney","13:00:00","2018-06-25",705,70,77,319,98,1269
"Havering","13:00:00","2018-06-25",819,1,1,89,12,922
"Hillingdon","13:00:00","2018-06-25",626,4,20,136,22,808
"Kingston upon Thames","13:00:00","2018-06-25",1380,16,8,235,63,1702
"Merton","13:00:00","2018-06-25",354,6,8,65,3,436
"Newham","13:00:00","2018-06-25",67,0,25,23,6,121
"Redbridge","13:00:00","2018-06-25",458,5,12,64,10,549
"Tower Hamlets","13:00:00","2018-06-25",3696,227,102,1494,596,6115
"Hackney","14:00:00","2018-06-25",606,71,74,266,75,1092
"Havering","14:00:00","2018-06-25",886,5,7,145,5,1048
"Hillingdon","14:00:00","2018-06-25",803,3,29,192,34,1061
"Kingston upon Thames","14:00:00","2018-06-25",1229,23,7,296,68,1623
"Merton","14:00:00","2018-06-25",377,10,8,66,4,465
"Newham","14:00:00","2018-06-25",87,0,23,16,9,135
"Redbridge","14:00:00","2018-06-25",425,4,14,75,14,532
"Tower Hamlets","14:00:00","2018-06-25",3961,207,97,1479,554,6298
"Hackney","15:00:00","2018-06-25",723,118,77,261,63,1242
"Havering","15:00:00","2018-06-25",921,7,3,135,7,1073
"Hillingdon","15:00:00","2018-06-25",1202,7,35,198,19,1461
"Kingston upon Thames","15:00:00","2018-06-25",1437,22,12,272,22,1765
"Merton","15:00:00","2018-06-25",512,7,13,70,0,602
"Newham","15:00:00","2018-06-25",124,2,26,18,10,180
"Redbridge","15:00:00","2018-06-25",607,3,18,56,6,690
"Tower Hamlets","15:00:00","2018-06-25",4374,261,80,1630,442,6787
"Hackney","16:00:00","2018-06-25",776,117,85,267,53,1298
"Havering","16:00:00","2018-06-25",1089,2,5,196,8,1300
"Hillingdon","16:00:00","2018-06-25",2013,11,28,240,15,2307
"Kingston upon Thames","16:00:00","2018-06-25",1339,18,15,261,38,1671
"Merton","16:00:00","2018-06-25",561,12,8,126,10,717
"Newham","16:00:00","2018-06-25",113,1,31,23,6,174
"Redbridge","16:00:00","2018-06-25",531,3,20,51,5,610
"Tower Hamlets","16:00:00","2018-06-25",4941,427,101,1604,317,7390
"Hackney","17:00:00","2018-06-25",959,181,69,239,28,1476
"Havering","17:00:00","2018-06-25",1291,9,6,185,2,1493
"Hillingdon","17:00:00","2018-06-25",2154,9,27,175,12,2377
"Kingston upon Thames","17:00:00","2018-06-25",1325,33,9,100,12,1479
"Merton","17:00:00","2018-06-25",602,15,7,93,0,717
"Newham","17:00:00","2018-06-25",158,2,31,19,1,211
"Redbridge","17:00:00","2018-06-25",576,3,12,50,5,646
"Tower Hamlets","17:00:00","2018-06-25",5420,541,95,1186,181,7423
"Hackney","18:00:00","2018-06-25",1003,178,60,200,17,1458
"Havering","18:00:00","2018-06-25",1068,2,7,137,2,1216
"Hillingdon","18:00:00","2018-06-25",1961,2,24,158,12,2157
"Kingston upon Thames","18:00:00","2018-06-25",988,41,10,89,10,1138
"Merton","18:00:00","2018-06-25",539,16,10,54,0,619
"Newham","18:00:00","2018-06-25",122,3,29,13,2,169
"Redbridge","18:00:00","2018-06-25",553,3,11,41,2,610
"Tower Hamlets","18:00:00","2018-06-25",5601,527,88,894,142,7252
"Bexley","07:00:00","2018-06-26",1527,29,47,425,46,2074
"Bromley","07:00:00","2018-06-26",194,7,0,31,0,232
"Croydon","07:00:00","2018-06-26",197,4,0,36,0,237
"Havering","07:00:00","2018-06-26",548,0,48,115,6,717
"Hillingdon","07:00:00","2018-06-26",1945,29,16,280,52,2322
"Lewisham","07:00:00","2018-06-26",378,22,9,146,4,559
"Merton","07:00:00","2018-06-26",1019,79,40,308,36,1482
"Redbridge","07:00:00","2018-06-26",199,0,2,19,0,220
"Richmond upon Thames","07:00:00","2018-06-26",150,1,0,19,3,173
"Bexley","08:00:00","2018-06-26",1678,20,52,263,47,2060
"Bromley","08:00:00","2018-06-26",198,0,0,27,0,225
"Croydon","08:00:00","2018-06-26",270,0,0,40,1,311
"Havering","08:00:00","2018-06-26",526,3,40,110,18,697
"Hillingdon","08:00:00","2018-06-26",2461,29,21,253,69,2833
"Lewisham","08:00:00","2018-06-26",412,17,8,88,6,531
"Merton","08:00:00","2018-06-26",1060,49,44,218,29,1400
"Redbridge","08:00:00","2018-06-26",242,2,0,16,3,263
"Richmond upon Thames","08:00:00","2018-06-26",256,0,0,28,0,284
"Bexley","09:00:00","2018-06-26",1516,10,46,283,48,1903
"Bromley","09:00:00","2018-06-26",138,0,0,22,4,164
"Croydon","09:00:00","2018-06-26",131,3,0,34,0,168
"Havering","09:00:00","2018-06-26",653,4,35,91,12,795
"Hillingdon","09:00:00","2018-06-26",1893,14,25,255,76,2263
"Lewisham","09:00:00","2018-06-26",371,14,9,90,8,492
"Merton","09:00:00","2018-06-26",951,22,50,228,55,1306
"Redbridge","09:00:00","2018-06-26",152,0,0,14,1,167
"Richmond upon Thames","09:00:00","2018-06-26",125,4,0,15,1,145
"Bexley","10:00:00","2018-06-26",1156,9,34,291,57,1547
"Bromley","10:00:00","2018-06-26",83,0,0,14,2,99
"Croydon","10:00:00","2018-06-26",94,0,0,12,1,107
"Havering","10:00:00","2018-06-26",486,2,48,59,14,609
"Hillingdon","10:00:00","2018-06-26",1302,14,15,214,59,1604
"Lewisham","10:00:00","2018-06-26",275,12,5,95,9,396
"Merton","10:00:00","2018-06-26",892,25,46,231,49,1243
"Redbridge","10:00:00","2018-06-26",109,0,0,10,1,120
"Richmond upon Thames","10:00:00","2018-06-26",92,0,0,23,5,120
"Bexley","11:00:00","2018-06-26",1308,14,37,302,61,1722
"Bromley","11:00:00","2018-06-26",161,0,0,23,2,186
"Croydon","11:00:00","2018-06-26",85,3,0,15,2,105
"Havering","11:00:00","2018-06-26",458,2,53,92,9,614
"Hillingdon","11:00:00","2018-06-26",1507,16,22,221,64,1830
"Lewisham","11:00:00","2018-06-26",258,16,7,66,3,350
"Merton","11:00:00","2018-06-26",834,21,41,209,51,1156
"Redbridge","11:00:00","2018-06-26",83,2,0,14,3,102
"Richmond upon Thames","11:00:00","2018-06-26",85,0,0,27,1,113
"Bexley","12:00:00","2018-06-26",1349,10,42,314,59,1774
"Bromley","12:00:00","2018-06-26",116,0,0,38,1,155
"Croydon","12:00:00","2018-06-26",105,1,0,24,2,132
"Havering","12:00:00","2018-06-26",548,4,43,99,7,701
"Hillingdon","12:00:00","2018-06-26",1547,19,21,265,89,1941
"Lewisham","12:00:00","2018-06-26",312,16,6,95,4,433
"Merton","12:00:00","2018-06-26",886,22,38,222,48,1216
"Redbridge","12:00:00","2018-06-26",124,1,0,15,7,147
"Richmond upon Thames","12:00:00","2018-06-26",89,3,0,16,2,110
"Bexley","13:00:00","2018-06-26",1308,12,42,307,64,1733
"Bromley","13:00:00","2018-06-26",90,0,0,20,1,111
"Croydon","13:00:00","2018-06-26",61,0,0,18,0,79
"Havering","13:00:00","2018-06-26",482,4,35,75,11,607
"Hillingdon","13:00:00","2018-06-26",1470,24,25,301,105,1925
"Lewisham","13:00:00","2018-06-26",317,16,9,109,4,455
"Merton","13:00:00","2018-06-26",1001,24,46,244,42,1357
"Redbridge","13:00:00","2018-06-26",73,0,0,13,2,88
"Richmond upon Thames","13:00:00","2018-06-26",88,0,0,21,0,109
"Bexley","14:00:00","2018-06-26",1350,13,36,315,50,1764
"Bromley","14:00:00","2018-06-26",122,1,0,22,1,146
"Croydon","14:00:00","2018-06-26",111,1,1,22,1,136
"Havering","14:00:00","2018-06-26",505,3,47,92,11,658
"Hillingdon","14:00:00","2018-06-26",1659,14,35,238,65,2011
"Lewisham","14:00:00","2018-06-26",306,14,6,78,5,409
"Merton","14:00:00","2018-06-26",1025,23,43,204,28,1323
"Redbridge","14:00:00","2018-06-26",107,0,0,10,1,118
"Richmond upon Thames","14:00:00","2018-06-26",101,2,1,14,0,118
"Bexley","15:00:00","2018-06-26",1416,16,48,293,19,1792
"Bromley","15:00:00","2018-06-26",181,1,0,16,0,198
"Croydon","15:00:00","2018-06-26",191,1,0,30,2,224
"Havering","15:00:00","2018-06-26",525,10,43,60,3,641
"Hillingdon","15:00:00","2018-06-26",1687,11,33,278,50,2059
"Lewisham","15:00:00","2018-06-26",412,18,10,86,2,528
"Merton","15:00:00","2018-06-26",1045,39,38,240,37,1399
"Redbridge","15:00:00","2018-06-26",168,1,2,10,1,182
"Richmond upon Thames","15:00:00","2018-06-26",165,1,0,17,0,183
"Bexley","16:00:00","2018-06-26",1420,26,33,310,29,1818
"Bromley","16:00:00","2018-06-26",163,0,0,17,0,180
"Croydon","16:00:00","2018-06-26",145,0,0,27,0,172
"Havering","16:00:00","2018-06-26",604,8,42,98,2,754
"Hillingdon","16:00:00","2018-06-26",1645,17,21,191,39,1913
"Lewisham","16:00:00","2018-06-26",377,20,6,94,4,501
"Merton","16:00:00","2018-06-26",1114,50,45,256,26,1491
"Redbridge","16:00:00","2018-06-26",145,0,0,12,0,157
"Richmond upon Thames","16:00:00","2018-06-26",162,0,0,20,2,184
"Bexley","17:00:00","2018-06-26",1803,34,39,234,24,2134
"Bromley","17:00:00","2018-06-26",184,2,0,17,0,203
"Croydon","17:00:00","2018-06-26",240,3,0,38,0,281
"Havering","17:00:00","2018-06-26",589,13,33,75,1,711
"Hillingdon","17:00:00","2018-06-26",1620,24,12,192,21,1869
"Lewisham","17:00:00","2018-06-26",434,30,7,69,0,540
"Merton","17:00:00","2018-06-26",1253,66,39,190,8,1556
"Redbridge","17:00:00","2018-06-26",188,0,0,12,0,200
"Richmond upon Thames","17:00:00","2018-06-26",175,2,0,9,0,186
"Bexley","18:00:00","2018-06-26",1472,24,32,176,26,1730
"Bromley","18:00:00","2018-06-26",150,0,0,11,0,161
"Croydon","18:00:00","2018-06-26",235,3,0,23,0,261
"Havering","18:00:00","2018-06-26",596,2,41,33,1,673
"Hillingdon","18:00:00","2018-06-26",1492,26,14,109,13,1654
"Lewisham","18:00:00","2018-06-26",432,27,9,45,0,513
"Merton","18:00:00","2018-06-26",1294,76,38,139,10,1557
"Redbridge","18:00:00","2018-06-26",205,0,0,12,0,217
"Richmond upon Thames","18:00:00","2018-06-26",113,3,0,6,0,122
"Brent","07:00:00","2018-06-27",138,10,11,48,38,245
"Bromley","07:00:00","2018-06-27",1532,63,24,426,35,2080
"Haringey","07:00:00","2018-06-27",930,51,42,354,64,1441
"Kingston upon Thames","07:00:00","2018-06-27",728,25,26,165,19,963
"Lambeth","07:00:00","2018-06-27",344,73,65,191,21,694
"Redbridge","07:00:00","2018-06-27",1360,83,24,506,44,2017
"Southwark","07:00:00","2018-06-27",301,96,77,179,29,682
"Sutton","07:00:00","2018-06-27",108,0,0,15,0,123
"Westminster","07:00:00","2018-06-27",259,18,20,91,17,405
"Brent","08:00:00","2018-06-27",172,3,10,56,51,292
"Bromley","08:00:00","2018-06-27",1712,43,26,316,43,2140
"Haringey","08:00:00","2018-06-27",1150,39,52,311,50,1602
"Kingston upon Thames","08:00:00","2018-06-27",785,42,17,127,9,980
"Lambeth","08:00:00","2018-06-27",364,59,56,119,18,616
"Redbridge","08:00:00","2018-06-27",1429,48,26,382,25,1910
"Southwark","08:00:00","2018-06-27",392,185,79,152,44,852
"Sutton","08:00:00","2018-06-27",102,0,0,6,0,108
"Westminster","08:00:00","2018-06-27",339,48,22,101,20,530
"Brent","09:00:00","2018-06-27",139,3,9,70,40,261
"Bromley","09:00:00","2018-06-27",1523,34,36,307,56,1956
"Haringey","09:00:00","2018-06-27",1101,29,51,353,64,1598
"Kingston upon Thames","09:00:00","2018-06-27",764,22,24,122,12,944
"Lambeth","09:00:00","2018-06-27",340,44,74,147,27,632
"Redbridge","09:00:00","2018-06-27",1172,39,22,229,26,1488
"Southwark","09:00:00","2018-06-27",349,81,102,158,61,751
"Sutton","09:00:00","2018-06-27",68,0,0,11,0,79
"Westminster","09:00:00","2018-06-27",358,34,20,90,16,518
"Brent","10:00:00","2018-06-27",110,5,9,71,49,244
"Bromley","10:00:00","2018-06-27",1561,30,36,373,56,2056
"Haringey","10:00:00","2018-06-27",927,26,38,312,57,1360
"Kingston upon Thames","10:00:00","2018-06-27",702,19,13,148,21,903
"Lambeth","10:00:00","2018-06-27",309,24,67,161,29,590
"Redbridge","10:00:00","2018-06-27",1069,33,20,279,36,1437
"Southwark","10:00:00","2018-06-27",366,29,141,155,58,749
"Sutton","10:00:00","2018-06-27",74,0,0,12,0,86
"Westminster","10:00:00","2018-06-27",389,16,18,127,26,576
"Brent","11:00:00","2018-06-27",126,2,7,67,43,245
"Bromley","11:00:00","2018-06-27",1572,23,22,327,62,2006
"Haringey","11:00:00","2018-06-27",967,29,38,320,69,1423
"Kingston upon Thames","11:00:00","2018-06-27",734,15,13,147,20,929
"Lambeth","11:00:00","2018-06-27",285,24,60,124,34,527
"Redbridge","11:00:00","2018-06-27",926,11,18,181,18,1154
"Southwark","11:00:00","2018-06-27",325,45,106,148,62,686
"Sutton","11:00:00","2018-06-27",74,0,0,9,0,83
"Westminster","11:00:00","2018-06-27",399,20,10,132,12,573
"Brent","12:00:00","2018-06-27",118,6,10,73,48,255
"Bromley","12:00:00","2018-06-27",1491,22,24,302,46,1885
"Haringey","12:00:00","2018-06-27",1028,40,50,278,55,1451
"Kingston upon Thames","12:00:00","2018-06-27",741,18,14,128,16,917
"Lambeth","12:00:00","2018-06-27",295,24,52,124,26,521
"Redbridge","12:00:00","2018-06-27",937,15,18,177,20,1167
"Southwark","12:00:00","2018-06-27",496,37,104,208,66,911
"Sutton","12:00:00","2018-06-27",76,0,0,4,1,81
"Westminster","12:00:00","2018-06-27",373,28,10,126,18,555
"Brent","13:00:00","2018-06-27",140,6,9,55,40,250
"Bromley","13:00:00","2018-06-27",1469,28,25,365,46,1933
"Haringey","13:00:00","2018-06-27",1029,41,32,274,48,1424
"Kingston upon Thames","13:00:00","2018-06-27",755,22,16,157,16,966
"Lambeth","13:00:00","2018-06-27",340,43,62,154,32,631
"Redbridge","13:00:00","2018-06-27",867,12,15,190,13,1097
"Southwark","13:00:00","2018-06-27",499,48,105,167,63,882
"Sutton","13:00:00","2018-06-27",72,0,0,4,0,76
"Westminster","13:00:00","2018-06-27",364,19,15,107,11,516
"Brent","14:00:00","2018-06-27",137,3,11,60,40,251
"Bromley","14:00:00","2018-06-27",1190,22,24,364,46,1646
"Haringey","14:00:00","2018-06-27",1032,36,42,287,44,1441
"Kingston upon Thames","14:00:00","2018-06-27",759,25,20,141,13,958
"Lambeth","14:00:00","2018-06-27",367,35,66,140,24,632
"Redbridge","14:00:00","2018-06-27",824,19,12,158,19,1032
"Southwark","14:00:00","2018-06-27",379,50,99,143,43,714
"Sutton","14:00:00","2018-06-27",89,0,1,6,1,97
"Westminster","14:00:00","2018-06-27",374,23,14,101,10,522
"Brent","15:00:00","2018-06-27",171,5,7,56,41,280
"Bromley","15:00:00","2018-06-27",1517,47,36,360,31,1991
"Haringey","15:00:00","2018-06-27",1250,39,54,294,29,1666
"Kingston upon Thames","15:00:00","2018-06-27",804,20,16,131,19,990
"Lambeth","15:00:00","2018-06-27",603,43,73,150,21,890
"Redbridge","15:00:00","2018-06-27",1255,27,21,251,22,1576
"Southwark","15:00:00","2018-06-27",455,63,95,151,50,814
"Sutton","15:00:00","2018-06-27",119,1,0,10,0,130
"Westminster","15:00:00","2018-06-27",437,35,15,93,9,589
"Brent","16:00:00","2018-06-27",211,13,9,47,25,305
"Bromley","16:00:00","2018-06-27",1732,45,31,386,21,2215
"Haringey","16:00:00","2018-06-27",1241,49,40,265,20,1615
"Kingston upon Thames","16:00:00","2018-06-27",841,17,22,103,9,992
"Lambeth","16:00:00","2018-06-27",493,62,66,178,18,817
"Redbridge","16:00:00","2018-06-27",1462,42,26,264,14,1808
"Southwark","16:00:00","2018-06-27",335,106,91,215,32,779
"Sutton","16:00:00","2018-06-27",98,1,0,8,0,107
"Westminster","16:00:00","2018-06-27",417,22,19,79,10,547
"Brent","17:00:00","2018-06-27",241,7,7,28,12,295
"Bromley","17:00:00","2018-06-27",1885,51,19,302,16,2273
"Haringey","17:00:00","2018-06-27",1281,79,41,268,16,1685
"Kingston upon Thames","17:00:00","2018-06-27",951,32,16,112,7,1118
"Lambeth","17:00:00","2018-06-27",550,94,60,122,9,835
"Redbridge","17:00:00","2018-06-27",1223,73,19,246,11,1572
"Southwark","17:00:00","2018-06-27",470,123,107,171,15,886
"Sutton","17:00:00","2018-06-27",105,4,1,5,0,115
"Westminster","17:00:00","2018-06-27",456,55,26,80,2,619
"Brent","18:00:00","2018-06-27",207,5,13,30,11,266
"Bromley","18:00:00","2018-06-27",1618,44,22,251,9,1944
"Haringey","18:00:00","2018-06-27",1356,70,40,219,11,1696
"Kingston upon Thames","18:00:00","2018-06-27",1006,38,18,79,1,1142
"Lambeth","18:00:00","2018-06-27",593,83,57,95,6,834
"Redbridge","18:00:00","2018-06-27",1346,67,13,162,6,1594
"Southwark","18:00:00","2018-06-27",535,96,97,113,14,855
"Sutton","18:00:00","2018-06-27",90,1,0,3,0,94
"Westminster","18:00:00","2018-06-27",459,34,18,50,1,562
"Bexley","07:00:00","2018-06-28",387,6,15,104,0,512
"Bromley","07:00:00","2018-06-28",1575,40,79,259,22,1975
"Camden","07:00:00","2018-06-28",661,157,189,424,103,1534
"Ealing","07:00:00","2018-06-28",674,33,62,199,59,1027
"Hammersmith and Fulham","07:00:00","2018-06-28",805,68,109,377,35,1394
"Harrow","07:00:00","2018-06-28",897,16,28,158,11,1110
"Kingston upon Thames","07:00:00","2018-06-28",87,0,0,13,3,103
"Wandsworth","07:00:00","2018-06-28",238,4,19,44,4,309
"Westminster","07:00:00","2018-06-28",413,83,98,222,65,881
"Bexley","08:00:00","2018-06-28",468,4,14,93,8,587
"Bromley","08:00:00","2018-06-28",1736,26,72,213,41,2088
"Camden","08:00:00","2018-06-28",792,224,177,469,101,1763
"Ealing","08:00:00","2018-06-28",695,37,53,196,53,1034
"Hammersmith and Fulham","08:00:00","2018-06-28",1173,68,115,342,62,1760
"Harrow","08:00:00","2018-06-28",1081,13,23,100,13,1230
"Kingston upon Thames","08:00:00","2018-06-28",148,0,0,14,0,162
"Wandsworth","08:00:00","2018-06-28",301,9,12,38,3,363
"Westminster","08:00:00","2018-06-28",566,130,107,238,40,1081
"Bexley","09:00:00","2018-06-28",305,4,11,83,3,406
"Bromley","09:00:00","2018-06-28",1657,22,74,197,22,1972
"Camden","09:00:00","2018-06-28",965,129,187,415,63,1759
"Ealing","09:00:00","2018-06-28",628,26,57,267,55,1033
"Hammersmith and Fulham","09:00:00","2018-06-28",856,82,89,320,48,1395
"Harrow","09:00:00","2018-06-28",851,11,22,111,16,1011
"Kingston upon Thames","09:00:00","2018-06-28",103,1,0,13,1,118
"Wandsworth","09:00:00","2018-06-28",243,3,16,55,2,319
"Westminster","09:00:00","2018-06-28",539,80,105,208,43,975
"Bexley","10:00:00","2018-06-28",208,2,10,91,4,315
"Bromley","10:00:00","2018-06-28",1487,17,71,206,37,1818
"Camden","10:00:00","2018-06-28",876,70,172,452,82,1652
"Ealing","10:00:00","2018-06-28",528,26,54,258,46,912
"Hammersmith and Fulham","10:00:00","2018-06-28",873,53,99,405,68,1498
"Harrow","10:00:00","2018-06-28",769,5,12,134,18,938
"Kingston upon Thames","10:00:00","2018-06-28",94,0,0,19,3,116
"Wandsworth","10:00:00","2018-06-28",168,7,18,40,0,233
"Westminster","10:00:00","2018-06-28",519,53,126,198,31,927
"Bexley","11:00:00","2018-06-28",240,3,15,92,6,356
"Bromley","11:00:00","2018-06-28",1371,18,69,282,40,1780
"Camden","11:00:00","2018-06-28",870,80,154,388,79,1571
"Ealing","11:00:00","2018-06-28",519,34,49,249,56,907
"Hammersmith and Fulham","11:00:00","2018-06-28",1123,105,85,406,52,1771
"Harrow","11:00:00","2018-06-28",783,7,20,127,20,957
"Kingston upon Thames","11:00:00","2018-06-28",54,0,0,18,0,72
"Wandsworth","11:00:00","2018-06-28",206,6,14,47,1,274
"Westminster","11:00:00","2018-06-28",461,58,122,210,34,885
"Bexley","12:00:00","2018-06-28",276,3,9,99,2,389
"Bromley","12:00:00","2018-06-28",1499,25,63,189,29,1805
"Camden","12:00:00","2018-06-28",974,89,152,382,46,1643
"Ealing","12:00:00","2018-06-28",600,34,54,275,59,1022
"Hammersmith and Fulham","12:00:00","2018-06-28",1024,119,88,354,42,1627
"Harrow","12:00:00","2018-06-28",806,19,17,124,11,977
"Kingston upon Thames","12:00:00","2018-06-28",69,0,0,18,1,88
"Wandsworth","12:00:00","2018-06-28",245,9,17,58,1,330
"Westminster","12:00:00","2018-06-28",565,74,117,192,18,966
"Bexley","13:00:00","2018-06-28",274,3,8,87,0,372
"Bromley","13:00:00","2018-06-28",1543,24,55,203,32,1857
"Camden","13:00:00","2018-06-28",782,74,147,358,71,1432
"Ealing","13:00:00","2018-06-28",651,33,51,225,53,1013
"Hammersmith and Fulham","13:00:00","2018-06-28",1086,136,112,437,50,1821
"Harrow","13:00:00","2018-06-28",813,15,15,119,16,978
"Kingston upon Thames","13:00:00","2018-06-28",65,0,0,14,2,81
"Wandsworth","13:00:00","2018-06-28",241,13,14,37,1,306
"Westminster","13:00:00","2018-06-28",615,66,116,166,21,984
"Bexley","14:00:00","2018-06-28",359,11,10,92,10,482
"Bromley","14:00:00","2018-06-28",1474,20,80,230,31,1835
"Camden","14:00:00","2018-06-28",993,97,163,307,37,1597
"Ealing","14:00:00","2018-06-28",702,28,49,257,53,1089
"Hammersmith and Fulham","14:00:00","2018-06-28",1127,118,83,432,47,1807
"Harrow","14:00:00","2018-06-28",860,12,19,118,15,1024
"Kingston upon Thames","14:00:00","2018-06-28",77,0,0,13,1,91
"Wandsworth","14:00:00","2018-06-28",250,13,13,44,5,325
"Westminster","14:00:00","2018-06-28",608,62,129,191,18,1008
"Bexley","15:00:00","2018-06-28",519,11,15,122,2,669
"Bromley","15:00:00","2018-06-28",1659,27,66,183,15,1950
"Camden","15:00:00","2018-06-28",989,115,178,375,39,1696
"Ealing","15:00:00","2018-06-28",700,37,54,229,27,1047
"Hammersmith and Fulham","15:00:00","2018-06-28",970,97,100,347,32,1546
"Harrow","15:00:00","2018-06-28",986,14,27,96,9,1132
"Kingston upon Thames","15:00:00","2018-06-28",100,0,0,13,0,113
"Wandsworth","15:00:00","2018-06-28",314,10,16,42,3,385
"Westminster","15:00:00","2018-06-28",616,84,120,154,17,991
"Bexley","16:00:00","2018-06-28",482,6,16,123,4,631
"Bromley","16:00:00","2018-06-28",2012,27,76,197,14,2326
"Camden","16:00:00","2018-06-28",749,132,166,308,22,1377
"Ealing","16:00:00","2018-06-28",781,38,54,211,31,1115
"Hammersmith and Fulham","16:00:00","2018-06-28",986,124,98,315,17,1540
"Harrow","16:00:00","2018-06-28",970,20,34,120,5,1149
"Kingston upon Thames","16:00:00","2018-06-28",119,0,0,15,0,134
"Wandsworth","16:00:00","2018-06-28",347,11,15,54,3,430
"Westminster","16:00:00","2018-06-28",618,105,142,148,8,1021
"Bexley","17:00:00","2018-06-28",533,15,10,94,3,655
"Camden","17:00:00","2018-06-28",1097,234,207,230,24,1792
"Ealing","17:00:00","2018-06-28",924,51,55,166,19,1215
"Hammersmith and Fulham","17:00:00","2018-06-28",1318,228,104,291,15,1956
"Harrow","17:00:00","2018-06-28",1120,24,24,99,2,1269
"Kingston upon Thames","17:00:00","2018-06-28",98,0,0,9,0,107
"Wandsworth","17:00:00","2018-06-28",344,18,15,48,0,425
"Westminster","17:00:00","2018-06-28",720,150,126,98,2,1096
"Bexley","18:00:00","2018-06-28",330,6,10,41,0,387
"Bromley","18:00:00","2018-06-28",1697,48,51,127,5,1928
"Camden","18:00:00","2018-06-28",1196,220,200,171,10,1797
"Ealing","18:00:00","2018-06-28",947,48,60,148,15,1218
"Hammersmith and Fulham","18:00:00","2018-06-28",1417,296,108,215,11,2047
"Harrow","18:00:00","2018-06-28",1081,19,17,76,2,1195
"Kingston upon Thames","18:00:00","2018-06-28",146,2,0,8,0,156
"Wandsworth","18:00:00","2018-06-28",351,27,15,25,1,419
"Westminster","18:00:00","2018-06-28",824,119,134,73,1,1151
"Barnet","07:00:00","2018-06-29",1989,53,79,776,270,3167
"Croydon","07:00:00","2018-06-29",278,5,1,51,0,335
"Enfield","07:00:00","2018-06-29",1602,55,38,587,195,2477
"Havering","07:00:00","2018-06-29",1141,24,9,265,62,1501
"Kensington and Chelsea","07:00:00","2018-06-29",161,14,2,52,2,231
"Kingston upon Thames","07:00:00","2018-06-29",41,0,0,15,1,57
"Southwark","07:00:00","2018-06-29",585,60,46,297,21,1009
"Sutton","07:00:00","2018-06-29",1263,38,7,347,62,1717
"Wandsworth","07:00:00","2018-06-29",414,37,6,153,4,614
"Barnet","08:00:00","2018-06-29",2109,44,73,707,224,3157
"Croydon","08:00:00","2018-06-29",435,2,0,28,1,466
"Enfield","08:00:00","2018-06-29",1802,48,35,635,202,2722
"Havering","08:00:00","2018-06-29",1133,5,9,251,65,1463
"Kensington and Chelsea","08:00:00","2018-06-29",266,14,2,73,3,358
"Kingston upon Thames","08:00:00","2018-06-29",81,1,0,11,0,93
"Southwark","08:00:00","2018-06-29",594,66,51,284,36,1031
"Sutton","08:00:00","2018-06-29",1521,37,4,265,74,1901
"Wandsworth","08:00:00","2018-06-29",542,41,12,122,5,722
"Barnet","09:00:00","2018-06-29",1969,46,76,560,270,2921
"Croydon","09:00:00","2018-06-29",173,0,0,18,2,193
"Enfield","09:00:00","2018-06-29",1463,53,38,659,168,2381
"Havering","09:00:00","2018-06-29",1075,7,10,156,46,1294
"Kensington and Chelsea","09:00:00","2018-06-29",221,12,4,69,6,312
"Kingston upon Thames","09:00:00","2018-06-29",52,0,0,11,0,63
"Southwark","09:00:00","2018-06-29",660,55,53,278,32,1078
"Sutton","09:00:00","2018-06-29",1276,22,10,269,78,1655
"Wandsworth","09:00:00","2018-06-29",437,22,13,123,4,599
"Barnet","10:00:00","2018-06-29",2260,35,85,700,264,3344
"Croydon","10:00:00","2018-06-29",141,0,0,19,0,160
"Enfield","10:00:00","2018-06-29",1393,36,39,616,209,2293
"Havering","10:00:00","2018-06-29",851,9,3,153,48,1064
"Kensington and Chelsea","10:00:00","2018-06-29",211,18,4,74,5,312
"Kingston upon Thames","10:00:00","2018-06-29",29,2,0,7,1,39
"Southwark","10:00:00","2018-06-29",638,34,48,306,37,1063
"Sutton","10:00:00","2018-06-29",1099,17,9,260,75,1460
"Wandsworth","10:00:00","2018-06-29",352,19,11,100,7,489
"Barnet","11:00:00","2018-06-29",2319,32,79,620,225,3275
"Croydon","11:00:00","2018-06-29",141,2,0,21,3,167
"Enfield","11:00:00","2018-06-29",1346,37,30,556,184,2153
"Havering","11:00:00","2018-06-29",1016,14,7,216,67,1320
"Kensington and Chelsea","11:00:00","2018-06-29",229,24,0,74,5,332
"Kingston upon Thames","11:00:00","2018-06-29",49,0,0,11,2,62
"Southwark","11:00:00","2018-06-29",650,39,49,279,31,1048
"Sutton","11:00:00","2018-06-29",1219,15,8,250,79,1571
"Wandsworth","11:00:00","2018-06-29",410,16,11,134,10,581
"Barnet","12:00:00","2018-06-29",2606,43,69,636,272,3626
"Croydon","12:00:00","2018-06-29",150,4,0,24,1,179
"Enfield","12:00:00","2018-06-29",1322,35,28,592,161,2138
"Havering","12:00:00","2018-06-29",1016,5,3,151,45,1220
"Kensington and Chelsea","12:00:00","2018-06-29",258,22,1,86,4,371
"Kingston upon Thames","12:00:00","2018-06-29",40,0,0,7,1,48
"Southwark","12:00:00","2018-06-29",662,38,47,270,42,1059
"Sutton","12:00:00","2018-06-29",1317,16,5,293,58,1689
"Wandsworth","12:00:00","2018-06-29",452,16,8,121,9,606
"Barnet","13:00:00","2018-06-29",2457,43,84,632,246,3462
"Croydon","13:00:00","2018-06-29",166,5,0,22,0,193
"Enfield","13:00:00","2018-06-29",1451,35,32,588,161,2267
"Havering","13:00:00","2018-06-29",977,7,4,195,29,1212
"Kensington and Chelsea","13:00:00","2018-06-29",252,24,3,77,4,360
"Kingston upon Thames","13:00:00","2018-06-29",33,0,0,10,2,45
"Southwark","13:00:00","2018-06-29",646,39,42,266,25,1018
"Sutton","13:00:00","2018-06-29",1288,12,5,258,76,1639
"Wandsworth","13:00:00","2018-06-29",433,21,12,134,5,605
"Barnet","14:00:00","2018-06-29",2530,34,69,629,211,3473
"Croydon","14:00:00","2018-06-29",222,5,0,22,3,252
"Enfield","14:00:00","2018-06-29",1446,38,46,544,136,2210
"Havering","14:00:00","2018-06-29",1182,12,10,237,53,1494
"Kensington and Chelsea","14:00:00","2018-06-29",222,34,1,87,10,354
"Kingston upon Thames","14:00:00","2018-06-29",47,0,0,11,0,58
"Southwark","14:00:00","2018-06-29",709,62,45,234,26,1076
"Sutton","14:00:00","2018-06-29",1400,19,5,272,56,1752
"Wandsworth","14:00:00","2018-06-29",428,19,10,122,9,588
"Barnet","15:00:00","2018-06-29",2759,34,91,668,209,3761
"Croydon","15:00:00","2018-06-29",311,2,0,38,2,353
"Enfield","15:00:00","2018-06-29",1799,50,42,552,127,2570
"Havering","15:00:00","2018-06-29",1206,17,7,188,33,1451
"Kensington and Chelsea","15:00:00","2018-06-29",291,14,2,66,7,380
"Kingston upon Thames","15:00:00","2018-06-29",44,0,0,11,0,55
"Southwark","15:00:00","2018-06-29",685,47,51,210,15,1008
"Sutton","15:00:00","2018-06-29",1484,34,8,285,48,1859
"Wandsworth","15:00:00","2018-06-29",517,29,10,122,4,682
"Barnet","16:00:00","2018-06-29",2865,74,119,643,142,3843
"Croydon","16:00:00","2018-06-29",262,7,1,42,2,314
"Enfield","16:00:00","2018-06-29",1913,58,32,650,115,2768
"Havering","16:00:00","2018-06-29",1222,18,2,155,17,1414
"Kensington and Chelsea","16:00:00","2018-06-29",302,30,5,63,3,403
"Kingston upon Thames","16:00:00","2018-06-29",56,1,0,7,0,64
"Southwark","16:00:00","2018-06-29",772,80,46,162,6,1066
"Sutton","16:00:00","2018-06-29",1567,26,11,261,21,1886
"Wandsworth","16:00:00","2018-06-29",420,29,10,100,1,560
"Barnet","17:00:00","2018-06-29",2895,74,86,532,102,3689
"Croydon","17:00:00","2018-06-29",343,8,0,41,0,392
"Enfield","17:00:00","2018-06-29",2000,65,33,612,68,2778
"Havering","17:00:00","2018-06-29",1459,22,3,164,13,1661
"Kensington and Chelsea","17:00:00","2018-06-29",266,43,0,45,1,355
"Kingston upon Thames","17:00:00","2018-06-29",58,0,0,9,0,67
"Southwark","17:00:00","2018-06-29",702,90,44,150,5,991
"Sutton","17:00:00","2018-06-29",1799,40,4,298,23,2164
"Wandsworth","17:00:00","2018-06-29",538,43,9,115,0,705
"Barnet","18:00:00","2018-06-29",2995,70,78,420,75,3638
"Croydon","18:00:00","2018-06-29",340,7,0,48,0,395
"Enfield","18:00:00","2018-06-29",2100,89,33,567,58,2847
"Havering","18:00:00","2018-06-29",1252,10,5,117,10,1394
"Kensington and Chelsea","18:00:00","2018-06-29",279,38,0,31,1,349
"Kingston upon Thames","18:00:00","2018-06-29",54,0,0,5,0,59
"Southwark","18:00:00","2018-06-29",817,62,42,122,3,1046
"Sutton","18:00:00","2018-06-29",1680,36,4,192,17,1929
"Wandsworth","18:00:00","2018-06-29",517,42,8,57,0,624
"Barnet","07:00:00","2018-07-02",58,3,0,12,1,74
"Bromley","07:00:00","2018-07-02",90,2,0,20,1,113
"Hackney","07:00:00","2018-07-02",499,81,65,322,67,1034
"Haringey","07:00:00","2018-07-02",397,11,2,90,5,505
"Kingston upon Thames","07:00:00","2018-07-02",646,11,9,116,5,787
"Lambeth","07:00:00","2018-07-02",349,178,68,237,41,873
"Merton","07:00:00","2018-07-02",329,14,2,80,1,426
"Wandsworth","07:00:00","2018-07-02",412,49,14,132,28,635
"Barnet","08:00:00","2018-07-02",68,1,0,5,0,74
"Bromley","08:00:00","2018-07-02",124,0,0,12,0,136
"Hackney","08:00:00","2018-07-02",468,115,51,316,67,1017
"Haringey","08:00:00","2018-07-02",494,17,3,92,4,610
"Kingston upon Thames","08:00:00","2018-07-02",706,10,1,107,8,832
"Lambeth","08:00:00","2018-07-02",443,236,63,235,46,1023
"Merton","08:00:00","2018-07-02",302,7,2,38,1,350
"Wandsworth","08:00:00","2018-07-02",475,40,17,74,20,626
"Barnet","09:00:00","2018-07-02",53,0,0,6,0,59
"Bromley","09:00:00","2018-07-02",128,0,0,10,0,138
"Hackney","09:00:00","2018-07-02",600,83,67,347,76,1173
"Haringey","09:00:00","2018-07-02",442,7,1,97,12,559
"Kingston upon Thames","09:00:00","2018-07-02",611,2,2,88,8,711
"Lambeth","09:00:00","2018-07-02",379,131,75,186,48,819
"Merton","09:00:00","2018-07-02",190,6,0,42,2,240
"Wandsworth","09:00:00","2018-07-02",331,15,13,103,24,486
"Barnet","10:00:00","2018-07-02",57,0,0,4,0,61
"Bromley","10:00:00","2018-07-02",43,0,0,4,0,47
"Hackney","10:00:00","2018-07-02",541,47,60,364,83,1095
"Haringey","10:00:00","2018-07-02",339,12,4,111,6,472
"Kingston upon Thames","10:00:00","2018-07-02",461,2,1,77,9,550
"Lambeth","10:00:00","2018-07-02",489,54,82,211,52,888
"Merton","10:00:00","2018-07-02",145,2,0,33,0,180
"Wandsworth","10:00:00","2018-07-02",319,18,9,122,24,492
"Barnet","11:00:00","2018-07-02",47,0,0,13,0,60
"Bromley","11:00:00","2018-07-02",44,0,0,10,0,54
"Hackney","11:00:00","2018-07-02",520,60,49,347,74,1050
"Haringey","11:00:00","2018-07-02",347,10,2,103,17,479
"Kingston upon Thames","11:00:00","2018-07-02",424,3,1,89,11,528
"Lambeth","11:00:00","2018-07-02",504,44,82,220,39,889
"Merton","11:00:00","2018-07-02",135,4,0,27,1,167
"Wandsworth","11:00:00","2018-07-02",391,11,17,152,30,601
"Barnet","12:00:00","2018-07-02",39,0,0,8,0,47
"Bromley","12:00:00","2018-07-02",71,0,0,11,0,82
"Hackney","12:00:00","2018-07-02",564,77,56,383,61,1141
"Haringey","12:00:00","2018-07-02",399,8,0,103,4,514
"Kingston upon Thames","12:00:00","2018-07-02",474,1,2,91,8,576
"Lambeth","12:00:00","2018-07-02",429,45,80,196,45,795
"Merton","12:00:00","2018-07-02",163,2,1,31,0,197
"Wandsworth","12:00:00","2018-07-02",418,12,14,140,33,617
"Barnet","13:00:00","2018-07-02",59,0,0,5,0,64
"Bromley","13:00:00","2018-07-02",48,0,0,8,0,56
"Hackney","13:00:00","2018-07-02",544,72,59,366,73,1114
"Haringey","13:00:00","2018-07-02",353,9,2,88,9,461
"Kingston upon Thames","13:00:00","2018-07-02",348,6,1,68,4,427
"Lambeth","13:00:00","2018-07-02",413,68,82,161,31,755
"Merton","13:00:00","2018-07-02",158,6,0,37,0,201
"Wandsworth","13:00:00","2018-07-02",367,18,10,140,29,564
"Barnet","14:00:00","2018-07-02",41,1,0,5,1,48
"Bromley","14:00:00","2018-07-02",48,0,0,5,0,53
"Hackney","14:00:00","2018-07-02",476,87,49,342,59,1013
"Haringey","14:00:00","2018-07-02",344,13,0,92,3,452
"Kingston upon Thames","14:00:00","2018-07-02",525,5,0,106,7,643
"Lambeth","14:00:00","2018-07-02",484,56,85,230,28,883
"Merton","14:00:00","2018-07-02",235,5,0,36,2,278
"Wandsworth","14:00:00","2018-07-02",394,14,11,100,17,536
"Barnet","15:00:00","2018-07-02",36,0,0,11,0,47
"Bromley","15:00:00","2018-07-02",58,0,0,7,0,65
"Hackney","15:00:00","2018-07-02",632,83,57,362,46,1180
"Haringey","15:00:00","2018-07-02",415,11,3,79,6,514
"Kingston upon Thames","15:00:00","2018-07-02",580,2,5,111,5,703
"Lambeth","15:00:00","2018-07-02",482,58,85,191,26,842
"Merton","15:00:00","2018-07-02",247,6,1,46,0,300
"Wandsworth","15:00:00","2018-07-02",430,11,12,139,23,615
"Barnet","16:00:00","2018-07-02",84,3,0,5,0,92
"Bromley","16:00:00","2018-07-02",79,3,0,6,0,88
"Hackney","16:00:00","2018-07-02",551,91,56,299,36,1033
"Haringey","16:00:00","2018-07-02",520,9,2,86,1,618
"Kingston upon Thames","16:00:00","2018-07-02",617,11,7,112,6,753
"Lambeth","16:00:00","2018-07-02",460,100,103,160,26,849
"Merton","16:00:00","2018-07-02",227,9,0,54,1,291
"Wandsworth","16:00:00","2018-07-02",431,22,15,106,19,593
"Barnet","17:00:00","2018-07-02",51,2,0,11,0,64
"Bromley","17:00:00","2018-07-02",88,2,0,10,0,100
"Hackney","17:00:00","2018-07-02",687,218,54,224,24,1207
"Haringey","17:00:00","2018-07-02",551,19,2,82,1,655
"Kingston upon Thames","17:00:00","2018-07-02",958,9,2,94,6,1069
"Lambeth","17:00:00","2018-07-02",472,189,75,135,12,883
"Merton","17:00:00","2018-07-02",291,11,0,46,0,348
"Wandsworth","17:00:00","2018-07-02",498,34,16,125,8,681
"Barnet","18:00:00","2018-07-02",62,3,0,5,0,70
"Bromley","18:00:00","2018-07-02",71,0,0,4,0,75
"Hackney","18:00:00","2018-07-02",787,231,72,282,11,1383
"Haringey","18:00:00","2018-07-02",623,26,1,61,0,711
"Kingston upon Thames","18:00:00","2018-07-02",588,10,1,50,2,651
"Lambeth","18:00:00","2018-07-02",636,228,89,108,10,1071
"Merton","18:00:00","2018-07-02",289,6,0,28,0,323
"Wandsworth","18:00:00","2018-07-02",483,50,11,61,6,611
"Bromley","07:00:00","2018-07-03",43,0,0,6,0,49
"Ealing","07:00:00","2018-07-03",444,23,16,133,13,629
"Hackney","07:00:00","2018-07-03",347,12,12,124,7,502
"Hammersmith and Fulham","07:00:00","2018-07-03",321,14,18,118,9,480
"Haringey","07:00:00","2018-07-03",112,10,0,37,0,159
"Harrow","07:00:00","2018-07-03",1095,6,25,206,9,1341
"Havering","07:00:00","2018-07-03",3,0,0,2,0,5
"Hillingdon","07:00:00","2018-07-03",2386,28,12,307,53,2786
"Bromley","08:00:00","2018-07-03",45,0,0,14,0,59
"Ealing","08:00:00","2018-07-03",532,40,17,121,18,728
"Hackney","08:00:00","2018-07-03",461,17,11,120,6,615
"Hammersmith and Fulham","08:00:00","2018-07-03",468,18,19,111,13,629
"Haringey","08:00:00","2018-07-03",147,4,2,30,1,184
"Harrow","08:00:00","2018-07-03",1156,4,32,138,7,1337
"Havering","08:00:00","2018-07-03",7,0,0,3,0,10
"Hillingdon","08:00:00","2018-07-03",2710,51,9,287,49,3106
"Bromley","09:00:00","2018-07-03",41,0,0,4,0,45
"Ealing","09:00:00","2018-07-03",455,31,13,107,32,638
"Hackney","09:00:00","2018-07-03",381,8,16,138,11,554
"Hammersmith and Fulham","09:00:00","2018-07-03",399,10,21,95,11,536
"Haringey","09:00:00","2018-07-03",114,1,1,20,1,137
"Harrow","09:00:00","2018-07-03",1085,11,32,174,11,1313
"Havering","09:00:00","2018-07-03",14,0,0,0,0,14
"Hillingdon","09:00:00","2018-07-03",2180,44,3,259,61,2547
"Bromley","10:00:00","2018-07-03",32,1,0,7,0,40
"Ealing","10:00:00","2018-07-03",473,14,13,169,26,695
"Hackney","10:00:00","2018-07-03",299,18,8,125,9,459
"Hammersmith and Fulham","10:00:00","2018-07-03",320,17,13,108,11,469
"Haringey","10:00:00","2018-07-03",129,3,0,26,0,158
"Harrow","10:00:00","2018-07-03",879,9,21,168,16,1093
"Havering","10:00:00","2018-07-03",5,0,0,0,0,5
"Hillingdon","10:00:00","2018-07-03",1700,6,4,272,75,2057
"Bromley","11:00:00","2018-07-03",38,2,0,8,1,49
"Ealing","11:00:00","2018-07-03",476,23,12,158,37,706
"Hackney","11:00:00","2018-07-03",290,18,9,112,13,442
"Hammersmith and Fulham","11:00:00","2018-07-03",294,13,19,108,12,446
"Haringey","11:00:00","2018-07-03",144,5,0,24,0,173
"Harrow","11:00:00","2018-07-03",889,2,20,158,22,1091
"Havering","11:00:00","2018-07-03",7,0,0,1,0,8
"Hillingdon","11:00:00","2018-07-03",1471,6,8,298,62,1845
"Bromley","12:00:00","2018-07-03",35,0,0,6,0,41
"Ealing","12:00:00","2018-07-03",450,28,15,175,34,702
"Hackney","12:00:00","2018-07-03",290,11,10,96,4,411
"Hammersmith and Fulham","12:00:00","2018-07-03",328,19,27,100,10,484
"Haringey","12:00:00","2018-07-03",147,4,0,28,1,180
"Harrow","12:00:00","2018-07-03",790,7,19,177,16,1009
"Havering","12:00:00","2018-07-03",7,0,0,2,0,9
"Hillingdon","12:00:00","2018-07-03",1507,8,4,221,53,1793
"Bromley","13:00:00","2018-07-03",29,0,0,7,0,36
"Ealing","13:00:00","2018-07-03",463,27,18,170,36,714
"Hackney","13:00:00","2018-07-03",354,23,10,95,7,489
"Hammersmith and Fulham","13:00:00","2018-07-03",296,18,23,106,15,458
"Haringey","13:00:00","2018-07-03",131,4,0,26,0,161
"Harrow","13:00:00","2018-07-03",997,4,21,154,25,1201
"Havering","13:00:00","2018-07-03",3,0,0,2,0,5
"Hillingdon","13:00:00","2018-07-03",1675,9,2,244,62,1992
"Bromley","14:00:00","2018-07-03",41,0,0,7,0,48
"Ealing","14:00:00","2018-07-03",494,37,19,133,37,720
"Hackney","14:00:00","2018-07-03",290,16,14,88,7,415
"Hammersmith and Fulham","14:00:00","2018-07-03",392,26,16,85,14,533
"Haringey","14:00:00","2018-07-03",128,3,2,22,0,155
"Harrow","14:00:00","2018-07-03",920,7,27,148,11,1113
"Havering","14:00:00","2018-07-03",4,0,0,0,0,4
"Hillingdon","14:00:00","2018-07-03",1718,16,5,221,52,2012
"Bromley","15:00:00","2018-07-03",65,0,0,15,0,80
"Ealing","15:00:00","2018-07-03",513,33,13,167,19,745
"Hackney","15:00:00","2018-07-03",404,20,16,130,6,576
"Hammersmith and Fulham","15:00:00","2018-07-03",436,26,21,102,10,595
"Haringey","15:00:00","2018-07-03",149,5,1,21,0,176
"Harrow","15:00:00","2018-07-03",1105,7,28,144,20,1304
"Havering","15:00:00","2018-07-03",6,0,0,1,0,7
"Hillingdon","15:00:00","2018-07-03",1652,9,6,218,32,1917
"Bromley","16:00:00","2018-07-03",73,0,0,16,0,89
"Ealing","16:00:00","2018-07-03",474,58,11,145,14,702
"Hackney","16:00:00","2018-07-03",453,21,13,121,4,612
"Hammersmith and Fulham","16:00:00","2018-07-03",484,33,22,85,4,628
"Haringey","16:00:00","2018-07-03",148,5,0,26,0,179
"Harrow","16:00:00","2018-07-03",1075,12,33,137,8,1265
"Havering","16:00:00","2018-07-03",7,0,0,2,0,9
"Hillingdon","16:00:00","2018-07-03",2575,21,6,332,26,2960
"Bromley","17:00:00","2018-07-03",67,0,0,4,0,71
"Ealing","17:00:00","2018-07-03",505,64,12,130,19,730
"Hackney","17:00:00","2018-07-03",399,25,5,89,2,520
"Hammersmith and Fulham","17:00:00","2018-07-03",391,37,15,67,2,512
"Haringey","17:00:00","2018-07-03",143,2,0,17,0,162
"Harrow","17:00:00","2018-07-03",1210,11,18,141,3,1383
"Havering","17:00:00","2018-07-03",4,0,0,1,0,5
"Hillingdon","17:00:00","2018-07-03",2557,39,4,201,15,2816
"Bromley","18:00:00","2018-07-03",51,0,0,6,0,57
"Ealing","18:00:00","2018-07-03",636,69,16,102,9,832
"Hackney","18:00:00","2018-07-03",494,48,10,65,5,622
"Hammersmith and Fulham","18:00:00","2018-07-03",429,42,20,57,1,549
"Haringey","18:00:00","2018-07-03",125,4,0,11,0,140
"Harrow","18:00:00","2018-07-03",1202,10,14,149,4,1379
"Havering","18:00:00","2018-07-03",7,1,0,0,0,8
"Hillingdon","18:00:00","2018-07-03",2354,19,5,217,9,2604
"Brent","07:00:00","2018-07-04",447,3,0,100,5,555
"Bromley","07:00:00","2018-07-04",116,3,4,105,33,261
"Ealing","07:00:00","2018-07-04",1287,49,57,355,61,1809
"Hammersmith and Fulham","07:00:00","2018-07-04",430,52,43,132,24,681
"Havering","07:00:00","2018-07-04",1052,11,17,194,13,1287
"Lambeth","07:00:00","2018-07-04",18,3,0,6,0,27
"Richmond upon Thames","07:00:00","2018-07-04",75,0,0,7,0,82
"Southwark","07:00:00","2018-07-04",615,128,58,356,36,1193
"Wandsworth","07:00:00","2018-07-04",1019,77,21,242,30,1389
"Brent","08:00:00","2018-07-04",561,1,1,46,3,612
"Bromley","08:00:00","2018-07-04",148,5,2,109,28,292
"Ealing","08:00:00","2018-07-04",1277,31,40,285,55,1688
"Hammersmith and Fulham","08:00:00","2018-07-04",474,58,48,126,29,735
"Havering","08:00:00","2018-07-04",1043,6,18,161,13,1241
"Lambeth","08:00:00","2018-07-04",26,5,0,6,0,37
"Richmond upon Thames","08:00:00","2018-07-04",115,1,0,5,3,124
"Southwark","08:00:00","2018-07-04",832,175,57,354,52,1470
"Wandsworth","08:00:00","2018-07-04",1309,71,24,221,34,1659
"Brent","09:00:00","2018-07-04",471,2,1,61,1,536
"Bromley","09:00:00","2018-07-04",168,0,3,152,39,362
"Ealing","09:00:00","2018-07-04",1186,36,53,296,61,1632
"Hammersmith and Fulham","09:00:00","2018-07-04",371,28,28,178,19,624
"Havering","09:00:00","2018-07-04",848,2,11,111,12,984
"Lambeth","09:00:00","2018-07-04",26,2,0,7,1,36
"Richmond upon Thames","09:00:00","2018-07-04",64,0,0,3,2,69
"Southwark","09:00:00","2018-07-04",779,115,65,376,35,1370
"Wandsworth","09:00:00","2018-07-04",1062,49,25,220,28,1384
"Brent","10:00:00","2018-07-04",368,0,0,85,1,454
"Bromley","10:00:00","2018-07-04",168,5,0,147,39,359
"Ealing","10:00:00","2018-07-04",1042,21,49,298,59,1469
"Hammersmith and Fulham","10:00:00","2018-07-04",426,38,35,204,24,727
"Havering","10:00:00","2018-07-04",663,6,13,105,16,803
"Lambeth","10:00:00","2018-07-04",20,2,0,6,1,29
"Richmond upon Thames","10:00:00","2018-07-04",30,0,0,4,1,35
"Southwark","10:00:00","2018-07-04",695,55,60,384,43,1237
"Wandsworth","10:00:00","2018-07-04",1210,35,33,215,37,1530
"Brent","11:00:00","2018-07-04",378,2,0,43,2,425
"Bromley","11:00:00","2018-07-04",116,5,4,115,33,273
"Ealing","11:00:00","2018-07-04",1115,24,46,288,75,1548
"Hammersmith and Fulham","11:00:00","2018-07-04",447,29,27,209,20,732
"Havering","11:00:00","2018-07-04",678,6,11,140,19,854
"Lambeth","11:00:00","2018-07-04",22,2,0,7,0,31
"Richmond upon Thames","11:00:00","2018-07-04",35,2,0,10,1,48
"Southwark","11:00:00","2018-07-04",713,45,60,357,38,1213
"Wandsworth","11:00:00","2018-07-04",1358,52,32,223,37,1702
"Brent","12:00:00","2018-07-04",396,2,0,42,3,443
"Bromley","12:00:00","2018-07-04",128,5,3,104,38,278
"Ealing","12:00:00","2018-07-04",1220,33,39,291,79,1662
"Hammersmith and Fulham","12:00:00","2018-07-04",439,57,29,193,17,735
"Havering","12:00:00","2018-07-04",651,6,13,93,11,774
"Lambeth","12:00:00","2018-07-04",23,2,0,9,1,35
"Richmond upon Thames","12:00:00","2018-07-04",34,0,0,2,2,38
"Southwark","12:00:00","2018-07-04",809,61,54,366,38,1328
"Wandsworth","12:00:00","2018-07-04",1187,31,26,219,26,1489
"Brent","13:00:00","2018-07-04",435,3,6,61,2,507
"Bromley","13:00:00","2018-07-04",148,7,1,149,37,342
"Ealing","13:00:00","2018-07-04",1275,31,42,335,67,1750
"Hammersmith and Fulham","13:00:00","2018-07-04",374,54,27,118,25,598
"Havering","13:00:00","2018-07-04",667,4,11,124,14,820
"Lambeth","13:00:00","2018-07-04",25,3,0,7,0,35
"Richmond upon Thames","13:00:00","2018-07-04",33,0,0,5,0,38
"Southwark","13:00:00","2018-07-04",741,70,51,354,25,1241
"Wandsworth","13:00:00","2018-07-04",875,38,23,242,29,1207
"Brent","14:00:00","2018-07-04",459,2,3,66,0,530
"Bromley","14:00:00","2018-07-04",105,0,1,113,41,260
"Ealing","14:00:00","2018-07-04",1321,34,53,353,79,1840
"Hammersmith and Fulham","14:00:00","2018-07-04",498,59,36,120,20,733
"Havering","14:00:00","2018-07-04",827,9,14,138,8,996
"Lambeth","14:00:00","2018-07-04",25,1,0,7,0,33
"Richmond upon Thames","14:00:00","2018-07-04",35,0,0,9,1,45
"Southwark","14:00:00","2018-07-04",779,68,57,326,39,1269
"Wandsworth","14:00:00","2018-07-04",924,40,27,212,38,1241
"Brent","15:00:00","2018-07-04",455,5,0,66,4,530
"Bromley","15:00:00","2018-07-04",90,2,3,82,24,201
"Ealing","15:00:00","2018-07-04",1369,37,50,307,44,1807
"Hammersmith and Fulham","15:00:00","2018-07-04",467,45,42,102,20,676
"Havering","15:00:00","2018-07-04",861,3,15,140,15,1034
"Lambeth","15:00:00","2018-07-04",33,0,0,7,2,42
"Richmond upon Thames","15:00:00","2018-07-04",79,1,0,7,1,88
"Southwark","15:00:00","2018-07-04",751,65,62,290,25,1193
"Wandsworth","15:00:00","2018-07-04",1041,32,25,198,27,1323
"Brent","16:00:00","2018-07-04",513,14,1,69,1,598
"Bromley","16:00:00","2018-07-04",156,5,9,74,8,252
"Ealing","16:00:00","2018-07-04",1520,34,54,248,32,1888
"Hammersmith and Fulham","16:00:00","2018-07-04",480,61,44,76,12,673
"Havering","16:00:00","2018-07-04",918,7,19,163,10,1117
"Lambeth","16:00:00","2018-07-04",43,0,0,12,0,55
"Richmond upon Thames","16:00:00","2018-07-04",83,0,0,6,0,89
"Southwark","16:00:00","2018-07-04",702,114,58,283,19,1176
"Wandsworth","16:00:00","2018-07-04",1077,51,26,220,12,1386
"Brent","17:00:00","2018-07-04",565,4,0,69,0,638
"Bromley","17:00:00","2018-07-04",174,4,1,58,0,237
"Ealing","17:00:00","2018-07-04",1381,45,38,212,23,1699
"Hammersmith and Fulham","17:00:00","2018-07-04",513,82,38,66,7,706
"Havering","17:00:00","2018-07-04",1241,16,10,171,5,1443
"Lambeth","17:00:00","2018-07-04",32,2,0,10,0,44
"Richmond upon Thames","17:00:00","2018-07-04",80,1,0,5,0,86
"Southwark","17:00:00","2018-07-04",798,160,59,153,13,1183
"Wandsworth","17:00:00","2018-07-04",1248,83,24,177,7,1539
"Brent","18:00:00","2018-07-04",623,4,0,58,1,686
"Bromley","18:00:00","2018-07-04",79,12,10,16,0,117
"Ealing","18:00:00","2018-07-04",1361,45,35,175,26,1642
"Hammersmith and Fulham","18:00:00","2018-07-04",500,45,32,58,6,641
"Havering","18:00:00","2018-07-04",1329,5,14,106,6,1460
"Lambeth","18:00:00","2018-07-04",31,3,0,5,0,39
"Richmond upon Thames","18:00:00","2018-07-04",56,1,0,6,0,63
"Southwark","18:00:00","2018-07-04",948,147,55,162,12,1324
"Wandsworth","18:00:00","2018-07-04",1363,82,21,112,6,1584
"Barnet","07:00:00","2018-07-05",1319,105,32,516,105,2077
"Bexley","07:00:00","2018-07-05",136,3,0,24,0,163
"Bromley","07:00:00","2018-07-05",876,10,38,175,23,1122
"Greenwich","07:00:00","2018-07-05",136,3,1,33,0,173
"Harrow","07:00:00","2018-07-05",34,0,0,3,0,37
"Kensington and Chelsea","07:00:00","2018-07-05",726,86,32,410,111,1365
"Kingston upon Thames","07:00:00","2018-07-05",1055,42,49,194,33,1373
"Merton","07:00:00","2018-07-05",143,5,0,25,1,174
"Redbridge","07:00:00","2018-07-05",604,4,73,82,10,773
"Westminster","07:00:00","2018-07-05",22,3,0,7,0,32
"Barnet","08:00:00","2018-07-05",1417,93,30,546,60,2146
"Bexley","08:00:00","2018-07-05",220,1,0,20,1,242
"Bromley","08:00:00","2018-07-05",1127,13,36,156,14,1346
"Greenwich","08:00:00","2018-07-05",214,5,0,18,2,239
"Harrow","08:00:00","2018-07-05",88,1,0,8,0,97
"Kensington and Chelsea","08:00:00","2018-07-05",778,74,20,316,109,1297
"Kingston upon Thames","08:00:00","2018-07-05",1150,44,41,164,32,1431
"Merton","08:00:00","2018-07-05",233,1,1,23,1,259
"Redbridge","08:00:00","2018-07-05",925,3,62,83,13,1086
"Westminster","08:00:00","2018-07-05",36,3,0,6,2,47
"Barnet","09:00:00","2018-07-05",1481,65,67,542,109,2264
"Bexley","09:00:00","2018-07-05",111,0,0,17,1,129
"Bromley","09:00:00","2018-07-05",841,10,34,135,20,1040
"Greenwich","09:00:00","2018-07-05",161,1,0,24,0,186
"Harrow","09:00:00","2018-07-05",30,0,0,2,0,32
"Kensington and Chelsea","09:00:00","2018-07-05",639,42,26,356,77,1140
"Kingston upon Thames","09:00:00","2018-07-05",1191,39,40,206,31,1507
"Merton","09:00:00","2018-07-05",134,1,1,31,0,167
"Redbridge","09:00:00","2018-07-05",660,0,68,76,18,822
"Westminster","09:00:00","2018-07-05",38,5,0,13,2,58
"Barnet","10:00:00","2018-07-05",1495,46,58,535,104,2238
"Bexley","10:00:00","2018-07-05",80,2,0,17,0,99
"Bromley","10:00:00","2018-07-05",729,7,46,118,16,916
"Greenwich","10:00:00","2018-07-05",86,1,0,29,1,117
"Harrow","10:00:00","2018-07-05",27,0,0,2,0,29
"Kensington and Chelsea","10:00:00","2018-07-05",828,36,35,374,99,1372
"Kingston upon Thames","10:00:00","2018-07-05",1182,28,53,191,38,1492
"Merton","10:00:00","2018-07-05",79,1,1,15,0,96
"Redbridge","10:00:00","2018-07-05",555,3,64,72,17,711
"Westminster","10:00:00","2018-07-05",33,7,0,11,1,52
"Barnet","11:00:00","2018-07-05",1741,37,53,572,84,2487
"Bexley","11:00:00","2018-07-05",118,0,0,12,3,133
"Bromley","11:00:00","2018-07-05",821,6,33,104,19,983
"Greenwich","11:00:00","2018-07-05",77,4,0,15,3,99
"Harrow","11:00:00","2018-07-05",29,0,0,9,0,38
"Kensington and Chelsea","11:00:00","2018-07-05",858,63,37,365,85,1408
"Kingston upon Thames","11:00:00","2018-07-05",1127,22,38,172,34,1393
"Merton","11:00:00","2018-07-05",96,1,0,23,0,120
"Redbridge","11:00:00","2018-07-05",602,3,63,66,16,750
"Westminster","11:00:00","2018-07-05",31,8,0,13,3,55
"Barnet","12:00:00","2018-07-05",1750,47,50,596,94,2537
"Bexley","12:00:00","2018-07-05",114,1,0,17,2,134
"Bromley","12:00:00","2018-07-05",777,9,36,136,13,971
"Greenwich","12:00:00","2018-07-05",100,1,0,14,1,116
"Harrow","12:00:00","2018-07-05",28,0,0,6,0,34
"Kensington and Chelsea","12:00:00","2018-07-05",666,46,24,368,83,1187
"Kingston upon Thames","12:00:00","2018-07-05",1257,28,32,192,31,1540
"Merton","12:00:00","2018-07-05",83,1,0,18,0,102
"Redbridge","12:00:00","2018-07-05",694,11,67,93,9,874
"Westminster","12:00:00","2018-07-05",32,9,0,9,1,51
"Barnet","13:00:00","2018-07-05",1697,40,46,592,92,2467
"Bexley","13:00:00","2018-07-05",82,2,0,17,1,102
"Bromley","13:00:00","2018-07-05",692,4,37,123,12,868
"Greenwich","13:00:00","2018-07-05",83,1,0,10,0,94
"Harrow","13:00:00","2018-07-05",32,0,0,2,0,34
"Kensington and Chelsea","13:00:00","2018-07-05",854,67,34,378,80,1413
"Kingston upon Thames","13:00:00","2018-07-05",972,28,35,182,36,1253
"Merton","13:00:00","2018-07-05",88,2,0,17,0,107
"Redbridge","13:00:00","2018-07-05",615,12,60,85,15,787
"Westminster","13:00:00","2018-07-05",21,7,0,8,0,36
"Barnet","14:00:00","2018-07-05",1789,52,55,559,69,2524
"Bexley","14:00:00","2018-07-05",114,5,0,26,0,145
"Bromley","14:00:00","2018-07-05",816,9,36,140,13,1014
"Greenwich","14:00:00","2018-07-05",106,0,4,16,2,128
"Harrow","14:00:00","2018-07-05",33,0,0,3,0,36
"Kensington and Chelsea","14:00:00","2018-07-05",914,68,28,292,71,1373
"Kingston upon Thames","14:00:00","2018-07-05",1205,27,40,191,33,1496
"Merton","14:00:00","2018-07-05",115,4,2,26,0,147
"Redbridge","14:00:00","2018-07-05",620,7,67,69,9,772
"Westminster","14:00:00","2018-07-05",33,10,0,6,0,49
"Barnet","15:00:00","2018-07-05",1841,64,53,541,73,2572
"Bexley","15:00:00","2018-07-05",186,3,0,23,0,212
"Bromley","15:00:00","2018-07-05",889,15,39,157,8,1108
"Greenwich","15:00:00","2018-07-05",134,0,0,5,3,142
"Harrow","15:00:00","2018-07-05",39,4,0,4,0,47
"Kensington and Chelsea","15:00:00","2018-07-05",771,67,22,294,41,1195
"Kingston upon Thames","15:00:00","2018-07-05",1188,26,33,191,32,1470
"Merton","15:00:00","2018-07-05",187,6,2,25,1,221
"Redbridge","15:00:00","2018-07-05",809,7,64,62,11,953
"Westminster","15:00:00","2018-07-05",30,5,0,7,1,43
"Barnet","16:00:00","2018-07-05",1920,83,53,540,35,2631
"Bexley","16:00:00","2018-07-05",161,5,0,24,2,192
"Bromley","16:00:00","2018-07-05",855,28,35,165,3,1086
"Greenwich","16:00:00","2018-07-05",168,6,0,9,0,183
"Harrow","16:00:00","2018-07-05",37,0,0,3,0,40
"Kensington and Chelsea","16:00:00","2018-07-05",1052,97,31,324,32,1536
"Kingston upon Thames","16:00:00","2018-07-05",1280,31,27,166,16,1520
"Merton","16:00:00","2018-07-05",168,5,2,51,0,226
"Redbridge","16:00:00","2018-07-05",805,8,71,77,3,964
"Westminster","16:00:00","2018-07-05",32,10,0,4,1,47
"Barnet","17:00:00","2018-07-05",2193,126,65,488,36,2908
"Bexley","17:00:00","2018-07-05",218,8,0,37,0,263
"Bromley","17:00:00","2018-07-05",1226,19,30,112,4,1391
"Greenwich","17:00:00","2018-07-05",202,2,0,7,0,211
"Harrow","17:00:00","2018-07-05",41,0,0,4,0,45
"Kensington and Chelsea","17:00:00","2018-07-05",1065,113,21,222,27,1448
"Kingston upon Thames","17:00:00","2018-07-05",1314,33,45,109,13,1514
"Merton","17:00:00","2018-07-05",187,14,0,29,0,230
"Redbridge","17:00:00","2018-07-05",776,13,55,66,1,911
"Westminster","17:00:00","2018-07-05",34,16,0,2,0,52
"Barnet","18:00:00","2018-07-05",2391,147,72,433,37,3080
"Bexley","18:00:00","2018-07-05",173,3,0,12,0,188
"Bromley","18:00:00","2018-07-05",1152,15,53,74,4,1298
"Greenwich","18:00:00","2018-07-05",120,2,0,9,0,131
"Harrow","18:00:00","2018-07-05",33,0,0,2,0,35
"Kensington and Chelsea","18:00:00","2018-07-05",1264,139,30,175,15,1623
"Kingston upon Thames","18:00:00","2018-07-05",1423,38,33,108,6,1608
"Merton","18:00:00","2018-07-05",178,8,0,34,0,220
"Redbridge","18:00:00","2018-07-05",880,10,53,56,2,1001
"Westminster","18:00:00","2018-07-05",48,12,0,2,0,62
"Barnet","07:00:00","2018-07-06",20,1,0,2,1,24
"Croydon","07:00:00","2018-07-06",95,1,6,9,0,111
"Islington","07:00:00","2018-07-06",219,32,69,151,48,519
"Newham","07:00:00","2018-07-06",1219,54,27,391,147,1838
"Sutton","07:00:00","2018-07-06",914,13,45,175,16,1163
"Tower Hamlets","07:00:00","2018-07-06",403,60,66,79,17,625
"Waltham Forest","07:00:00","2018-07-06",817,20,19,238,22,1116
"Barnet","08:00:00","2018-07-06",41,1,0,8,1,51
"Croydon","08:00:00","2018-07-06",320,1,8,10,0,339
"Islington","08:00:00","2018-07-06",218,26,64,118,52,478
"Newham","08:00:00","2018-07-06",1145,13,25,318,165,1666
"Sutton","08:00:00","2018-07-06",948,16,42,173,22,1201
"Tower Hamlets","08:00:00","2018-07-06",502,75,41,96,20,734
"Waltham Forest","08:00:00","2018-07-06",743,10,20,148,23,944
"Barnet","09:00:00","2018-07-06",42,1,0,7,0,50
"Croydon","09:00:00","2018-07-06",85,0,8,15,0,108
"Islington","09:00:00","2018-07-06",231,34,65,128,39,497
"Newham","09:00:00","2018-07-06",1199,16,27,338,185,1765
"Sutton","09:00:00","2018-07-06",933,4,42,147,19,1145
"Tower Hamlets","09:00:00","2018-07-06",457,33,26,78,16,610
"Waltham Forest","09:00:00","2018-07-06",747,8,26,144,30,955
"Barnet","10:00:00","2018-07-06",26,0,0,5,0,31
"Croydon","10:00:00","2018-07-06",49,0,8,11,1,69
"Islington","10:00:00","2018-07-06",396,24,72,168,35,695
"Newham","10:00:00","2018-07-06",1274,5,26,312,179,1796
"Sutton","10:00:00","2018-07-06",802,7,37,117,18,981
"Tower Hamlets","10:00:00","2018-07-06",306,23,23,91,20,463
"Waltham Forest","10:00:00","2018-07-06",728,8,23,178,23,960
"Barnet","11:00:00","2018-07-06",21,0,0,3,0,24
"Croydon","11:00:00","2018-07-06",53,0,11,9,0,73
"Islington","11:00:00","2018-07-06",303,24,72,166,52,617
"Newham","11:00:00","2018-07-06",1366,19,25,316,188,1914
"Sutton","11:00:00","2018-07-06",851,13,32,161,21,1078
"Tower Hamlets","11:00:00","2018-07-06",287,22,20,90,14,433
"Waltham Forest","11:00:00","2018-07-06",636,9,23,110,27,805
"Barnet","12:00:00","2018-07-06",28,0,0,6,0,34
"Croydon","12:00:00","2018-07-06",42,0,7,16,0,65
"Islington","12:00:00","2018-07-06",315,47,54,194,40,650
"Newham","12:00:00","2018-07-06",1654,16,27,347,193,2237
"Sutton","12:00:00","2018-07-06",935,14,43,171,10,1173
"Tower Hamlets","12:00:00","2018-07-06",316,54,23,61,16,470
"Waltham Forest","12:00:00","2018-07-06",647,19,15,87,16,784
"Barnet","13:00:00","2018-07-06",21,0,0,3,0,24
"Croydon","13:00:00","2018-07-06",44,0,8,16,0,68
"Islington","13:00:00","2018-07-06",375,36,58,148,36,653
"Newham","13:00:00","2018-07-06",1581,23,27,310,176,2117
"Sutton","13:00:00","2018-07-06",876,13,43,140,13,1085
"Tower Hamlets","13:00:00","2018-07-06",303,40,24,63,14,444
"Waltham Forest","13:00:00","2018-07-06",731,16,18,131,25,921
"Barnet","14:00:00","2018-07-06",33,0,0,1,0,34
"Camden","14:00:00","2018-07-06",1977,125,154,469,134,2859
"Croydon","14:00:00","2018-07-06",160,0,10,19,0,189
"Islington","14:00:00","2018-07-06",349,45,65,139,49,647
"Newham","14:00:00","2018-07-06",1621,37,28,295,129,2110
"Sutton","14:00:00","2018-07-06",965,17,38,116,15,1151
"Tower Hamlets","14:00:00","2018-07-06",379,42,24,71,10,526
"Waltham Forest","14:00:00","2018-07-06",680,14,17,119,15,845
"Barnet","15:00:00","2018-07-06",29,2,0,2,0,33
"Croydon","15:00:00","2018-07-06",145,0,10,19,0,174
"Islington","15:00:00","2018-07-06",351,46,56,139,41,633
"Newham","15:00:00","2018-07-06",1627,40,29,302,123,2121
"Sutton","15:00:00","2018-07-06",1069,12,33,153,13,1280
"Tower Hamlets","15:00:00","2018-07-06",402,47,25,61,12,547
"Waltham Forest","15:00:00","2018-07-06",680,12,14,87,3,796
"Barnet","16:00:00","2018-07-06",36,1,0,4,0,41
"Croydon","16:00:00","2018-07-06",65,0,13,5,0,83
"Islington","16:00:00","2018-07-06",387,46,67,127,16,643
"Newham","16:00:00","2018-07-06",1775,44,31,313,96,2259
"Sutton","16:00:00","2018-07-06",1034,10,46,163,4,1257
"Tower Hamlets","16:00:00","2018-07-06",428,54,28,53,5,568
"Waltham Forest","16:00:00","2018-07-06",790,26,16,136,10,978
"Barnet","17:00:00","2018-07-06",50,1,0,2,0,53
"Croydon","17:00:00","2018-07-06",53,0,8,6,0,67
"Islington","17:00:00","2018-07-06",460,71,65,94,23,713
"Newham","17:00:00","2018-07-06",1818,51,29,293,63,2254
"Sutton","17:00:00","2018-07-06",1251,27,38,137,4,1457
"Tower Hamlets","17:00:00","2018-07-06",541,105,31,46,10,733
"Waltham Forest","17:00:00","2018-07-06",757,11,15,93,5,881
"Barnet","18:00:00","2018-07-06",36,3,0,5,0,44
"Croydon","18:00:00","2018-07-06",58,0,7,4,0,69
"Islington","18:00:00","2018-07-06",516,84,62,75,7,744
"Newham","18:00:00","2018-07-06",1924,40,26,222,56,2268
"Sutton","18:00:00","2018-07-06",1162,24,44,119,1,1350
"Tower Hamlets","18:00:00","2018-07-06",499,75,29,17,9,629
"Waltham Forest","18:00:00","2018-07-06",971,12,19,90,7,1099
"Bexley","07:00:00","2018-07-09",460,4,17,85,1,567
"Croydon","07:00:00","2018-07-09",892,45,21,351,68,1377
"Havering","07:00:00","2018-07-09",520,10,13,85,14,642
"Hillingdon","07:00:00","2018-07-09",152,0,0,21,2,175
"Islington","07:00:00","2018-07-09",362,49,104,155,25,695
"Kingston upon Thames","07:00:00","2018-07-09",255,3,2,56,6,322
"Newham","07:00:00","2018-07-09",342,7,26,66,2,443
"Southwark","07:00:00","2018-07-09",188,27,65,133,38,451
"Waltham Forest","07:00:00","2018-07-09",25,0,0,5,0,30
"Westminster","07:00:00","2018-07-09",221,17,10,135,27,410
"Bexley","08:00:00","2018-07-09",589,6,20,82,7,704
"Croydon","08:00:00","2018-07-09",994,51,19,316,75,1455
"Havering","08:00:00","2018-07-09",701,8,17,66,7,799
"Hillingdon","08:00:00","2018-07-09",367,0,0,24,0,391
"Islington","08:00:00","2018-07-09",405,60,110,185,26,786
"Kingston upon Thames","08:00:00","2018-07-09",366,2,2,52,7,429
"Newham","08:00:00","2018-07-09",454,7,29,60,7,557
"Southwark","08:00:00","2018-07-09",215,47,74,131,21,488
"Waltham Forest","08:00:00","2018-07-09",34,2,0,0,0,36
"Westminster","08:00:00","2018-07-09",202,27,15,126,34,404
"Bexley","09:00:00","2018-07-09",489,3,21,49,6,568
"Croydon","09:00:00","2018-07-09",995,37,16,354,86,1488
"Havering","09:00:00","2018-07-09",575,3,12,74,11,675
"Hillingdon","09:00:00","2018-07-09",87,1,0,14,0,102
"Islington","09:00:00","2018-07-09",339,61,108,196,30,734
"Kingston upon Thames","09:00:00","2018-07-09",297,2,0,61,8,368
"Newham","09:00:00","2018-07-09",360,9,24,78,5,476
"Southwark","09:00:00","2018-07-09",374,47,92,168,29,710
"Waltham Forest","09:00:00","2018-07-09",22,0,0,11,1,34
"Westminster","09:00:00","2018-07-09",225,26,26,107,18,402
"Bexley","10:00:00","2018-07-09",451,3,17,53,2,526
"Croydon","10:00:00","2018-07-09",948,30,13,330,81,1402
"Havering","10:00:00","2018-07-09",532,5,8,63,10,618
"Hillingdon","10:00:00","2018-07-09",78,1,0,10,1,90
"Islington","10:00:00","2018-07-09",329,37,109,168,35,678
"Kingston upon Thames","10:00:00","2018-07-09",250,5,0,67,8,330
"Newham","10:00:00","2018-07-09",297,7,28,58,7,397
"Southwark","10:00:00","2018-07-09",402,26,103,189,22,742
"Waltham Forest","10:00:00","2018-07-09",43,0,0,8,1,52
"Westminster","10:00:00","2018-07-09",336,23,20,113,11,503
"Bexley","11:00:00","2018-07-09",475,4,19,49,3,550
"Croydon","11:00:00","2018-07-09",1004,36,20,407,88,1555
"Havering","11:00:00","2018-07-09",585,2,9,63,11,670
"Hillingdon","11:00:00","2018-07-09",92,1,0,9,0,102
"Islington","11:00:00","2018-07-09",380,33,94,165,31,703
"Kingston upon Thames","11:00:00","2018-07-09",253,3,0,58,6,320
"Newham","11:00:00","2018-07-09",336,10,23,68,15,452
"Southwark","11:00:00","2018-07-09",322,34,100,108,31,595
"Waltham Forest","11:00:00","2018-07-09",38,0,0,8,2,48
"Westminster","11:00:00","2018-07-09",209,53,18,116,11,407
"Bexley","12:00:00","2018-07-09",444,5,17,67,5,538
"Croydon","12:00:00","2018-07-09",955,36,17,378,75,1461
"Havering","12:00:00","2018-07-09",643,5,12,85,8,753
"Hillingdon","12:00:00","2018-07-09",93,3,0,9,2,107
"Islington","12:00:00","2018-07-09",318,63,98,167,23,669
"Kingston upon Thames","12:00:00","2018-07-09",297,5,0,61,5,368
"Newham","12:00:00","2018-07-09",335,18,30,65,4,452
"Southwark","12:00:00","2018-07-09",341,65,96,104,22,628
"Waltham Forest","12:00:00","2018-07-09",51,0,0,7,1,59
"Westminster","12:00:00","2018-07-09",273,50,20,97,11,451
"Bexley","13:00:00","2018-07-09",473,7,16,37,4,537
"Croydon","13:00:00","2018-07-09",899,44,16,321,45,1325
"Havering","13:00:00","2018-07-09",658,2,9,78,10,757
"Hillingdon","13:00:00","2018-07-09",75,2,0,8,2,87
"Islington","13:00:00","2018-07-09",333,45,99,150,21,648
"Kingston upon Thames","13:00:00","2018-07-09",284,6,0,43,4,337
"Newham","13:00:00","2018-07-09",368,13,27,64,7,479
"Southwark","13:00:00","2018-07-09",282,48,81,90,16,517
"Waltham Forest","13:00:00","2018-07-09",31,0,0,12,0,43
"Westminster","13:00:00","2018-07-09",369,39,17,120,9,554
"Bexley","14:00:00","2018-07-09",506,7,14,59,2,588
"Croydon","14:00:00","2018-07-09",1099,31,17,353,56,1556
"Havering","14:00:00","2018-07-09",733,6,13,71,11,834
"Hillingdon","14:00:00","2018-07-09",124,0,0,18,3,145
"Islington","14:00:00","2018-07-09",425,45,108,166,23,767
"Kingston upon Thames","14:00:00","2018-07-09",264,5,3,33,5,310
"Newham","14:00:00","2018-07-09",403,8,25,58,6,500
"Southwark","14:00:00","2018-07-09",311,48,95,92,11,557
"Waltham Forest","14:00:00","2018-07-09",43,1,0,7,0,51
"Westminster","14:00:00","2018-07-09",376,32,17,86,11,522
"Bexley","15:00:00","2018-07-09",607,8,20,58,3,696
"Croydon","15:00:00","2018-07-09",1107,28,15,302,49,1501
"Havering","15:00:00","2018-07-09",701,11,12,87,7,818
"Hillingdon","15:00:00","2018-07-09",216,4,0,16,0,236
"Islington","15:00:00","2018-07-09",363,63,102,165,9,702
"Kingston upon Thames","15:00:00","2018-07-09",338,5,2,50,5,400
"Newham","15:00:00","2018-07-09",535,10,37,74,3,659
"Southwark","15:00:00","2018-07-09",312,31,86,81,3,513
"Waltham Forest","15:00:00","2018-07-09",39,1,0,8,0,48
"Westminster","15:00:00","2018-07-09",333,36,14,61,6,450
"Bexley","16:00:00","2018-07-09",547,6,18,78,0,649
"Croydon","16:00:00","2018-07-09",1062,52,17,292,36,1459
"Havering","16:00:00","2018-07-09",749,7,11,83,6,856
"Hillingdon","16:00:00","2018-07-09",179,1,0,15,0,195
"Islington","16:00:00","2018-07-09",410,54,103,126,8,701
"Kingston upon Thames","16:00:00","2018-07-09",322,4,0,42,4,372
"Newham","16:00:00","2018-07-09",418,16,25,58,2,519
"Southwark","16:00:00","2018-07-09",290,29,92,67,5,483
"Waltham Forest","16:00:00","2018-07-09",56,1,0,10,0,67
"Westminster","16:00:00","2018-07-09",503,54,18,69,8,652
"Bexley","17:00:00","2018-07-09",560,12,18,68,1,659
"Croydon","17:00:00","2018-07-09",1277,53,17,262,18,1627
"Havering","17:00:00","2018-07-09",778,7,11,80,2,878
"Hillingdon","17:00:00","2018-07-09",245,0,0,19,0,264
"Islington","17:00:00","2018-07-09",442,110,103,106,1,762
"Kingston upon Thames","17:00:00","2018-07-09",403,4,0,38,1,446
"Newham","17:00:00","2018-07-09",494,14,33,65,2,608
"Southwark","17:00:00","2018-07-09",304,56,70,50,4,484
"Waltham Forest","17:00:00","2018-07-09",57,0,0,6,0,63
"Westminster","17:00:00","2018-07-09",483,39,21,58,8,609
"Bexley","18:00:00","2018-07-09",553,6,15,53,4,631
"Croydon","18:00:00","2018-07-09",1122,35,12,248,12,1429
"Havering","18:00:00","2018-07-09",667,7,12,69,4,759
"Hillingdon","18:00:00","2018-07-09",242,1,0,18,0,261
"Islington","18:00:00","2018-07-09",480,118,112,89,2,801
"Kingston upon Thames","18:00:00","2018-07-09",361,5,2,26,0,394
"Newham","18:00:00","2018-07-09",454,19,32,61,1,567
"Southwark","18:00:00","2018-07-09",268,87,80,34,5,474
"Waltham Forest","18:00:00","2018-07-09",42,2,0,4,0,48
"Westminster","18:00:00","2018-07-09",567,66,15,23,4,675
"Barnet","07:00:00","2018-07-10",209,2,0,14,1,226
"Ealing","07:00:00","2018-07-10",4638,153,14,1151,428,6384
"Enfield","07:00:00","2018-07-10",995,4,12,269,63,1343
"Greenwich","07:00:00","2018-07-10",3168,345,20,1217,304,5054
"Tower Hamlets","07:00:00","2018-07-10",78,4,0,19,3,104
"Wandsworth","07:00:00","2018-07-10",1727,203,52,681,99,2762
"Barnet","08:00:00","2018-07-10",414,1,0,27,0,442
"Ealing","08:00:00","2018-07-10",4620,139,27,801,497,6084
"Enfield","08:00:00","2018-07-10",926,7,8,146,40,1127
"Greenwich","08:00:00","2018-07-10",3145,319,25,903,288,4680
"Tower Hamlets","08:00:00","2018-07-10",118,1,2,34,4,159
"Wandsworth","08:00:00","2018-07-10",1846,204,41,473,143,2707
"Barnet","09:00:00","2018-07-10",185,0,0,18,0,203
"Ealing","09:00:00","2018-07-10",4372,88,61,982,649,6152
"Enfield","09:00:00","2018-07-10",683,4,11,127,70,895
"Greenwich","09:00:00","2018-07-10",3002,134,42,871,330,4379
"Tower Hamlets","09:00:00","2018-07-10",122,4,0,29,5,160
"Wandsworth","09:00:00","2018-07-10",1655,152,44,515,141,2507
"Barnet","10:00:00","2018-07-10",126,10,0,18,3,157
"Ealing","10:00:00","2018-07-10",3917,56,37,1065,704,5779
"Enfield","10:00:00","2018-07-10",572,0,16,142,70,800
"Greenwich","10:00:00","2018-07-10",2782,79,16,916,361,4154
"Tower Hamlets","10:00:00","2018-07-10",104,1,0,30,5,140
"Wandsworth","10:00:00","2018-07-10",1627,122,36,490,189,2464
"Barnet","11:00:00","2018-07-10",116,0,0,15,1,132
"Ealing","11:00:00","2018-07-10",4113,60,36,1125,646,5980
"Enfield","11:00:00","2018-07-10",558,5,17,114,65,759
"Greenwich","11:00:00","2018-07-10",2872,85,8,990,408,4363
"Tower Hamlets","11:00:00","2018-07-10",83,0,0,29,3,115
"Wandsworth","11:00:00","2018-07-10",1643,86,39,456,143,2367
"Barnet","12:00:00","2018-07-10",119,1,0,19,1,140
"Ealing","12:00:00","2018-07-10",4451,63,41,1219,778,6552
"Enfield","12:00:00","2018-07-10",562,4,18,107,46,737
"Greenwich","12:00:00","2018-07-10",3030,76,11,1001,390,4508
"Tower Hamlets","12:00:00","2018-07-10",115,4,0,34,4,157
"Wandsworth","12:00:00","2018-07-10",1636,113,41,481,156,2427
"Barnet","13:00:00","2018-07-10",104,4,0,14,1,123
"Ealing","13:00:00","2018-07-10",3988,58,31,1165,753,5995
"Enfield","13:00:00","2018-07-10",505,3,19,121,67,715
"Greenwich","13:00:00","2018-07-10",2968,82,8,1000,361,4419
"Tower Hamlets","13:00:00","2018-07-10",111,4,0,24,2,141
"Wandsworth","13:00:00","2018-07-10",1465,142,39,513,130,2289
"Barnet","14:00:00","2018-07-10",126,3,0,16,2,147
"Ealing","14:00:00","2018-07-10",4456,60,39,1336,760,6651
"Enfield","14:00:00","2018-07-10",642,4,19,157,74,896
"Greenwich","14:00:00","2018-07-10",3249,95,20,1199,322,4885
"Tower Hamlets","14:00:00","2018-07-10",133,8,0,30,6,177
"Wandsworth","14:00:00","2018-07-10",1486,138,39,460,162,2285
"Barnet","15:00:00","2018-07-10",151,4,0,13,1,169
"Ealing","15:00:00","2018-07-10",4821,79,39,1323,622,6884
"Enfield","15:00:00","2018-07-10",746,13,12,203,79,1053
"Greenwich","15:00:00","2018-07-10",2939,104,18,1124,266,4451
"Tower Hamlets","15:00:00","2018-07-10",121,4,2,25,1,153
"Wandsworth","15:00:00","2018-07-10",1726,113,49,441,108,2437
"Barnet","16:00:00","2018-07-10",183,1,0,16,1,201
"Ealing","16:00:00","2018-07-10",6071,151,22,1498,442,8184
"Enfield","16:00:00","2018-07-10",883,7,13,203,42,1148
"Greenwich","16:00:00","2018-07-10",3457,250,10,1033,166,4916
"Tower Hamlets","16:00:00","2018-07-10",104,5,0,21,2,132
"Wandsworth","16:00:00","2018-07-10",1858,161,51,513,69,2652
"Barnet","17:00:00","2018-07-10",205,0,0,20,0,225
"Ealing","17:00:00","2018-07-10",6647,206,40,1224,274,8391
"Enfield","17:00:00","2018-07-10",1176,3,11,146,28,1364
"Greenwich","17:00:00","2018-07-10",4215,357,36,1021,120,5749
"Tower Hamlets","17:00:00","2018-07-10",153,1,1,20,0,175
"Wandsworth","17:00:00","2018-07-10",1975,276,39,403,39,2732
"Barnet","18:00:00","2018-07-10",271,0,0,20,0,291
"Ealing","18:00:00","2018-07-10",6653,185,50,860,253,8001
"Enfield","18:00:00","2018-07-10",1223,5,11,158,23,1420
"Greenwich","18:00:00","2018-07-10",4312,382,66,751,112,5623
"Tower Hamlets","18:00:00","2018-07-10",154,7,0,15,0,176
"Wandsworth","18:00:00","2018-07-10",2154,318,44,236,27,2779
"Bexley","07:00:00","2018-07-11",810,44,26,170,9,1059
"Croydon","07:00:00","2018-07-11",1919,74,40,486,120,2639
"Ealing","07:00:00","2018-07-11",837,64,24,287,25,1237
"Greenwich","07:00:00","2018-07-11",239,3,14,15,0,271
"Haringey","07:00:00","2018-07-11",851,37,27,339,28,1282
"Harrow","07:00:00","2018-07-11",1394,21,33,278,55,1781
"Hounslow","07:00:00","2018-07-11",562,20,2,123,8,715
"Richmond upon Thames","07:00:00","2018-07-11",796,27,26,286,18,1153
"Bexley","08:00:00","2018-07-11",1009,27,25,132,11,1204
"Croydon","08:00:00","2018-07-11",2041,53,41,356,139,2630
"Ealing","08:00:00","2018-07-11",700,53,22,208,29,1012
"Greenwich","08:00:00","2018-07-11",406,2,12,23,7,450
"Haringey","08:00:00","2018-07-11",1024,35,28,267,30,1384
"Harrow","08:00:00","2018-07-11",1089,24,27,206,73,1419
"Hounslow","08:00:00","2018-07-11",813,16,5,102,8,944
"Richmond upon Thames","08:00:00","2018-07-11",641,23,30,169,18,881
"Bexley","09:00:00","2018-07-11",861,13,37,155,18,1084
"Croydon","09:00:00","2018-07-11",1791,25,49,384,142,2391
"Ealing","09:00:00","2018-07-11",694,38,16,249,50,1047
"Greenwich","09:00:00","2018-07-11",255,0,12,29,1,297
"Haringey","09:00:00","2018-07-11",1045,25,33,281,41,1425
"Harrow","09:00:00","2018-07-11",1166,8,27,202,85,1488
"Hounslow","09:00:00","2018-07-11",678,8,0,75,5,766
"Richmond upon Thames","09:00:00","2018-07-11",706,7,20,203,18,954
"Bexley","10:00:00","2018-07-11",659,12,31,128,15,845
"Croydon","10:00:00","2018-07-11",1612,24,41,364,131,2172
"Ealing","10:00:00","2018-07-11",749,55,23,258,58,1143
"Greenwich","10:00:00","2018-07-11",238,0,12,37,3,290
"Haringey","10:00:00","2018-07-11",843,15,27,325,35,1245
"Harrow","10:00:00","2018-07-11",1063,9,22,240,82,1416
"Hounslow","10:00:00","2018-07-11",549,4,2,49,5,609
"Richmond upon Thames","10:00:00","2018-07-11",648,13,21,200,24,906
"Bexley","11:00:00","2018-07-11",682,12,30,142,13,879
"Croydon","11:00:00","2018-07-11",1448,22,36,368,108,1982
"Ealing","11:00:00","2018-07-11",771,37,21,227,33,1089
"Greenwich","11:00:00","2018-07-11",237,2,12,46,1,298
"Haringey","11:00:00","2018-07-11",952,27,26,294,35,1334
"Harrow","11:00:00","2018-07-11",1194,13,18,246,118,1589
"Hounslow","11:00:00","2018-07-11",516,9,0,69,9,603
"Richmond upon Thames","11:00:00","2018-07-11",569,14,25,200,22,830
"Bexley","12:00:00","2018-07-11",698,11,21,115,19,864
"Croydon","12:00:00","2018-07-11",1345,24,35,324,130,1858
"Ealing","12:00:00","2018-07-11",774,48,18,228,31,1099
"Greenwich","12:00:00","2018-07-11",207,0,10,42,1,260
"Haringey","12:00:00","2018-07-11",803,16,30,274,34,1157
"Harrow","12:00:00","2018-07-11",1159,12,17,224,85,1497
"Hounslow","12:00:00","2018-07-11",522,6,0,67,3,598
"Richmond upon Thames","12:00:00","2018-07-11",650,22,21,185,14,892
"Bexley","13:00:00","2018-07-11",770,13,30,136,9,958
"Croydon","13:00:00","2018-07-11",1429,17,35,374,130,1985
"Ealing","13:00:00","2018-07-11",647,42,13,218,32,952
"Greenwich","13:00:00","2018-07-11",238,2,11,30,0,281
"Haringey","13:00:00","2018-07-11",879,27,26,266,33,1231
"Harrow","13:00:00","2018-07-11",1133,9,18,205,71,1436
"Hounslow","13:00:00","2018-07-11",517,9,1,62,1,590
"Richmond upon Thames","13:00:00","2018-07-11",634,30,25,194,21,904
"Bexley","14:00:00","2018-07-11",826,15,26,156,12,1035
"Croydon","14:00:00","2018-07-11",1541,21,41,382,124,2109
"Ealing","14:00:00","2018-07-11",853,27,25,227,48,1180
"Greenwich","14:00:00","2018-07-11",249,5,12,48,0,314
"Haringey","14:00:00","2018-07-11",992,30,29,275,38,1364
"Harrow","14:00:00","2018-07-11",1096,16,18,253,73,1456
"Hounslow","14:00:00","2018-07-11",595,22,5,92,8,722
"Richmond upon Thames","14:00:00","2018-07-11",678,32,24,189,22,945
"Bexley","15:00:00","2018-07-11",852,21,27,158,8,1066
"Croydon","15:00:00","2018-07-11",1534,20,42,362,89,2047
"Ealing","15:00:00","2018-07-11",935,40,19,208,31,1233
"Greenwich","15:00:00","2018-07-11",387,4,18,49,0,458
"Haringey","15:00:00","2018-07-11",1090,22,29,276,19,1436
"Harrow","15:00:00","2018-07-11",1330,14,26,229,63,1662
"Hounslow","15:00:00","2018-07-11",737,12,2,100,7,858
"Richmond upon Thames","15:00:00","2018-07-11",825,19,23,233,7,1107
"Bexley","16:00:00","2018-07-11",1073,37,27,183,4,1324
"Croydon","16:00:00","2018-07-11",1919,41,39,348,48,2395
"Ealing","16:00:00","2018-07-11",895,41,26,240,26,1228
"Greenwich","16:00:00","2018-07-11",298,4,10,29,1,342
"Haringey","16:00:00","2018-07-11",1163,43,31,264,18,1519
"Harrow","16:00:00","2018-07-11",1245,18,25,210,31,1529
"Hounslow","16:00:00","2018-07-11",894,20,5,101,2,1022
"Richmond upon Thames","16:00:00","2018-07-11",795,23,18,177,3,1016
"Bexley","17:00:00","2018-07-11",1122,51,24,160,5,1362
"Croydon","17:00:00","2018-07-11",1802,42,42,246,30,2162
"Ealing","17:00:00","2018-07-11",1016,62,14,175,20,1287
"Greenwich","17:00:00","2018-07-11",373,11,10,30,2,426
"Haringey","17:00:00","2018-07-11",1249,56,25,258,10,1598
"Harrow","17:00:00","2018-07-11",1292,24,28,182,35,1561
"Hounslow","17:00:00","2018-07-11",908,25,0,83,1,1017
"Richmond upon Thames","17:00:00","2018-07-11",914,42,20,136,5,1117
"Bexley","18:00:00","2018-07-11",1188,44,37,92,0,1361
"Croydon","18:00:00","2018-07-11",1918,31,43,192,33,2217
"Ealing","18:00:00","2018-07-11",1093,50,11,108,17,1279
"Greenwich","18:00:00","2018-07-11",442,4,12,19,0,477
"Haringey","18:00:00","2018-07-11",1284,75,26,185,5,1575
"Harrow","18:00:00","2018-07-11",1361,20,31,137,19,1568
"Hounslow","18:00:00","2018-07-11",865,30,1,70,0,966
"Richmond upon Thames","18:00:00","2018-07-11",945,28,22,82,0,1077
"Barking and Dagenham","07:00:00","2018-07-12",708,22,5,217,21,973
"Barnet","07:00:00","2018-07-12",44,0,6,16,2,68
"Bexley","07:00:00","2018-07-12",952,18,6,308,43,1327
"Bromley","07:00:00","2018-07-12",233,1,5,24,8,271
"Croydon","07:00:00","2018-07-12",420,2,3,60,2,487
"Ealing","07:00:00","2018-07-12",127,3,0,30,0,160
"Harrow","07:00:00","2018-07-12",396,2,0,45,1,444
"Havering","07:00:00","2018-07-12",24,0,0,4,0,28
"Hillingdon","07:00:00","2018-07-12",155,1,0,37,0,193
"Lambeth","07:00:00","2018-07-12",506,153,94,351,100,1204
"Merton","07:00:00","2018-07-12",1212,74,24,348,73,1731
"Southwark","07:00:00","2018-07-12",850,169,44,408,48,1519
"Barking and Dagenham","08:00:00","2018-07-12",713,12,6,188,33,952
"Barnet","08:00:00","2018-07-12",101,0,5,6,2,114
"Bexley","08:00:00","2018-07-12",985,10,21,212,49,1277
"Bromley","08:00:00","2018-07-12",808,0,2,66,3,879
"Croydon","08:00:00","2018-07-12",519,1,5,43,4,572
"Ealing","08:00:00","2018-07-12",129,3,0,22,1,155
"Harrow","08:00:00","2018-07-12",446,3,1,43,4,497
"Havering","08:00:00","2018-07-12",30,0,0,1,0,31
"Hillingdon","08:00:00","2018-07-12",240,1,0,30,3,274
"Lambeth","08:00:00","2018-07-12",510,168,96,298,60,1132
"Merton","08:00:00","2018-07-12",1197,41,23,278,67,1606
"Southwark","08:00:00","2018-07-12",805,175,51,407,51,1489
"Barking and Dagenham","09:00:00","2018-07-12",555,11,5,169,32,772
"Barnet","09:00:00","2018-07-12",72,0,5,10,0,87
"Bexley","09:00:00","2018-07-12",1004,7,11,191,58,1271
"Bromley","09:00:00","2018-07-12",424,0,3,65,0,492
"Croydon","09:00:00","2018-07-12",397,1,7,44,3,452
"Ealing","09:00:00","2018-07-12",113,1,0,21,0,135
"Harrow","09:00:00","2018-07-12",412,1,1,50,7,471
"Havering","09:00:00","2018-07-12",40,0,0,12,0,52
"Hillingdon","09:00:00","2018-07-12",157,1,0,17,4,179
"Lambeth","09:00:00","2018-07-12",585,108,98,312,74,1177
"Merton","09:00:00","2018-07-12",948,24,29,312,96,1409
"Southwark","09:00:00","2018-07-12",764,117,50,390,56,1377
"Barking and Dagenham","10:00:00","2018-07-12",517,6,0,131,43,697
"Barnet","10:00:00","2018-07-12",51,1,5,4,0,61
"Bexley","10:00:00","2018-07-12",845,15,9,236,49,1154
"Bromley","10:00:00","2018-07-12",154,3,1,31,2,191
"Croydon","10:00:00","2018-07-12",254,0,5,51,2,312
"Ealing","10:00:00","2018-07-12",83,2,0,18,1,104
"Harrow","10:00:00","2018-07-12",273,1,0,42,3,319
"Havering","10:00:00","2018-07-12",25,0,0,5,0,30
"Hillingdon","10:00:00","2018-07-12",110,2,0,23,6,141
"Lambeth","10:00:00","2018-07-12",717,68,95,318,84,1282
"Merton","10:00:00","2018-07-12",869,32,23,296,105,1325
"Southwark","10:00:00","2018-07-12",785,77,56,420,65,1403
"Barking and Dagenham","11:00:00","2018-07-12",626,6,2,163,40,837
"Barnet","11:00:00","2018-07-12",31,1,5,6,1,44
"Bexley","11:00:00","2018-07-12",878,10,4,219,41,1152
"Bromley","11:00:00","2018-07-12",173,4,1,45,3,226
"Croydon","11:00:00","2018-07-12",244,4,4,27,3,282
"Ealing","11:00:00","2018-07-12",57,1,0,22,0,80
"Harrow","11:00:00","2018-07-12",307,1,0,35,4,347
"Havering","11:00:00","2018-07-12",26,0,0,4,0,30
"Hillingdon","11:00:00","2018-07-12",92,1,0,33,2,128
"Lambeth","11:00:00","2018-07-12",794,69,94,340,86,1383
"Merton","11:00:00","2018-07-12",896,20,23,315,99,1353
"Southwark","11:00:00","2018-07-12",853,71,55,426,52,1457
"Barking and Dagenham","12:00:00","2018-07-12",649,7,3,169,38,866
"Barnet","12:00:00","2018-07-12",35,1,4,5,0,45
"Bexley","12:00:00","2018-07-12",960,9,8,199,43,1219
"Bromley","12:00:00","2018-07-12",231,4,1,34,9,279
"Croydon","12:00:00","2018-07-12",255,3,5,40,3,306
"Ealing","12:00:00","2018-07-12",89,1,0,21,1,112
"Harrow","12:00:00","2018-07-12",349,4,0,27,5,385
"Havering","12:00:00","2018-07-12",32,1,0,11,1,45
"Hillingdon","12:00:00","2018-07-12",102,3,0,15,3,123
"Lambeth","12:00:00","2018-07-12",681,76,72,329,78,1236
"Merton","12:00:00","2018-07-12",873,18,23,317,103,1334
"Southwark","12:00:00","2018-07-12",822,84,51,385,52,1394
"Barking and Dagenham","13:00:00","2018-07-12",689,7,2,173,28,899
"Barnet","13:00:00","2018-07-12",45,0,5,3,1,54
"Bexley","13:00:00","2018-07-12",871,10,4,218,55,1158
"Bromley","13:00:00","2018-07-12",232,0,4,52,2,290
"Croydon","13:00:00","2018-07-12",211,1,4,40,1,257
"Ealing","13:00:00","2018-07-12",72,0,0,22,1,95
"Harrow","13:00:00","2018-07-12",340,1,1,49,4,395
"Havering","13:00:00","2018-07-12",31,0,0,2,0,33
"Hillingdon","13:00:00","2018-07-12",134,2,0,11,2,149
"Lambeth","13:00:00","2018-07-12",757,85,94,332,75,1343
"Merton","13:00:00","2018-07-12",879,19,23,253,104,1278
"Southwark","13:00:00","2018-07-12",904,65,45,426,51,1491
"Barking and Dagenham","14:00:00","2018-07-12",643,7,4,156,18,828
"Barnet","14:00:00","2018-07-12",43,0,5,10,1,59
"Bexley","14:00:00","2018-07-12",785,5,9,167,35,1001
"Bromley","14:00:00","2018-07-12",267,6,2,48,2,325
"Croydon","14:00:00","2018-07-12",212,1,3,33,0,249
"Ealing","14:00:00","2018-07-12",77,2,0,20,2,101
"Harrow","14:00:00","2018-07-12",397,4,0,38,5,444
"Havering","14:00:00","2018-07-12",32,0,0,2,0,34
"Hillingdon","14:00:00","2018-07-12",128,2,0,12,2,144
"Lambeth","14:00:00","2018-07-12",763,80,93,363,69,1368
"Merton","14:00:00","2018-07-12",1020,30,28,310,87,1475
"Southwark","14:00:00","2018-07-12",777,61,49,371,38,1296
"Barking and Dagenham","15:00:00","2018-07-12",673,6,2,133,22,836
"Barnet","15:00:00","2018-07-12",44,0,6,8,0,58
"Bexley","15:00:00","2018-07-12",799,10,10,178,39,1036
"Bromley","15:00:00","2018-07-12",335,4,6,47,1,393
"Croydon","15:00:00","2018-07-12",339,2,4,45,1,391
"Ealing","15:00:00","2018-07-12",99,1,0,24,0,124
"Harrow","15:00:00","2018-07-12",447,4,4,26,6,487
"Havering","15:00:00","2018-07-12",30,0,0,2,0,32
"Hillingdon","15:00:00","2018-07-12",145,3,0,26,0,174
"Lambeth","15:00:00","2018-07-12",867,117,96,331,71,1482
"Merton","15:00:00","2018-07-12",1134,40,17,310,64,1565
"Southwark","15:00:00","2018-07-12",765,61,44,307,34,1211
"Barking and Dagenham","16:00:00","2018-07-12",770,9,3,186,14,982
"Barnet","16:00:00","2018-07-12",50,0,5,4,0,59
"Bexley","16:00:00","2018-07-12",896,13,8,200,43,1160
"Bromley","16:00:00","2018-07-12",293,1,2,70,0,366
"Croydon","16:00:00","2018-07-12",419,1,5,62,0,487
"Ealing","16:00:00","2018-07-12",98,1,0,26,0,125
"Harrow","16:00:00","2018-07-12",474,3,2,40,9,528
"Havering","16:00:00","2018-07-12",39,1,0,1,1,42
"Hillingdon","16:00:00","2018-07-12",214,3,0,28,1,246
"Lambeth","16:00:00","2018-07-12",792,160,101,321,60,1434
"Merton","16:00:00","2018-07-12",1328,61,26,313,58,1786
"Southwark","16:00:00","2018-07-12",938,109,37,316,21,1421
"Barking and Dagenham","17:00:00","2018-07-12",909,30,6,175,16,1136
"Barnet","17:00:00","2018-07-12",59,0,5,7,0,71
"Bexley","17:00:00","2018-07-12",851,15,3,165,26,1060
"Bromley","17:00:00","2018-07-12",443,2,1,65,0,511
"Croydon","17:00:00","2018-07-12",525,1,4,42,0,572
"Ealing","17:00:00","2018-07-12",124,3,0,26,0,153
"Harrow","17:00:00","2018-07-12",542,1,0,70,1,614
"Havering","17:00:00","2018-07-12",57,0,0,6,0,63
"Hillingdon","17:00:00","2018-07-12",244,4,0,45,0,293
"Lambeth","17:00:00","2018-07-12",871,179,103,246,56,1455
"Merton","17:00:00","2018-07-12",1242,63,28,233,25,1591
"Southwark","17:00:00","2018-07-12",894,149,41,242,21,1347
"Barking and Dagenham","18:00:00","2018-07-12",792,16,2,94,1,905
"Barnet","18:00:00","2018-07-12",62,0,4,6,0,72
"Bexley","18:00:00","2018-07-12",880,15,7,160,13,1075
"Bromley","18:00:00","2018-07-12",474,2,1,22,0,499
"Croydon","18:00:00","2018-07-12",412,4,4,38,0,458
"Ealing","18:00:00","2018-07-12",127,7,0,19,0,153
"Harrow","18:00:00","2018-07-12",463,2,0,45,1,511
"Havering","18:00:00","2018-07-12",35,0,0,2,0,37
"Hillingdon","18:00:00","2018-07-12",144,4,0,24,0,172
"Lambeth","18:00:00","2018-07-12",990,193,106,138,43,1470
"Merton","18:00:00","2018-07-12",1151,61,23,202,19,1456
"Southwark","18:00:00","2018-07-12",1043,161,46,217,26,1493
"Barking and Dagenham","07:00:00","2018-07-13",4334,248,63,1539,920,7104
"Barnet","07:00:00","2018-07-13",2837,139,17,1177,401,4571
"Croydon","07:00:00","2018-07-13",112,2,11,32,1,158
"Enfield","07:00:00","2018-07-13",1030,47,10,445,155,1687
"Haringey","07:00:00","2018-07-13",487,11,35,205,29,767
"Havering","07:00:00","2018-07-13",3751,210,25,1334,833,6153
"Hillingdon","07:00:00","2018-07-13",1166,19,13,182,21,1401
"Lambeth","07:00:00","2018-07-13",396,11,52,137,11,607
"Tower Hamlets","07:00:00","2018-07-13",3294,380,38,1407,431,5550
"Barking and Dagenham","08:00:00","2018-07-13",4644,125,54,1384,973,7180
"Barnet","08:00:00","2018-07-13",3293,106,27,935,409,4770
"Croydon","08:00:00","2018-07-13",187,3,12,19,0,221
"Enfield","08:00:00","2018-07-13",991,36,9,397,168,1601
"Haringey","08:00:00","2018-07-13",708,15,42,161,27,953
"Havering","08:00:00","2018-07-13",3537,111,26,1221,825,5720
"Hillingdon","08:00:00","2018-07-13",1231,16,19,157,23,1446
"Lambeth","08:00:00","2018-07-13",417,13,43,123,12,608
"Tower Hamlets","08:00:00","2018-07-13",3720,291,36,1231,519,5797
"Barking and Dagenham","09:00:00","2018-07-13",4049,84,43,1359,1165,6700
"Barnet","09:00:00","2018-07-13",3049,62,33,918,468,4530
"Croydon","09:00:00","2018-07-13",101,1,12,21,1,136
"Enfield","09:00:00","2018-07-13",793,41,11,378,200,1423
"Haringey","09:00:00","2018-07-13",602,15,49,196,28,890
"Havering","09:00:00","2018-07-13",3140,68,23,1149,967,5347
"Hillingdon","09:00:00","2018-07-13",1025,21,18,188,28,1280
"Lambeth","09:00:00","2018-07-13",398,10,38,117,16,579
"Tower Hamlets","09:00:00","2018-07-13",3017,131,22,1072,563,4805
"Barking and Dagenham","10:00:00","2018-07-13",3852,57,45,1371,1141,6466
"Barnet","10:00:00","2018-07-13",3245,52,27,1017,449,4790
"Croydon","10:00:00","2018-07-13",63,0,10,30,1,104
"Enfield","10:00:00","2018-07-13",863,18,10,413,164,1468
"Haringey","10:00:00","2018-07-13",538,17,34,161,23,773
"Havering","10:00:00","2018-07-13",2821,35,15,1151,932,4954
"Hillingdon","10:00:00","2018-07-13",822,12,11,154,40,1039
"Lambeth","10:00:00","2018-07-13",383,11,42,114,15,565
"Tower Hamlets","10:00:00","2018-07-13",2671,126,36,1085,541,4459
"Barking and Dagenham","11:00:00","2018-07-13",4203,60,41,1379,1204,6887
"Barnet","11:00:00","2018-07-13",3581,52,15,992,487,5127
"Croydon","11:00:00","2018-07-13",73,4,10,15,0,102
"Enfield","11:00:00","2018-07-13",935,21,4,448,219,1627
"Haringey","11:00:00","2018-07-13",528,13,24,177,28,770
"Havering","11:00:00","2018-07-13",3043,42,14,1152,1010,5261
"Hillingdon","11:00:00","2018-07-13",954,24,9,170,24,1181
"Lambeth","11:00:00","2018-07-13",380,10,37,143,19,589
"Tower Hamlets","11:00:00","2018-07-13",2969,130,11,1155,581,4846
"Barking and Dagenham","12:00:00","2018-07-13",4597,75,30,1451,1109,7262
"Barnet","12:00:00","2018-07-13",3738,67,17,1008,464,5294
"Croydon","12:00:00","2018-07-13",96,2,9,18,3,128
"Enfield","12:00:00","2018-07-13",778,27,4,388,195,1392
"Haringey","12:00:00","2018-07-13",642,27,35,150,11,865
"Havering","12:00:00","2018-07-13",3409,66,15,1188,952,5630
"Hillingdon","12:00:00","2018-07-13",1043,19,16,193,26,1297
"Lambeth","12:00:00","2018-07-13",430,22,38,132,12,634
"Tower Hamlets","12:00:00","2018-07-13",3401,136,10,1219,533,5299
"Barking and Dagenham","13:00:00","2018-07-13",4604,77,41,1478,1089,7289
"Barnet","13:00:00","2018-07-13",3667,74,17,1004,415,5177
"Croydon","13:00:00","2018-07-13",128,8,13,15,1,165
"Enfield","13:00:00","2018-07-13",789,26,7,370,143,1335
"Haringey","13:00:00","2018-07-13",606,16,31,163,21,837
"Havering","13:00:00","2018-07-13",3571,56,17,1276,941,5861
"Hillingdon","13:00:00","2018-07-13",967,24,15,166,34,1206
"Lambeth","13:00:00","2018-07-13",445,22,44,166,12,689
"Tower Hamlets","13:00:00","2018-07-13",3235,123,12,1194,558,5122
"Barking and Dagenham","14:00:00","2018-07-13",5168,93,45,1459,1036,7801
"Barnet","14:00:00","2018-07-13",3666,74,28,982,377,5127
"Croydon","14:00:00","2018-07-13",114,1,9,18,0,142
"Enfield","14:00:00","2018-07-13",730,24,11,318,137,1220
"Haringey","14:00:00","2018-07-13",645,25,36,179,15,900
"Havering","14:00:00","2018-07-13",4019,62,16,1280,874,6251
"Hillingdon","14:00:00","2018-07-13",923,17,16,137,32,1125
"Lambeth","14:00:00","2018-07-13",493,26,41,122,11,693
"Tower Hamlets","14:00:00","2018-07-13",3665,150,23,1324,435,5597
"Barking and Dagenham","15:00:00","2018-07-13",5535,120,37,1562,866,8120
"Barnet","15:00:00","2018-07-13",3691,69,22,926,314,5022
"Croydon","15:00:00","2018-07-13",142,0,11,21,1,175
"Enfield","15:00:00","2018-07-13",684,32,4,296,128,1144
"Haringey","15:00:00","2018-07-13",766,28,39,173,15,1021
"Havering","15:00:00","2018-07-13",4176,98,13,1318,802,6407
"Hillingdon","15:00:00","2018-07-13",1081,20,20,193,19,1333
"Lambeth","15:00:00","2018-07-13",403,10,36,118,11,578
"Tower Hamlets","15:00:00","2018-07-13",4024,214,9,1238,371,5856
"Barking and Dagenham","16:00:00","2018-07-13",6199,205,58,1534,646,8642
"Barnet","16:00:00","2018-07-13",3805,124,20,911,236,5096
"Croydon","16:00:00","2018-07-13",100,5,11,21,0,137
"Enfield","16:00:00","2018-07-13",816,37,2,233,85,1173
"Haringey","16:00:00","2018-07-13",644,33,34,145,9,865
"Havering","16:00:00","2018-07-13",5028,165,26,1395,534,7148
"Hillingdon","16:00:00","2018-07-13",1303,21,16,178,13,1531
"Lambeth","16:00:00","2018-07-13",496,22,34,131,5,688
"Tower Hamlets","16:00:00","2018-07-13",4204,276,15,1134,239,5868
"Barking and Dagenham","17:00:00","2018-07-13",6813,235,44,1339,406,8837
"Barnet","17:00:00","2018-07-13",3911,135,25,820,166,5057
"Croydon","17:00:00","2018-07-13",148,3,11,18,2,182
"Enfield","17:00:00","2018-07-13",846,21,6,344,106,1323
"Haringey","17:00:00","2018-07-13",754,29,32,139,6,960
"Havering","17:00:00","2018-07-13",5814,176,23,1143,390,7546
"Hillingdon","17:00:00","2018-07-13",1389,26,10,178,21,1624
"Lambeth","17:00:00","2018-07-13",519,37,42,121,4,723
"Tower Hamlets","17:00:00","2018-07-13",4620,356,26,898,187,6087
"Barking and Dagenham","18:00:00","2018-07-13",7132,215,50,1107,388,8892
"Barnet","18:00:00","2018-07-13",3991,123,23,634,146,4917
"Croydon","18:00:00","2018-07-13",126,7,11,24,0,168
"Enfield","18:00:00","2018-07-13",822,25,4,233,36,1120
"Haringey","18:00:00","2018-07-13",774,49,27,118,1,969
"Havering","18:00:00","2018-07-13",5651,155,23,865,348,7042
"Hillingdon","18:00:00","2018-07-13",1162,43,10,97,8,1320
"Lambeth","18:00:00","2018-07-13",478,36,38,82,3,637
"Tower Hamlets","18:00:00","2018-07-13",4775,305,32,714,134,5960
"Barking and Dagenham","07:00:00","2018-09-05",43,0,1,6,0,50
"Hackney","07:00:00","2018-09-05",1818,164,56,837,100,2975
"Kensington and Chelsea","07:00:00","2018-09-05",460,28,7,182,7,684
"Lambeth","07:00:00","2018-09-05",571,195,72,331,42,1211
"Lewisham","07:00:00","2018-09-05",708,89,115,244,52,1208
"Merton","07:00:00","2018-09-05",1344,136,25,470,75,2050
"Wandsworth","07:00:00","2018-09-05",563,106,19,137,15,840
"Barking and Dagenham","08:00:00","2018-09-05",57,0,0,15,0,72
"Hackney","08:00:00","2018-09-05",1698,122,59,714,96,2689
"Kensington and Chelsea","08:00:00","2018-09-05",674,43,1,185,12,915
"Lambeth","08:00:00","2018-09-05",609,216,59,265,48,1197
"Lewisham","08:00:00","2018-09-05",786,79,116,209,98,1288
"Merton","08:00:00","2018-09-05",1557,94,22,323,75,2071
"Wandsworth","08:00:00","2018-09-05",757,154,29,172,11,1123
"Barking and Dagenham","09:00:00","2018-09-05",46,0,0,6,0,52
"Hackney","09:00:00","2018-09-05",1447,91,51,608,136,2333
"Kensington and Chelsea","09:00:00","2018-09-05",542,25,0,151,29,747
"Lambeth","09:00:00","2018-09-05",695,122,72,274,45,1208
"Lewisham","09:00:00","2018-09-05",799,32,132,183,82,1228
"Merton","09:00:00","2018-09-05",1099,38,28,296,63,1524
"Wandsworth","09:00:00","2018-09-05",609,86,33,281,17,1026
"Barking and Dagenham","10:00:00","2018-09-05",45,0,1,3,1,50
"Hackney","10:00:00","2018-09-05",1483,51,58,660,133,2385
"Kensington and Chelsea","10:00:00","2018-09-05",457,20,1,145,26,649
"Lambeth","10:00:00","2018-09-05",657,56,69,304,55,1141
"Lewisham","10:00:00","2018-09-05",897,25,139,242,90,1393
"Merton","10:00:00","2018-09-05",1277,43,30,346,80,1776
"Wandsworth","10:00:00","2018-09-05",460,37,23,206,16,742
"Barking and Dagenham","11:00:00","2018-09-05",46,0,0,4,0,50
"Hackney","11:00:00","2018-09-05",1365,52,47,533,141,2138
"Kensington and Chelsea","11:00:00","2018-09-05",459,29,1,153,15,657
"Lambeth","11:00:00","2018-09-05",726,53,72,338,51,1240
"Lewisham","11:00:00","2018-09-05",885,33,132,300,88,1438
"Merton","11:00:00","2018-09-05",1050,41,23,326,76,1516
"Wandsworth","11:00:00","2018-09-05",474,29,20,231,28,782
"Barking and Dagenham","12:00:00","2018-09-05",33,0,0,7,0,40
"Hackney","12:00:00","2018-09-05",1250,33,48,511,103,1945
"Kensington and Chelsea","12:00:00","2018-09-05",431,28,1,122,25,607
"Lambeth","12:00:00","2018-09-05",662,70,62,317,44,1155
"Lewisham","12:00:00","2018-09-05",743,40,134,251,52,1220
"Merton","12:00:00","2018-09-05",1197,49,21,266,44,1577
"Wandsworth","12:00:00","2018-09-05",473,26,23,229,33,784
"Barking and Dagenham","13:00:00","2018-09-05",28,0,0,9,0,37
"Hackney","13:00:00","2018-09-05",1482,38,49,469,116,2154
"Kensington and Chelsea","13:00:00","2018-09-05",428,14,3,122,18,585
"Lambeth","13:00:00","2018-09-05",654,78,64,322,54,1172
"Lewisham","13:00:00","2018-09-05",762,28,117,203,48,1158
"Merton","13:00:00","2018-09-05",1320,52,24,323,52,1771
"Wandsworth","13:00:00","2018-09-05",393,25,26,184,35,663
"Barking and Dagenham","14:00:00","2018-09-05",30,0,0,3,2,35
"Hackney","14:00:00","2018-09-05",1418,38,46,541,87,2130
"Kensington and Chelsea","14:00:00","2018-09-05",451,14,2,143,10,620
"Lambeth","14:00:00","2018-09-05",708,72,63,330,54,1227
"Lewisham","14:00:00","2018-09-05",963,29,143,250,63,1448
"Merton","14:00:00","2018-09-05",1163,40,21,299,47,1570
"Wandsworth","14:00:00","2018-09-05",408,28,18,174,17,645
"Barking and Dagenham","15:00:00","2018-09-05",42,1,0,5,0,48
"Hackney","15:00:00","2018-09-05",1529,58,50,508,67,2212
"Kensington and Chelsea","15:00:00","2018-09-05",422,15,0,122,7,566
"Lambeth","15:00:00","2018-09-05",763,72,66,317,27,1245
"Lewisham","15:00:00","2018-09-05",1071,35,132,245,50,1533
"Merton","15:00:00","2018-09-05",1133,48,24,255,45,1505
"Wandsworth","15:00:00","2018-09-05",462,26,22,141,13,664
"Barking and Dagenham","16:00:00","2018-09-05",47,1,1,7,0,56
"Hackney","16:00:00","2018-09-05",1755,75,62,484,51,2427
"Kensington and Chelsea","16:00:00","2018-09-05",469,35,0,123,10,637
"Lambeth","16:00:00","2018-09-05",851,108,63,297,27,1346
"Lewisham","16:00:00","2018-09-05",1161,27,120,288,45,1641
"Merton","16:00:00","2018-09-05",1684,73,23,341,39,2160
"Wandsworth","16:00:00","2018-09-05",506,32,33,162,17,750
"Barking and Dagenham","17:00:00","2018-09-05",50,1,0,3,0,54
"Hackney","17:00:00","2018-09-05",1679,99,55,405,51,2289
"Kensington and Chelsea","17:00:00","2018-09-05",592,49,3,100,3,747
"Lambeth","17:00:00","2018-09-05",947,241,56,276,14,1534
"Lewisham","17:00:00","2018-09-05",1103,71,115,210,41,1540
"Merton","17:00:00","2018-09-05",2428,120,26,425,29,3028
"Wandsworth","17:00:00","2018-09-05",565,54,19,142,4,784
"Barking and Dagenham","18:00:00","2018-09-05",53,0,0,4,0,57
"Hackney","18:00:00","2018-09-05",1756,105,48,322,27,2258
"Kensington and Chelsea","18:00:00","2018-09-05",613,40,1,121,2,777
"Lambeth","18:00:00","2018-09-05",795,214,56,171,13,1249
"Lewisham","18:00:00","2018-09-05",1069,31,111,256,23,1490
"Merton","18:00:00","2018-09-05",2451,114,18,332,12,2927
"Wandsworth","18:00:00","2018-09-05",608,55,23,107,6,799
"Barnet","07:00:00","2018-09-06",725,13,19,171,8,936
"Hackney","07:00:00","2018-09-06",402,35,10,120,2,569
"Harrow","07:00:00","2018-09-06",1658,18,49,316,16,2057
"Hillingdon","07:00:00","2018-09-06",922,17,26,197,23,1185
"Kingston upon Thames","07:00:00","2018-09-06",116,0,0,21,0,137
"Sutton","07:00:00","2018-09-06",374,4,11,78,5,472
"Wandsworth","07:00:00","2018-09-06",1470,160,10,655,48,2343
"Barnet","08:00:00","2018-09-06",755,14,21,158,10,958
"Hackney","08:00:00","2018-09-06",594,27,15,147,9,792
"Harrow","08:00:00","2018-09-06",1938,16,45,212,23,2234
"Hillingdon","08:00:00","2018-09-06",1175,9,20,203,24,1431
"Kingston upon Thames","08:00:00","2018-09-06",206,3,0,14,1,224
"Sutton","08:00:00","2018-09-06",506,11,10,55,7,589
"Wandsworth","08:00:00","2018-09-06",1583,167,12,586,59,2407
"Barnet","09:00:00","2018-09-06",537,7,15,125,4,688
"Hackney","09:00:00","2018-09-06",534,36,16,199,11,796
"Harrow","09:00:00","2018-09-06",1571,12,45,253,39,1920
"Hillingdon","09:00:00","2018-09-06",740,3,24,140,27,934
"Kingston upon Thames","09:00:00","2018-09-06",103,0,1,16,2,122
"Sutton","09:00:00","2018-09-06",270,4,11,56,7,348
"Wandsworth","09:00:00","2018-09-06",1456,95,14,513,92,2170
"Barnet","10:00:00","2018-09-06",528,6,14,111,5,664
"Hackney","10:00:00","2018-09-06",489,34,9,182,11,725
"Harrow","10:00:00","2018-09-06",1423,9,46,267,33,1778
"Hillingdon","10:00:00","2018-09-06",608,6,16,159,30,819
"Kingston upon Thames","10:00:00","2018-09-06",84,3,0,16,0,103
"Sutton","10:00:00","2018-09-06",167,2,7,45,7,228
"Wandsworth","10:00:00","2018-09-06",1427,93,9,519,95,2143
"Barnet","11:00:00","2018-09-06",491,5,15,101,7,619
"Hackney","11:00:00","2018-09-06",457,31,14,162,9,673
"Harrow","11:00:00","2018-09-06",1445,16,47,223,34,1765
"Hillingdon","11:00:00","2018-09-06",621,4,14,140,27,806
"Kingston upon Thames","11:00:00","2018-09-06",96,1,0,26,0,123
"Sutton","11:00:00","2018-09-06",174,3,8,44,8,237
"Wandsworth","11:00:00","2018-09-06",1337,63,6,518,67,1991
"Barnet","12:00:00","2018-09-06",525,6,13,99,5,648
"Hackney","12:00:00","2018-09-06",430,32,13,163,6,644
"Harrow","12:00:00","2018-09-06",1557,19,37,225,29,1867
"Hillingdon","12:00:00","2018-09-06",630,11,12,170,35,858
"Kingston upon Thames","12:00:00","2018-09-06",105,1,0,22,1,129
"Sutton","12:00:00","2018-09-06",221,2,12,45,12,292
"Wandsworth","12:00:00","2018-09-06",1342,74,10,479,107,2012
"Barnet","13:00:00","2018-09-06",529,5,11,93,7,645
"Hackney","13:00:00","2018-09-06",410,26,11,142,0,589
"Harrow","13:00:00","2018-09-06",1561,14,40,214,24,1853
"Hillingdon","13:00:00","2018-09-06",627,7,14,117,23,788
"Kingston upon Thames","13:00:00","2018-09-06",87,3,0,18,1,109
"Sutton","13:00:00","2018-09-06",184,3,9,29,15,240
"Wandsworth","13:00:00","2018-09-06",1408,98,4,508,79,2097
"Barnet","14:00:00","2018-09-06",548,7,14,96,8,673
"Hackney","14:00:00","2018-09-06",478,33,10,162,0,683
"Harrow","14:00:00","2018-09-06",1624,18,49,254,24,1969
"Hillingdon","14:00:00","2018-09-06",815,16,19,168,32,1050
"Kingston upon Thames","14:00:00","2018-09-06",94,1,0,18,2,115
"Sutton","14:00:00","2018-09-06",267,1,9,33,4,314
"Wandsworth","14:00:00","2018-09-06",1478,102,5,474,63,2122
"Barnet","15:00:00","2018-09-06",732,7,12,119,6,876
"Hackney","15:00:00","2018-09-06",582,35,13,146,7,783
"Harrow","15:00:00","2018-09-06",2027,21,47,275,23,2393
"Hillingdon","15:00:00","2018-09-06",843,4,17,163,23,1050
"Kingston upon Thames","15:00:00","2018-09-06",168,1,0,23,2,194
"Sutton","15:00:00","2018-09-06",289,2,10,56,5,362
"Wandsworth","15:00:00","2018-09-06",1626,102,11,433,50,2222
"Barnet","16:00:00","2018-09-06",750,21,16,111,2,900
"Hackney","16:00:00","2018-09-06",663,47,13,146,1,870
"Harrow","16:00:00","2018-09-06",2061,18,49,290,18,2436
"Hillingdon","16:00:00","2018-09-06",908,15,25,152,10,1110
"Kingston upon Thames","16:00:00","2018-09-06",122,1,1,22,2,148
"Sutton","16:00:00","2018-09-06",321,0,10,55,7,393
"Wandsworth","16:00:00","2018-09-06",1679,136,15,468,16,2314
"Barnet","17:00:00","2018-09-06",835,12,22,127,6,1002
"Hackney","17:00:00","2018-09-06",669,32,10,119,0,830
"Harrow","17:00:00","2018-09-06",2036,14,36,231,10,2327
"Hillingdon","17:00:00","2018-09-06",1003,12,14,138,13,1180
"Kingston upon Thames","17:00:00","2018-09-06",157,3,0,13,0,173
"Sutton","17:00:00","2018-09-06",323,4,6,45,1,379
"Wandsworth","17:00:00","2018-09-06",1783,209,5,418,17,2432
"Barnet","18:00:00","2018-09-06",861,20,13,106,1,1001
"Hackney","18:00:00","2018-09-06",566,24,10,110,0,710
"Harrow","18:00:00","2018-09-06",1988,24,43,126,2,2183
"Hillingdon","18:00:00","2018-09-06",837,16,17,129,8,1007
"Kingston upon Thames","18:00:00","2018-09-06",183,1,0,14,0,198
"Sutton","18:00:00","2018-09-06",343,5,9,48,0,405
"Wandsworth","18:00:00","2018-09-06",2035,197,6,333,16,2587
"Barnet","07:00:00","2018-09-07",634,2,8,74,4,722
"Bexley","07:00:00","2018-09-07",237,4,40,37,7,325
"Croydon","07:00:00","2018-09-07",1052,17,6,300,40,1415
"Hackney","07:00:00","2018-09-07",408,42,98,173,40,761
"Hounslow","07:00:00","2018-09-07",136,7,12,23,0,178
"Islington","07:00:00","2018-09-07",413,122,34,266,73,908
"Kensington and Chelsea","07:00:00","2018-09-07",133,6,15,42,4,200
"Lambeth","07:00:00","2018-09-07",28,3,0,15,4,50
"Merton","07:00:00","2018-09-07",899,48,34,281,47,1309
"Tower Hamlets","07:00:00","2018-09-07",509,191,164,377,134,1375
"Barnet","08:00:00","2018-09-07",842,4,17,67,6,936
"Bexley","08:00:00","2018-09-07",470,5,52,34,4,565
"Croydon","08:00:00","2018-09-07",969,12,4,180,41,1206
"Hackney","08:00:00","2018-09-07",338,36,77,157,49,657
"Hounslow","08:00:00","2018-09-07",219,6,11,19,0,255
"Islington","08:00:00","2018-09-07",444,124,31,215,44,858
"Kensington and Chelsea","08:00:00","2018-09-07",197,11,16,48,2,274
"Lambeth","08:00:00","2018-09-07",22,6,2,10,4,44
"Merton","08:00:00","2018-09-07",894,31,38,173,26,1162
"Tower Hamlets","08:00:00","2018-09-07",550,239,166,347,122,1424
"Barnet","09:00:00","2018-09-07",549,3,11,73,12,648
"Bexley","09:00:00","2018-09-07",358,2,55,44,2,461
"Croydon","09:00:00","2018-09-07",719,4,0,201,35,959
"Hackney","09:00:00","2018-09-07",305,28,73,154,50,610
"Hounslow","09:00:00","2018-09-07",144,6,8,23,0,181
"Islington","09:00:00","2018-09-07",404,68,28,219,50,769
"Kensington and Chelsea","09:00:00","2018-09-07",232,17,13,60,3,325
"Lambeth","09:00:00","2018-09-07",37,6,0,18,3,64
"Merton","09:00:00","2018-09-07",703,23,38,191,48,1003
"Tower Hamlets","09:00:00","2018-09-07",605,168,132,324,148,1377
"Barnet","10:00:00","2018-09-07",412,3,8,53,5,481
"Bexley","10:00:00","2018-09-07",338,3,43,39,5,428
"Croydon","10:00:00","2018-09-07",730,9,6,234,48,1027
"Hackney","10:00:00","2018-09-07",339,21,83,170,49,662
"Hounslow","10:00:00","2018-09-07",130,3,11,15,2,161
"Islington","10:00:00","2018-09-07",417,48,30,227,52,774
"Kensington and Chelsea","10:00:00","2018-09-07",234,16,17,60,1,328
"Lambeth","10:00:00","2018-09-07",43,1,0,23,8,75
"Merton","10:00:00","2018-09-07",595,24,29,181,37,866
"Tower Hamlets","10:00:00","2018-09-07",670,109,158,338,122,1397
"Barnet","11:00:00","2018-09-07",414,2,14,49,4,483
"Bexley","11:00:00","2018-09-07",376,4,46,36,8,470
"Croydon","11:00:00","2018-09-07",819,7,1,235,44,1106
"Hackney","11:00:00","2018-09-07",296,27,80,153,39,595
"Hounslow","11:00:00","2018-09-07",160,2,10,20,0,192
"Islington","11:00:00","2018-09-07",431,50,31,153,43,708
"Kensington and Chelsea","11:00:00","2018-09-07",231,25,15,50,3,324
"Lambeth","11:00:00","2018-09-07",40,3,0,19,5,67
"Merton","11:00:00","2018-09-07",600,19,33,140,42,834
"Tower Hamlets","11:00:00","2018-09-07",605,112,147,346,130,1340
"Barnet","12:00:00","2018-09-07",411,2,6,52,3,474
"Bexley","12:00:00","2018-09-07",370,4,46,39,3,462
"Croydon","12:00:00","2018-09-07",767,5,2,206,30,1010
"Hackney","12:00:00","2018-09-07",292,23,71,128,68,582
"Hounslow","12:00:00","2018-09-07",166,4,11,23,4,208
"Islington","12:00:00","2018-09-07",368,28,28,165,29,618
"Kensington and Chelsea","12:00:00","2018-09-07",223,48,14,49,1,335
"Lambeth","12:00:00","2018-09-07",37,2,2,19,8,68
"Merton","12:00:00","2018-09-07",651,23,29,174,44,921
"Tower Hamlets","12:00:00","2018-09-07",610,109,150,274,95,1238
"Barnet","13:00:00","2018-09-07",382,4,9,45,7,447
"Bexley","13:00:00","2018-09-07",426,3,54,45,7,535
"Croydon","13:00:00","2018-09-07",841,10,2,232,26,1111
"Hackney","13:00:00","2018-09-07",361,42,81,133,39,656
"Hounslow","13:00:00","2018-09-07",172,3,9,13,2,199
"Islington","13:00:00","2018-09-07",407,36,32,108,15,598
"Kensington and Chelsea","13:00:00","2018-09-07",229,42,14,42,2,329
"Lambeth","13:00:00","2018-09-07",40,1,0,17,3,61
"Merton","13:00:00","2018-09-07",683,26,28,170,26,933
"Tower Hamlets","13:00:00","2018-09-07",576,91,149,268,80,1164
"Barnet","14:00:00","2018-09-07",443,5,10,46,4,508
"Bexley","14:00:00","2018-09-07",397,7,43,35,3,485
"Croydon","14:00:00","2018-09-07",946,11,4,248,25,1234
"Hackney","14:00:00","2018-09-07",315,25,77,142,29,588
"Hounslow","14:00:00","2018-09-07",186,8,10,16,0,220
"Islington","14:00:00","2018-09-07",420,45,40,94,23,622
"Kensington and Chelsea","14:00:00","2018-09-07",233,59,10,47,1,350
"Lambeth","14:00:00","2018-09-07",27,1,0,11,5,44
"Merton","14:00:00","2018-09-07",763,25,37,132,26,983
"Tower Hamlets","14:00:00","2018-09-07",608,120,159,298,88,1273
"Barnet","15:00:00","2018-09-07",671,17,9,61,11,769
"Bexley","15:00:00","2018-09-07",428,6,43,37,2,516
"Croydon","15:00:00","2018-09-07",1108,12,2,242,19,1383
"Hackney","15:00:00","2018-09-07",357,35,68,138,38,636
"Hounslow","15:00:00","2018-09-07",220,3,11,27,0,261
"Islington","15:00:00","2018-09-07",410,39,34,107,25,615
"Kensington and Chelsea","15:00:00","2018-09-07",314,70,14,60,4,462
"Lambeth","15:00:00","2018-09-07",47,1,0,14,3,65
"Merton","15:00:00","2018-09-07",855,37,38,167,29,1126
"Tower Hamlets","15:00:00","2018-09-07",678,159,139,307,56,1339
"Barnet","16:00:00","2018-09-07",482,5,11,59,5,562
"Bexley","16:00:00","2018-09-07",491,1,45,42,1,580
"Croydon","16:00:00","2018-09-07",1361,17,7,197,14,1596
"Hackney","16:00:00","2018-09-07",391,49,84,122,17,663
"Hounslow","16:00:00","2018-09-07",229,9,14,28,0,280
"Islington","16:00:00","2018-09-07",528,50,36,104,4,722
"Kensington and Chelsea","16:00:00","2018-09-07",224,36,15,36,2,313
"Lambeth","16:00:00","2018-09-07",44,12,2,13,4,75
"Merton","16:00:00","2018-09-07",858,43,30,172,14,1117
"Tower Hamlets","16:00:00","2018-09-07",775,175,148,275,52,1425
"Barnet","17:00:00","2018-09-07",551,8,12,47,2,620
"Bexley","17:00:00","2018-09-07",655,9,30,58,2,754
"Croydon","17:00:00","2018-09-07",1244,19,1,182,13,1459
"Hackney","17:00:00","2018-09-07",447,59,71,105,12,694
"Hounslow","17:00:00","2018-09-07",248,10,12,28,0,298
"Islington","17:00:00","2018-09-07",535,49,34,68,8,694
"Kensington and Chelsea","17:00:00","2018-09-07",272,40,15,45,0,372
"Lambeth","17:00:00","2018-09-07",49,6,0,10,0,65
"Merton","17:00:00","2018-09-07",914,61,32,157,16,1180
"Tower Hamlets","17:00:00","2018-09-07",830,298,155,267,49,1599
"Barnet","18:00:00","2018-09-07",519,7,15,25,0,566
"Bexley","18:00:00","2018-09-07",473,7,37,39,1,557
"Croydon","18:00:00","2018-09-07",1159,11,1,168,6,1345
"Hackney","18:00:00","2018-09-07",578,50,87,111,7,833
"Hounslow","18:00:00","2018-09-07",234,5,12,16,0,267
"Islington","18:00:00","2018-09-07",638,49,35,53,2,777
"Kensington and Chelsea","18:00:00","2018-09-07",245,32,13,46,0,336
"Lambeth","18:00:00","2018-09-07",45,8,0,4,0,57
"Merton","18:00:00","2018-09-07",888,33,32,132,7,1092
"Tower Hamlets","18:00:00","2018-09-07",780,203,122,258,27,1390
"Brent","07:00:00","2018-09-10",78,2,0,10,2,92
"Ealing","07:00:00","2018-09-10",624,51,126,208,45,1054
"Hackney","07:00:00","2018-09-10",981,199,212,516,92,2000
"Hillingdon","07:00:00","2018-09-10",1514,22,72,164,77,1849
"Islington","07:00:00","2018-09-10",22,7,0,16,0,45
"Kingston upon Thames","07:00:00","2018-09-10",128,6,1,24,0,159
"Westminster","07:00:00","2018-09-10",11,0,0,0,2,13
"Barnet","08:00:00","2018-09-10",6195,224,136,1574,612,8741
"Brent","08:00:00","2018-09-10",140,1,1,11,0,153
"Ealing","08:00:00","2018-09-10",758,49,116,174,32,1129
"Hackney","08:00:00","2018-09-10",1036,278,218,421,101,2054
"Hillingdon","08:00:00","2018-09-10",1767,23,68,194,59,2111
"Islington","08:00:00","2018-09-10",27,14,0,32,9,82
"Kingston upon Thames","08:00:00","2018-09-10",373,7,1,30,0,411
"Westminster","08:00:00","2018-09-10",22,1,2,3,0,28
"Barnet","09:00:00","2018-09-10",5260,135,129,1692,786,8002
"Brent","09:00:00","2018-09-10",62,2,0,23,0,87
"Ealing","09:00:00","2018-09-10",616,34,132,205,40,1027
"Hackney","09:00:00","2018-09-10",1000,201,229,447,71,1948
"Hillingdon","09:00:00","2018-09-10",1257,11,63,152,75,1558
"Islington","09:00:00","2018-09-10",60,16,0,43,5,124
"Kingston upon Thames","09:00:00","2018-09-10",152,4,5,26,5,192
"Westminster","09:00:00","2018-09-10",31,3,1,3,1,39
"Barnet","10:00:00","2018-09-10",5158,108,122,1733,766,7887
"Brent","10:00:00","2018-09-10",68,1,1,7,1,78
"Ealing","10:00:00","2018-09-10",586,25,116,165,48,940
"Hackney","10:00:00","2018-09-10",929,91,226,467,94,1807
"Hillingdon","10:00:00","2018-09-10",1042,19,69,171,72,1373
"Islington","10:00:00","2018-09-10",55,8,0,57,4,124
"Kingston upon Thames","10:00:00","2018-09-10",154,1,0,27,9,191
"Westminster","10:00:00","2018-09-10",20,0,0,4,1,25
"Barnet","11:00:00","2018-09-10",5154,134,109,1768,781,7946
"Brent","11:00:00","2018-09-10",66,1,0,12,0,79
"Ealing","11:00:00","2018-09-10",557,44,108,166,43,918
"Hackney","11:00:00","2018-09-10",965,120,211,540,88,1924
"Hillingdon","11:00:00","2018-09-10",908,24,65,171,78,1246
"Islington","11:00:00","2018-09-10",46,9,0,52,4,111
"Kingston upon Thames","11:00:00","2018-09-10",157,3,0,41,7,208
"Westminster","11:00:00","2018-09-10",22,0,0,4,1,27
"Barnet","12:00:00","2018-09-10",5345,122,109,1760,802,8138
"Brent","12:00:00","2018-09-10",56,1,1,5,1,64
"Ealing","12:00:00","2018-09-10",582,39,119,165,39,944
"Hackney","12:00:00","2018-09-10",1006,159,208,462,48,1883
"Hillingdon","12:00:00","2018-09-10",1017,16,61,154,62,1310
"Islington","12:00:00","2018-09-10",52,14,0,37,0,103
"Kingston upon Thames","12:00:00","2018-09-10",161,4,0,33,3,201
"Westminster","12:00:00","2018-09-10",24,4,0,9,0,37
"Barnet","13:00:00","2018-09-10",5308,111,110,1725,724,7978
"Brent","13:00:00","2018-09-10",78,3,0,7,0,88
"Ealing","13:00:00","2018-09-10",620,45,111,153,37,966
"Hackney","13:00:00","2018-09-10",1087,134,194,482,66,1963
"Hillingdon","13:00:00","2018-09-10",961,19,61,144,57,1242
"Islington","13:00:00","2018-09-10",33,11,0,23,2,69
"Kingston upon Thames","13:00:00","2018-09-10",160,2,2,18,9,191
"Westminster","13:00:00","2018-09-10",18,2,0,8,1,29
"Barnet","14:00:00","2018-09-10",5727,118,129,1851,675,8500
"Brent","14:00:00","2018-09-10",101,2,0,7,0,110
"Ealing","14:00:00","2018-09-10",625,48,109,160,35,977
"Hackney","14:00:00","2018-09-10",1128,198,215,408,63,2012
"Hillingdon","14:00:00","2018-09-10",1040,13,61,149,72,1335
"Islington","14:00:00","2018-09-10",40,10,0,30,5,85
"Kingston upon Thames","14:00:00","2018-09-10",180,5,1,37,1,224
"Westminster","14:00:00","2018-09-10",29,1,0,5,0,35
"Barnet","15:00:00","2018-09-10",6054,157,128,1807,563,8709
"Brent","15:00:00","2018-09-10",82,0,1,14,0,97
"Ealing","15:00:00","2018-09-10",651,44,109,148,23,975
"Hackney","15:00:00","2018-09-10",1087,141,238,397,36,1899
"Hillingdon","15:00:00","2018-09-10",1060,15,64,201,66,1406
"Islington","15:00:00","2018-09-10",34,8,0,27,1,70
"Kingston upon Thames","15:00:00","2018-09-10",294,3,2,31,0,330
"Westminster","15:00:00","2018-09-10",30,0,0,3,0,33
"Brent","16:00:00","2018-09-10",77,4,0,16,0,97
"Ealing","16:00:00","2018-09-10",664,75,115,121,20,995
"Hackney","16:00:00","2018-09-10",1168,174,226,378,23,1969
"Hillingdon","16:00:00","2018-09-10",1217,14,71,204,62,1568
"Islington","16:00:00","2018-09-10",37,12,0,17,0,66
"Kingston upon Thames","16:00:00","2018-09-10",240,8,3,42,1,294
"Westminster","16:00:00","2018-09-10",31,2,0,5,0,38
"Brent","17:00:00","2018-09-10",101,2,0,13,0,116
"Ealing","17:00:00","2018-09-10",793,92,116,118,13,1132
"Hackney","17:00:00","2018-09-10",1370,297,213,319,16,2215
"Hillingdon","17:00:00","2018-09-10",1249,19,86,198,62,1614
"Islington","17:00:00","2018-09-10",33,21,0,20,2,76
"Kingston upon Thames","17:00:00","2018-09-10",290,6,0,30,2,328
"Westminster","17:00:00","2018-09-10",33,0,0,2,0,35
"Barnet","18:00:00","2018-09-10",7275,251,129,1040,198,8893
"Brent","18:00:00","2018-09-10",82,3,0,7,0,92
"Ealing","18:00:00","2018-09-10",810,105,127,85,9,1136
"Hackney","18:00:00","2018-09-10",1822,340,217,261,18,2658
"Hillingdon","18:00:00","2018-09-10",1284,30,77,133,57,1581
"Islington","18:00:00","2018-09-10",21,24,0,6,0,51
"Kingston upon Thames","18:00:00","2018-09-10",242,2,0,12,0,256
"Westminster","18:00:00","2018-09-10",21,2,0,5,0,28
"Brent","07:00:00","2018-09-11",2518,89,83,651,121,3462
"Croydon","07:00:00","2018-09-11",260,0,0,12,0,272
"Harrow","07:00:00","2018-09-11",118,1,4,26,0,149
"Hillingdon","07:00:00","2018-09-11",1277,13,32,418,45,1785
"Newham","07:00:00","2018-09-11",837,22,54,122,41,1076
"Southwark","07:00:00","2018-09-11",379,10,4,83,3,479
"Brent","08:00:00","2018-09-11",3174,79,78,461,91,3883
"Croydon","08:00:00","2018-09-11",296,4,0,14,0,314
"Harrow","08:00:00","2018-09-11",175,3,0,20,8,206
"Hillingdon","08:00:00","2018-09-11",2038,13,38,156,29,2274
"Newham","08:00:00","2018-09-11",947,18,61,154,28,1208
"Southwark","08:00:00","2018-09-11",470,9,7,47,0,533
"Brent","09:00:00","2018-09-11",2646,53,110,493,102,3404
"Croydon","09:00:00","2018-09-11",99,0,0,9,0,108
"Harrow","09:00:00","2018-09-11",119,0,0,32,4,155
"Hillingdon","09:00:00","2018-09-11",1106,10,40,200,33,1389
"Newham","09:00:00","2018-09-11",887,22,57,148,33,1147
"Southwark","09:00:00","2018-09-11",303,12,2,49,6,372
"Brent","10:00:00","2018-09-11",2263,33,86,519,112,3013
"Croydon","10:00:00","2018-09-11",80,0,0,9,0,89
"Harrow","10:00:00","2018-09-11",119,1,0,26,5,151
"Hillingdon","10:00:00","2018-09-11",866,11,39,165,25,1106
"Newham","10:00:00","2018-09-11",637,14,56,118,44,869
"Southwark","10:00:00","2018-09-11",252,1,0,44,9,306
"Brent","11:00:00","2018-09-11",2403,44,67,440,118,3072
"Croydon","11:00:00","2018-09-11",62,0,0,11,0,73
"Harrow","11:00:00","2018-09-11",88,0,1,25,1,115
"Hillingdon","11:00:00","2018-09-11",929,12,29,157,32,1159
"Newham","11:00:00","2018-09-11",673,16,70,141,35,935
"Southwark","11:00:00","2018-09-11",211,5,0,40,7,263
"Brent","12:00:00","2018-09-11",2407,48,86,413,101,3055
"Croydon","12:00:00","2018-09-11",60,0,0,8,0,68
"Harrow","12:00:00","2018-09-11",88,1,0,30,4,123
"Hillingdon","12:00:00","2018-09-11",983,13,26,152,24,1198
"Newham","12:00:00","2018-09-11",692,22,53,137,31,935
"Southwark","12:00:00","2018-09-11",237,4,0,49,4,294
"Brent","13:00:00","2018-09-11",2443,49,65,458,110,3125
"Croydon","13:00:00","2018-09-11",51,2,0,11,0,64
"Harrow","13:00:00","2018-09-11",95,1,0,23,6,125
"Hillingdon","13:00:00","2018-09-11",1094,7,33,158,17,1309
"Newham","13:00:00","2018-09-11",739,17,56,143,19,974
"Southwark","13:00:00","2018-09-11",191,11,2,30,5,239
"Brent","14:00:00","2018-09-11",2627,54,107,453,112,3353
"Croydon","14:00:00","2018-09-11",61,0,0,10,2,73
"Harrow","14:00:00","2018-09-11",147,0,0,31,7,185
"Hillingdon","14:00:00","2018-09-11",1086,15,37,184,21,1343
"Newham","14:00:00","2018-09-11",840,22,70,135,32,1099
"Southwark","14:00:00","2018-09-11",301,9,1,43,0,354
"Brent","15:00:00","2018-09-11",2827,68,78,485,101,3559
"Croydon","15:00:00","2018-09-11",225,1,0,11,0,237
"Harrow","15:00:00","2018-09-11",154,0,2,31,1,188
"Hillingdon","15:00:00","2018-09-11",1275,14,29,164,13,1495
"Newham","15:00:00","2018-09-11",858,27,62,129,15,1091
"Southwark","15:00:00","2018-09-11",343,8,1,49,3,404
"Brent","16:00:00","2018-09-11",2928,64,136,485,99,3712
"Croydon","16:00:00","2018-09-11",107,0,0,11,0,118
"Harrow","16:00:00","2018-09-11",156,1,4,25,0,186
"Hillingdon","16:00:00","2018-09-11",1364,21,35,191,15,1626
"Newham","16:00:00","2018-09-11",927,29,56,123,11,1146
"Southwark","16:00:00","2018-09-11",388,7,6,51,0,452
"Brent","17:00:00","2018-09-11",2904,71,66,559,67,3667
"Croydon","17:00:00","2018-09-11",135,0,0,11,0,146
"Harrow","17:00:00","2018-09-11",182,2,1,25,1,211
"Hillingdon","17:00:00","2018-09-11",1573,45,30,161,6,1815
"Newham","17:00:00","2018-09-11",909,31,56,101,4,1101
"Southwark","17:00:00","2018-09-11",413,15,0,37,1,466
"Brent","18:00:00","2018-09-11",3114,76,71,393,63,3717
"Croydon","18:00:00","2018-09-11",108,3,0,5,0,116
"Harrow","18:00:00","2018-09-11",187,2,0,15,1,205
"Hillingdon","18:00:00","2018-09-11",1352,13,27,124,1,1517
"Newham","18:00:00","2018-09-11",901,47,55,98,7,1108
"Southwark","18:00:00","2018-09-11",408,15,0,28,0,451
"Barking and Dagenham","07:00:00","2018-09-12",152,2,13,26,3,196
"Croydon","07:00:00","2018-09-12",2076,42,50,584,65,2817
"Hackney","07:00:00","2018-09-12",34,0,0,10,0,44
"Haringey","07:00:00","2018-09-12",505,9,2,162,13,691
"Havering","07:00:00","2018-09-12",612,2,38,97,10,759
"Islington","07:00:00","2018-09-12",152,24,57,64,26,323
"Waltham Forest","07:00:00","2018-09-12",111,1,32,22,6,172
"Westminster","07:00:00","2018-09-12",410,45,143,207,46,851
"Barking and Dagenham","08:00:00","2018-09-12",214,0,8,25,2,249
"Croydon","08:00:00","2018-09-12",2221,34,58,434,61,2808
"Hackney","08:00:00","2018-09-12",45,0,0,7,0,52
"Haringey","08:00:00","2018-09-12",483,7,0,70,10,570
"Havering","08:00:00","2018-09-12",908,2,35,138,9,1092
"Islington","08:00:00","2018-09-12",190,37,46,86,22,381
"Waltham Forest","08:00:00","2018-09-12",209,0,38,26,5,278
"Westminster","08:00:00","2018-09-12",522,51,159,147,66,945
"Barking and Dagenham","09:00:00","2018-09-12",182,0,17,22,0,221
"Croydon","09:00:00","2018-09-12",1958,29,69,463,71,2590
"Hackney","09:00:00","2018-09-12",29,0,0,8,2,39
"Haringey","09:00:00","2018-09-12",441,6,1,76,20,544
"Havering","09:00:00","2018-09-12",695,2,45,125,15,882
"Islington","09:00:00","2018-09-12",207,32,56,68,26,389
"Waltham Forest","09:00:00","2018-09-12",134,2,39,20,4,199
"Westminster","09:00:00","2018-09-12",527,50,179,151,57,964
"Barking and Dagenham","10:00:00","2018-09-12",149,3,12,31,3,198
"Croydon","10:00:00","2018-09-12",1487,24,53,462,62,2088
"Hackney","10:00:00","2018-09-12",29,1,0,3,1,34
"Haringey","10:00:00","2018-09-12",404,3,0,96,17,520
"Havering","10:00:00","2018-09-12",492,4,23,55,7,581
"Islington","10:00:00","2018-09-12",184,26,52,98,34,394
"Waltham Forest","10:00:00","2018-09-12",131,2,37,37,4,211
"Westminster","10:00:00","2018-09-12",452,30,193,157,55,887
"Barking and Dagenham","11:00:00","2018-09-12",105,1,11,20,5,142
"Croydon","11:00:00","2018-09-12",1661,24,49,505,61,2300
"Hackney","11:00:00","2018-09-12",26,0,0,9,0,35
"Haringey","11:00:00","2018-09-12",413,5,0,78,13,509
"Havering","11:00:00","2018-09-12",480,1,33,82,10,606
"Islington","11:00:00","2018-09-12",199,23,46,120,32,420
"Waltham Forest","11:00:00","2018-09-12",137,0,36,34,7,214
"Westminster","11:00:00","2018-09-12",476,28,169,169,48,890
"Barking and Dagenham","12:00:00","2018-09-12",153,1,14,30,4,202
"Croydon","12:00:00","2018-09-12",1704,32,50,420,55,2261
"Hackney","12:00:00","2018-09-12",29,5,0,6,2,42
"Haringey","12:00:00","2018-09-12",380,16,0,104,13,513
"Havering","12:00:00","2018-09-12",555,2,28,76,8,669
"Islington","12:00:00","2018-09-12",241,29,41,70,38,419
"Waltham Forest","12:00:00","2018-09-12",144,2,37,43,2,228
"Westminster","12:00:00","2018-09-12",513,39,179,163,36,930
"Barking and Dagenham","13:00:00","2018-09-12",154,0,13,23,2,192
"Croydon","13:00:00","2018-09-12",1888,23,61,532,51,2555
"Hackney","13:00:00","2018-09-12",22,3,0,10,0,35
"Haringey","13:00:00","2018-09-12",383,9,0,109,8,509
"Havering","13:00:00","2018-09-12",467,4,30,73,7,581
"Islington","13:00:00","2018-09-12",230,35,49,82,22,418
"Waltham Forest","13:00:00","2018-09-12",141,5,33,28,2,209
"Westminster","13:00:00","2018-09-12",574,45,167,157,29,972
"Barking and Dagenham","14:00:00","2018-09-12",176,0,12,18,1,207
"Croydon","14:00:00","2018-09-12",1949,24,55,509,62,2599
"Hackney","14:00:00","2018-09-12",34,3,1,6,0,44
"Haringey","14:00:00","2018-09-12",401,10,0,107,13,531
"Havering","14:00:00","2018-09-12",572,0,30,60,6,668
"Islington","14:00:00","2018-09-12",253,33,46,114,25,471
"Waltham Forest","14:00:00","2018-09-12",181,1,36,23,2,243
"Westminster","14:00:00","2018-09-12",757,39,160,126,31,1113
"Barking and Dagenham","15:00:00","2018-09-12",248,4,12,25,2,291
"Croydon","15:00:00","2018-09-12",2015,36,58,430,43,2582
"Hackney","15:00:00","2018-09-12",36,4,1,5,0,46
"Haringey","15:00:00","2018-09-12",407,12,1,75,11,506
"Havering","15:00:00","2018-09-12",678,0,34,86,6,804
"Islington","15:00:00","2018-09-12",260,33,57,61,20,431
"Waltham Forest","15:00:00","2018-09-12",161,2,34,24,0,221
"Westminster","15:00:00","2018-09-12",775,41,158,128,29,1131
"Barking and Dagenham","16:00:00","2018-09-12",208,2,13,33,0,256
"Hackney","16:00:00","2018-09-12",43,3,0,4,0,50
"Haringey","16:00:00","2018-09-12",460,12,2,96,4,574
"Havering","16:00:00","2018-09-12",727,6,41,84,6,864
"Islington","16:00:00","2018-09-12",281,31,50,90,14,466
"Waltham Forest","16:00:00","2018-09-12",204,1,42,29,0,276
"Westminster","16:00:00","2018-09-12",850,54,181,108,22,1215
"Barking and Dagenham","17:00:00","2018-09-12",189,0,10,19,1,219
"Hackney","17:00:00","2018-09-12",41,2,0,3,0,46
"Haringey","17:00:00","2018-09-12",468,21,0,91,15,595
"Havering","17:00:00","2018-09-12",738,11,34,83,3,869
"Islington","17:00:00","2018-09-12",334,31,43,56,11,475
"Waltham Forest","17:00:00","2018-09-12",232,4,36,15,1,288
"Westminster","17:00:00","2018-09-12",723,52,173,87,21,1056
"Barking and Dagenham","18:00:00","2018-09-12",211,4,10,25,0,250
"Hackney","18:00:00","2018-09-12",34,8,0,3,0,45
"Haringey","18:00:00","2018-09-12",498,13,0,58,1,570
"Havering","18:00:00","2018-09-12",621,5,24,64,0,714
"Islington","18:00:00","2018-09-12",430,60,49,57,8,604
"Waltham Forest","18:00:00","2018-09-12",264,7,36,16,1,324
"Westminster","18:00:00","2018-09-12",707,64,163,53,15,1002
"Bexley","07:00:00","2018-09-13",235,0,0,48,1,284
"Brent","07:00:00","2018-09-13",42,3,0,5,1,51
"Croydon","07:00:00","2018-09-13",304,10,9,105,16,444
"Enfield","07:00:00","2018-09-13",70,0,0,8,0,78
"Greenwich","07:00:00","2018-09-13",1811,97,77,482,58,2525
"Islington","07:00:00","2018-09-13",411,32,49,145,17,654
"Kensington and Chelsea","07:00:00","2018-09-13",263,58,74,159,29,583
"Lewisham","07:00:00","2018-09-13",718,18,42,275,14,1067
"Westminster","07:00:00","2018-09-13",164,24,0,147,27,362
"Bexley","08:00:00","2018-09-13",265,1,0,34,2,302
"Brent","08:00:00","2018-09-13",87,0,0,4,2,93
"Croydon","08:00:00","2018-09-13",435,10,13,102,33,593
"Enfield","08:00:00","2018-09-13",168,0,0,11,0,179
"Greenwich","08:00:00","2018-09-13",2120,90,76,466,59,2811
"Islington","08:00:00","2018-09-13",482,34,38,118,16,688
"Kensington and Chelsea","08:00:00","2018-09-13",323,82,67,119,28,619
"Lewisham","08:00:00","2018-09-13",943,15,34,253,18,1263
"Westminster","08:00:00","2018-09-13",169,55,0,120,27,371
"Bexley","09:00:00","2018-09-13",188,2,0,28,3,221
"Brent","09:00:00","2018-09-13",43,2,1,3,0,49
"Croydon","09:00:00","2018-09-13",400,6,18,107,27,558
"Enfield","09:00:00","2018-09-13",53,0,0,10,1,64
"Greenwich","09:00:00","2018-09-13",1881,72,110,516,110,2689
"Islington","09:00:00","2018-09-13",418,29,32,124,11,614
"Kensington and Chelsea","09:00:00","2018-09-13",376,59,79,180,54,748
"Lewisham","09:00:00","2018-09-13",738,12,52,205,18,1025
"Westminster","09:00:00","2018-09-13",147,63,0,122,25,357
"Bexley","10:00:00","2018-09-13",158,1,0,41,0,200
"Brent","10:00:00","2018-09-13",42,1,0,7,3,53
"Croydon","10:00:00","2018-09-13",347,11,12,110,18,498
"Enfield","10:00:00","2018-09-13",62,0,0,14,5,81
"Greenwich","10:00:00","2018-09-13",1626,38,85,539,79,2367
"Islington","10:00:00","2018-09-13",464,35,37,149,19,704
"Kensington and Chelsea","10:00:00","2018-09-13",336,31,65,122,44,598
"Lewisham","10:00:00","2018-09-13",705,17,36,224,22,1004
"Westminster","10:00:00","2018-09-13",197,28,0,125,10,360
"Bexley","11:00:00","2018-09-13",181,1,0,33,2,217
"Brent","11:00:00","2018-09-13",42,2,0,6,2,52
"Croydon","11:00:00","2018-09-13",400,13,12,118,20,563
"Enfield","11:00:00","2018-09-13",60,0,1,7,0,68
"Greenwich","11:00:00","2018-09-13",1570,36,76,558,97,2337
"Islington","11:00:00","2018-09-13",443,33,34,156,19,685
"Kensington and Chelsea","11:00:00","2018-09-13",351,43,71,139,26,630
"Lewisham","11:00:00","2018-09-13",770,14,29,183,18,1014
"Westminster","11:00:00","2018-09-13",231,42,0,139,16,428
"Bexley","12:00:00","2018-09-13",191,3,0,23,1,218
"Brent","12:00:00","2018-09-13",53,1,0,6,1,61
"Croydon","12:00:00","2018-09-13",410,8,19,111,28,576
"Enfield","12:00:00","2018-09-13",69,0,0,8,1,78
"Greenwich","12:00:00","2018-09-13",1693,43,86,547,92,2461
"Islington","12:00:00","2018-09-13",355,21,32,104,18,530
"Kensington and Chelsea","12:00:00","2018-09-13",338,39,65,114,39,595
"Lewisham","12:00:00","2018-09-13",719,27,40,201,17,1004
"Westminster","12:00:00","2018-09-13",218,39,1,112,13,383
"Bexley","13:00:00","2018-09-13",173,3,1,38,1,216
"Brent","13:00:00","2018-09-13",36,6,0,3,0,45
"Croydon","13:00:00","2018-09-13",397,13,12,107,21,550
"Enfield","13:00:00","2018-09-13",71,0,2,4,0,77
"Greenwich","13:00:00","2018-09-13",1728,47,77,480,87,2419
"Islington","13:00:00","2018-09-13",398,22,35,142,16,613
"Kensington and Chelsea","13:00:00","2018-09-13",297,29,59,83,33,501
"Lewisham","13:00:00","2018-09-13",777,22,32,213,27,1071
"Westminster","13:00:00","2018-09-13",220,48,0,96,6,370
"Bexley","14:00:00","2018-09-13",191,4,0,24,1,220
"Brent","14:00:00","2018-09-13",45,3,0,7,0,55
"Croydon","14:00:00","2018-09-13",378,8,16,94,34,530
"Enfield","14:00:00","2018-09-13",90,0,1,8,0,99
"Greenwich","14:00:00","2018-09-13",1898,74,95,518,96,2681
"Islington","14:00:00","2018-09-13",397,35,36,134,12,614
"Kensington and Chelsea","14:00:00","2018-09-13",398,45,76,97,24,640
"Lewisham","14:00:00","2018-09-13",805,23,36,181,13,1058
"Westminster","14:00:00","2018-09-13",207,23,0,64,6,300
"Bexley","15:00:00","2018-09-13",294,0,0,25,0,319
"Brent","15:00:00","2018-09-13",79,1,2,4,0,86
"Croydon","15:00:00","2018-09-13",458,11,15,106,16,606
"Enfield","15:00:00","2018-09-13",120,0,0,7,2,129
"Greenwich","15:00:00","2018-09-13",2014,81,91,503,83,2772
"Islington","15:00:00","2018-09-13",362,31,33,112,13,551
"Kensington and Chelsea","15:00:00","2018-09-13",475,62,72,103,19,731
"Lewisham","15:00:00","2018-09-13",834,25,36,208,15,1118
"Westminster","15:00:00","2018-09-13",248,23,1,71,9,352
"Bexley","16:00:00","2018-09-13",249,3,0,40,1,293
"Brent","16:00:00","2018-09-13",50,2,0,9,2,63
"Croydon","16:00:00","2018-09-13",484,13,26,92,12,627
"Enfield","16:00:00","2018-09-13",86,1,0,5,0,92
"Greenwich","16:00:00","2018-09-13",2076,77,77,547,83,2860
"Islington","16:00:00","2018-09-13",446,28,38,136,11,659
"Kensington and Chelsea","16:00:00","2018-09-13",382,43,69,68,12,574
"Lewisham","16:00:00","2018-09-13",764,21,38,196,6,1025
"Westminster","16:00:00","2018-09-13",251,30,0,61,7,349
"Bexley","17:00:00","2018-09-13",325,6,0,46,4,381
"Brent","17:00:00","2018-09-13",59,4,0,12,0,75
"Croydon","17:00:00","2018-09-13",553,32,15,91,8,699
"Enfield","17:00:00","2018-09-13",69,3,0,4,0,76
"Greenwich","17:00:00","2018-09-13",2535,138,74,459,58,3264
"Islington","17:00:00","2018-09-13",507,36,40,85,4,672
"Kensington and Chelsea","17:00:00","2018-09-13",437,59,65,59,10,630
"Lewisham","17:00:00","2018-09-13",838,40,27,145,5,1055
"Westminster","17:00:00","2018-09-13",277,48,0,39,6,370
"Bexley","18:00:00","2018-09-13",380,3,0,49,0,432
"Brent","18:00:00","2018-09-13",50,2,0,9,0,61
"Croydon","18:00:00","2018-09-13",533,10,16,67,1,627
"Enfield","18:00:00","2018-09-13",51,1,0,6,2,60
"Greenwich","18:00:00","2018-09-13",2526,96,72,411,40,3145
"Islington","18:00:00","2018-09-13",498,50,34,68,6,656
"Kensington and Chelsea","18:00:00","2018-09-13",369,32,49,50,13,513
"Lewisham","18:00:00","2018-09-13",949,34,36,114,2,1135
"Westminster","18:00:00","2018-09-13",366,37,0,30,1,434
"Barking and Dagenham","07:00:00","2018-09-14",52,1,9,14,1,77
"Bexley","07:00:00","2018-09-14",79,0,0,9,0,88
"Bromley","07:00:00","2018-09-14",492,15,2,153,4,666
"Croydon","07:00:00","2018-09-14",397,14,27,139,10,587
"Hackney","07:00:00","2018-09-14",428,17,15,114,16,590
"Harrow","07:00:00","2018-09-14",965,16,58,191,43,1273
"Kingston upon Thames","07:00:00","2018-09-14",1218,24,25,295,30,1592
"Redbridge","07:00:00","2018-09-14",502,0,0,52,2,556
"Richmond upon Thames","07:00:00","2018-09-14",1572,92,111,372,41,2188
"Southwark","07:00:00","2018-09-14",620,31,17,309,43,1020
"Wandsworth","07:00:00","2018-09-14",862,40,48,273,43,1266
"Westminster","07:00:00","2018-09-14",149,16,238,67,33,503
"Barking and Dagenham","08:00:00","2018-09-14",71,0,6,12,8,97
"Bexley","08:00:00","2018-09-14",160,0,0,16,1,177
"Bromley","08:00:00","2018-09-14",660,4,3,128,7,802
"Croydon","08:00:00","2018-09-14",506,16,31,119,23,695
"Hackney","08:00:00","2018-09-14",457,18,17,114,15,621
"Harrow","08:00:00","2018-09-14",1051,8,48,149,35,1291
"Kingston upon Thames","08:00:00","2018-09-14",1419,56,41,269,38,1823
"Redbridge","08:00:00","2018-09-14",668,1,0,63,4,736
"Richmond upon Thames","08:00:00","2018-09-14",1636,100,114,297,34,2181
"Southwark","08:00:00","2018-09-14",662,20,17,299,43,1041
"Wandsworth","08:00:00","2018-09-14",985,48,61,228,34,1356
"Westminster","08:00:00","2018-09-14",230,34,279,79,27,649
"Barking and Dagenham","09:00:00","2018-09-14",57,0,5,25,5,92
"Bexley","09:00:00","2018-09-14",96,0,0,13,0,109
"Bromley","09:00:00","2018-09-14",369,7,1,106,8,491
"Croydon","09:00:00","2018-09-14",444,7,23,104,21,599
"Hackney","09:00:00","2018-09-14",407,18,16,122,18,581
"Harrow","09:00:00","2018-09-14",1080,13,42,178,32,1345
"Kingston upon Thames","09:00:00","2018-09-14",1346,23,20,280,42,1711
"Redbridge","09:00:00","2018-09-14",328,3,0,41,2,374
"Richmond upon Thames","09:00:00","2018-09-14",1401,41,117,302,42,1903
"Southwark","09:00:00","2018-09-14",532,17,16,225,42,832
"Wandsworth","09:00:00","2018-09-14",878,32,57,243,35,1245
"Westminster","09:00:00","2018-09-14",260,26,264,69,34,653
"Barking and Dagenham","10:00:00","2018-09-14",56,0,6,25,0,87
"Bexley","10:00:00","2018-09-14",56,0,0,15,3,74
"Bromley","10:00:00","2018-09-14",248,1,1,59,1,310
"Croydon","10:00:00","2018-09-14",453,15,33,149,16,666
"Hackney","10:00:00","2018-09-14",403,17,16,117,15,568
"Harrow","10:00:00","2018-09-14",1026,8,44,188,44,1310
"Kingston upon Thames","10:00:00","2018-09-14",1586,33,26,291,56,1992
"Redbridge","10:00:00","2018-09-14",262,2,0,47,1,312
"Richmond upon Thames","10:00:00","2018-09-14",1528,63,112,335,52,2090
"Southwark","10:00:00","2018-09-14",537,17,15,279,45,893
"Wandsworth","10:00:00","2018-09-14",727,29,55,301,37,1149
"Westminster","10:00:00","2018-09-14",273,19,244,71,28,635
"Barking and Dagenham","11:00:00","2018-09-14",73,0,6,24,1,104
"Bexley","11:00:00","2018-09-14",78,3,0,14,1,96
"Bromley","11:00:00","2018-09-14",223,2,4,46,3,278
"Croydon","11:00:00","2018-09-14",496,22,39,127,9,693
"Hackney","11:00:00","2018-09-14",419,23,17,117,18,594
"Harrow","11:00:00","2018-09-14",1049,5,41,191,42,1328
"Kingston upon Thames","11:00:00","2018-09-14",1293,46,23,274,36,1672
"Redbridge","11:00:00","2018-09-14",237,1,0,46,0,284
"Richmond upon Thames","11:00:00","2018-09-14",1340,66,110,374,41,1931
"Southwark","11:00:00","2018-09-14",548,22,10,284,55,919
"Wandsworth","11:00:00","2018-09-14",755,35,49,247,40,1126
"Westminster","11:00:00","2018-09-14",274,12,226,66,27,605
"Barking and Dagenham","12:00:00","2018-09-14",68,0,6,17,4,95
"Bexley","12:00:00","2018-09-14",90,2,0,25,1,118
"Bromley","12:00:00","2018-09-14",244,0,0,44,0,288
"Croydon","12:00:00","2018-09-14",511,18,27,105,24,685
"Hackney","12:00:00","2018-09-14",443,28,13,131,28,643
"Harrow","12:00:00","2018-09-14",901,14,43,153,31,1142
"Kingston upon Thames","12:00:00","2018-09-14",1354,26,28,260,29,1697
"Redbridge","12:00:00","2018-09-14",269,0,0,46,1,316
"Richmond upon Thames","12:00:00","2018-09-14",1282,61,99,246,42,1730
"Southwark","12:00:00","2018-09-14",565,22,11,248,50,896
"Wandsworth","12:00:00","2018-09-14",769,44,44,233,30,1120
"Westminster","12:00:00","2018-09-14",219,16,214,44,10,503
"Barking and Dagenham","13:00:00","2018-09-14",64,0,5,19,2,90
"Bexley","13:00:00","2018-09-14",65,0,0,21,3,89
"Bromley","13:00:00","2018-09-14",226,6,1,45,4,282
"Croydon","13:00:00","2018-09-14",566,34,36,113,19,768
"Hackney","13:00:00","2018-09-14",430,21,14,99,17,581
"Harrow","13:00:00","2018-09-14",930,15,40,148,23,1156
"Kingston upon Thames","13:00:00","2018-09-14",1240,24,28,266,40,1598
"Redbridge","13:00:00","2018-09-14",286,2,0,50,5,343
"Richmond upon Thames","13:00:00","2018-09-14",1314,63,102,273,22,1774
"Southwark","13:00:00","2018-09-14",576,29,19,292,57,973
"Wandsworth","13:00:00","2018-09-14",835,50,51,208,29,1173
"Westminster","13:00:00","2018-09-14",197,14,233,30,7,481
"Barking and Dagenham","14:00:00","2018-09-14",76,0,7,13,3,99
"Bexley","14:00:00","2018-09-14",92,0,0,7,0,99
"Bromley","14:00:00","2018-09-14",294,3,0,52,1,350
"Croydon","14:00:00","2018-09-14",581,23,27,92,22,745
"Hackney","14:00:00","2018-09-14",492,22,15,117,23,669
"Harrow","14:00:00","2018-09-14",1009,5,46,134,35,1229
"Kingston upon Thames","14:00:00","2018-09-14",1305,47,43,202,31,1628
"Redbridge","14:00:00","2018-09-14",307,6,0,42,1,356
"Richmond upon Thames","14:00:00","2018-09-14",1521,71,101,251,26,1970
"Southwark","14:00:00","2018-09-14",662,33,14,295,45,1049
"Wandsworth","14:00:00","2018-09-14",912,53,51,239,28,1283
"Westminster","14:00:00","2018-09-14",219,14,210,30,18,491
"Barking and Dagenham","15:00:00","2018-09-14",56,0,5,10,5,76
"Bexley","15:00:00","2018-09-14",185,1,0,13,3,202
"Bromley","15:00:00","2018-09-14",372,8,1,56,0,437
"Croydon","15:00:00","2018-09-14",635,12,25,86,9,767
"Hackney","15:00:00","2018-09-14",476,30,19,124,9,658
"Harrow","15:00:00","2018-09-14",978,13,36,137,25,1189
"Kingston upon Thames","15:00:00","2018-09-14",1616,30,24,190,24,1884
"Redbridge","15:00:00","2018-09-14",527,0,0,59,1,587
"Richmond upon Thames","15:00:00","2018-09-14",1334,57,90,223,14,1718
"Southwark","15:00:00","2018-09-14",652,39,13,279,43,1026
"Wandsworth","15:00:00","2018-09-14",1000,53,51,222,23,1349
"Westminster","15:00:00","2018-09-14",219,17,213,19,4,472
"Barking and Dagenham","16:00:00","2018-09-14",52,0,6,15,0,73
"Bexley","16:00:00","2018-09-14",118,2,0,16,0,136
"Bromley","16:00:00","2018-09-14",500,8,0,115,0,623
"Croydon","16:00:00","2018-09-14",593,20,30,69,10,722
"Hackney","16:00:00","2018-09-14",477,27,14,91,12,621
"Harrow","16:00:00","2018-09-14",1167,24,48,154,15,1408
"Kingston upon Thames","16:00:00","2018-09-14",1901,44,22,187,14,2168
"Redbridge","16:00:00","2018-09-14",523,4,0,72,3,602
"Richmond upon Thames","16:00:00","2018-09-14",1657,71,96,237,17,2078
"Southwark","16:00:00","2018-09-14",705,42,15,294,27,1083
"Wandsworth","16:00:00","2018-09-14",1006,62,52,241,13,1374
"Westminster","16:00:00","2018-09-14",250,15,234,20,6,525
"Barking and Dagenham","17:00:00","2018-09-14",67,2,5,9,0,83
"Bexley","17:00:00","2018-09-14",125,0,0,15,0,140
"Bromley","17:00:00","2018-09-14",473,15,1,82,1,572
"Croydon","17:00:00","2018-09-14",599,33,25,83,1,741
"Hackney","17:00:00","2018-09-14",522,46,12,73,7,660
"Harrow","17:00:00","2018-09-14",1119,20,44,140,9,1332
"Kingston upon Thames","17:00:00","2018-09-14",1783,62,28,153,12,2038
"Redbridge","17:00:00","2018-09-14",469,4,0,37,0,510
"Richmond upon Thames","17:00:00","2018-09-14",1691,65,91,239,14,2100
"Southwark","17:00:00","2018-09-14",734,41,12,254,14,1055
"Wandsworth","17:00:00","2018-09-14",1073,87,50,193,3,1406
"Westminster","17:00:00","2018-09-14",207,18,241,17,4,487
"Barking and Dagenham","18:00:00","2018-09-14",70,1,7,6,0,84
"Bexley","18:00:00","2018-09-14",99,2,0,11,0,112
"Bromley","18:00:00","2018-09-14",363,6,0,49,1,419
"Croydon","18:00:00","2018-09-14",623,28,27,58,6,742
"Hackney","18:00:00","2018-09-14",557,43,14,69,1,684
"Harrow","18:00:00","2018-09-14",1306,19,46,108,10,1489
"Kingston upon Thames","18:00:00","2018-09-14",1936,45,30,124,7,2142
"Redbridge","18:00:00","2018-09-14",442,3,0,30,0,475
"Richmond upon Thames","18:00:00","2018-09-14",1777,99,93,194,6,2169
"Southwark","18:00:00","2018-09-14",776,44,11,208,3,1042
"Wandsworth","18:00:00","2018-09-14",1093,85,55,144,8,1385
"Westminster","18:00:00","2018-09-14",267,22,228,19,6,542
"Croydon","07:00:00","2018-09-17",415,6,0,38,0,459
"Ealing","07:00:00","2018-09-17",102,1,0,16,0,119
"Greenwich","07:00:00","2018-09-17",791,33,72,349,39,1284
"Havering","07:00:00","2018-09-17",1348,11,17,217,5,1598
"Richmond upon Thames","07:00:00","2018-09-17",894,25,16,134,5,1074
"Sutton","07:00:00","2018-09-17",5,0,0,0,0,5
"Tower Hamlets","07:00:00","2018-09-17",674,226,64,332,92,1388
"Westminster","07:00:00","2018-09-17",374,64,68,216,43,765
"Croydon","08:00:00","2018-09-17",425,5,0,21,0,451
"Ealing","08:00:00","2018-09-17",169,4,0,28,1,202
"Greenwich","08:00:00","2018-09-17",876,35,68,312,57,1348
"Havering","08:00:00","2018-09-17",1413,10,34,202,13,1672
"Richmond upon Thames","08:00:00","2018-09-17",749,23,15,120,8,915
"Sutton","08:00:00","2018-09-17",6,0,0,2,0,8
"Tower Hamlets","08:00:00","2018-09-17",953,253,89,333,109,1737
"Westminster","08:00:00","2018-09-17",343,60,61,153,52,669
"Croydon","09:00:00","2018-09-17",248,0,0,30,2,280
"Ealing","09:00:00","2018-09-17",85,1,0,20,2,108
"Greenwich","09:00:00","2018-09-17",873,18,71,372,42,1376
"Havering","09:00:00","2018-09-17",1021,11,22,113,6,1173
"Richmond upon Thames","09:00:00","2018-09-17",549,14,13,115,22,713
"Sutton","09:00:00","2018-09-17",16,0,0,0,0,16
"Tower Hamlets","09:00:00","2018-09-17",807,144,63,375,125,1514
"Westminster","09:00:00","2018-09-17",402,43,69,199,50,763
"Croydon","10:00:00","2018-09-17",172,3,0,21,0,196
"Ealing","10:00:00","2018-09-17",57,2,0,18,3,80
"Greenwich","10:00:00","2018-09-17",813,15,70,332,67,1297
"Havering","10:00:00","2018-09-17",806,10,21,128,4,969
"Richmond upon Thames","10:00:00","2018-09-17",417,9,14,85,14,539
"Sutton","10:00:00","2018-09-17",9,0,0,3,0,12
"Tower Hamlets","10:00:00","2018-09-17",767,80,63,373,137,1420
"Westminster","10:00:00","2018-09-17",513,37,69,205,60,884
"Croydon","11:00:00","2018-09-17",157,0,0,24,2,183
"Ealing","11:00:00","2018-09-17",58,2,0,24,0,84
"Greenwich","11:00:00","2018-09-17",797,27,66,290,52,1232
"Havering","11:00:00","2018-09-17",822,6,18,118,6,970
"Richmond upon Thames","11:00:00","2018-09-17",460,9,12,96,13,590
"Sutton","11:00:00","2018-09-17",8,0,0,1,0,9
"Tower Hamlets","11:00:00","2018-09-17",812,80,40,375,93,1400
"Westminster","11:00:00","2018-09-17",486,27,56,206,69,844
"Croydon","12:00:00","2018-09-17",200,0,0,24,3,227
"Ealing","12:00:00","2018-09-17",51,2,0,10,0,63
"Greenwich","12:00:00","2018-09-17",752,26,64,315,35,1192
"Havering","12:00:00","2018-09-17",659,6,17,103,6,791
"Richmond upon Thames","12:00:00","2018-09-17",400,8,15,85,15,523
"Sutton","12:00:00","2018-09-17",9,0,0,1,0,10
"Tower Hamlets","12:00:00","2018-09-17",896,84,48,299,115,1442
"Westminster","12:00:00","2018-09-17",434,38,65,181,58,776
"Croydon","13:00:00","2018-09-17",187,1,0,11,4,203
"Ealing","13:00:00","2018-09-17",68,4,0,17,4,93
"Greenwich","13:00:00","2018-09-17",789,33,61,258,39,1180
"Havering","13:00:00","2018-09-17",766,6,19,116,4,911
"Richmond upon Thames","13:00:00","2018-09-17",417,17,16,94,12,556
"Sutton","13:00:00","2018-09-17",11,0,0,1,0,12
"Tower Hamlets","13:00:00","2018-09-17",884,86,53,307,95,1425
"Westminster","13:00:00","2018-09-17",452,31,59,169,55,766
"Croydon","14:00:00","2018-09-17",216,0,0,19,0,235
"Ealing","14:00:00","2018-09-17",85,4,0,18,2,109
"Greenwich","14:00:00","2018-09-17",850,34,65,302,59,1310
"Havering","14:00:00","2018-09-17",821,8,23,108,7,967
"Richmond upon Thames","14:00:00","2018-09-17",453,13,21,83,7,577
"Sutton","14:00:00","2018-09-17",7,0,1,0,0,8
"Tower Hamlets","14:00:00","2018-09-17",873,92,50,343,87,1445
"Westminster","14:00:00","2018-09-17",443,40,60,184,44,771
"Croydon","15:00:00","2018-09-17",302,0,0,19,2,323
"Ealing","15:00:00","2018-09-17",76,8,0,11,4,99
"Greenwich","15:00:00","2018-09-17",1037,39,69,335,24,1504
"Havering","15:00:00","2018-09-17",1032,13,26,161,4,1236
"Richmond upon Thames","15:00:00","2018-09-17",529,8,17,84,4,642
"Sutton","15:00:00","2018-09-17",9,0,0,0,0,9
"Tower Hamlets","15:00:00","2018-09-17",984,104,50,290,70,1498
"Westminster","15:00:00","2018-09-17",441,45,69,212,36,803
"Croydon","16:00:00","2018-09-17",314,0,1,29,0,344
"Ealing","16:00:00","2018-09-17",145,5,0,30,1,181
"Greenwich","16:00:00","2018-09-17",1007,35,62,250,18,1372
"Havering","16:00:00","2018-09-17",1255,8,37,187,1,1488
"Richmond upon Thames","16:00:00","2018-09-17",713,14,8,116,3,854
"Sutton","16:00:00","2018-09-17",12,0,0,0,0,12
"Tower Hamlets","16:00:00","2018-09-17",991,178,53,311,53,1586
"Westminster","16:00:00","2018-09-17",467,63,75,186,15,806
"Croydon","17:00:00","2018-09-17",326,2,0,23,0,351
"Ealing","17:00:00","2018-09-17",222,8,0,36,0,266
"Greenwich","17:00:00","2018-09-17",1036,54,71,216,10,1387
"Havering","17:00:00","2018-09-17",1243,11,19,125,3,1401
"Richmond upon Thames","17:00:00","2018-09-17",807,30,11,78,6,932
"Sutton","17:00:00","2018-09-17",11,0,0,4,0,15
"Tower Hamlets","17:00:00","2018-09-17",789,270,35,181,36,1311
"Westminster","17:00:00","2018-09-17",426,79,69,116,13,703
"Croydon","18:00:00","2018-09-17",267,5,0,21,0,293
"Ealing","18:00:00","2018-09-17",204,7,0,33,0,244
"Greenwich","18:00:00","2018-09-17",1063,61,71,192,12,1399
"Havering","18:00:00","2018-09-17",1239,12,14,129,1,1395
"Richmond upon Thames","18:00:00","2018-09-17",663,18,9,68,4,762
"Sutton","18:00:00","2018-09-17",15,1,0,3,0,19
"Tower Hamlets","18:00:00","2018-09-17",1130,233,50,161,24,1598
"Westminster","18:00:00","2018-09-17",565,78,62,94,5,804
"Bromley","07:00:00","2018-09-18",781,13,8,112,7,921
"Ealing","07:00:00","2018-09-18",3370,301,72,1194,326,5263
"Enfield","07:00:00","2018-09-18",62,0,0,8,0,70
"Harrow","07:00:00","2018-09-18",39,0,0,6,0,45
"Hillingdon","07:00:00","2018-09-18",65,2,0,11,0,78
"Newham","07:00:00","2018-09-18",44,4,0,9,1,58
"Southwark","07:00:00","2018-09-18",574,23,25,185,17,824
"Bromley","08:00:00","2018-09-18",1176,6,6,126,3,1317
"Ealing","08:00:00","2018-09-18",3455,356,87,1102,320,5320
"Enfield","08:00:00","2018-09-18",72,0,0,8,0,80
"Harrow","08:00:00","2018-09-18",64,0,4,4,0,72
"Hillingdon","08:00:00","2018-09-18",95,2,0,16,2,115
"Newham","08:00:00","2018-09-18",57,2,0,10,1,70
"Southwark","08:00:00","2018-09-18",670,21,23,191,15,920
"Bromley","09:00:00","2018-09-18",745,5,7,87,3,847
"Ealing","09:00:00","2018-09-18",3253,145,63,1169,389,5019
"Enfield","09:00:00","2018-09-18",46,0,0,18,0,64
"Harrow","09:00:00","2018-09-18",38,0,0,8,0,46
"Hillingdon","09:00:00","2018-09-18",54,2,0,6,0,62
"Newham","09:00:00","2018-09-18",43,4,0,19,0,66
"Southwark","09:00:00","2018-09-18",577,16,22,175,25,815
"Bromley","10:00:00","2018-09-18",516,6,8,78,6,614
"Ealing","10:00:00","2018-09-18",2789,95,49,1197,397,4527
"Enfield","10:00:00","2018-09-18",42,0,0,11,0,53
"Harrow","10:00:00","2018-09-18",29,0,0,8,0,37
"Hillingdon","10:00:00","2018-09-18",56,0,0,16,0,72
"Newham","10:00:00","2018-09-18",45,3,0,6,0,54
"Southwark","10:00:00","2018-09-18",499,8,20,183,16,726
"Bromley","11:00:00","2018-09-18",522,4,5,75,9,615
"Ealing","11:00:00","2018-09-18",2979,94,38,1138,399,4648
"Enfield","11:00:00","2018-09-18",39,0,0,9,0,48
"Harrow","11:00:00","2018-09-18",23,0,0,4,0,27
"Hillingdon","11:00:00","2018-09-18",55,1,0,9,0,65
"Newham","11:00:00","2018-09-18",27,1,0,11,0,39
"Southwark","11:00:00","2018-09-18",463,12,19,181,22,697
"Bromley","12:00:00","2018-09-18",473,10,8,69,3,563
"Ealing","12:00:00","2018-09-18",3113,105,36,1261,401,4916
"Enfield","12:00:00","2018-09-18",53,0,0,13,0,66
"Harrow","12:00:00","2018-09-18",42,0,0,2,0,44
"Hillingdon","12:00:00","2018-09-18",56,0,0,16,0,72
"Newham","12:00:00","2018-09-18",48,2,0,14,0,64
"Southwark","12:00:00","2018-09-18",508,17,19,163,27,734
"Bromley","13:00:00","2018-09-18",473,13,7,72,7,572
"Ealing","13:00:00","2018-09-18",3077,97,38,1196,369,4777
"Enfield","13:00:00","2018-09-18",28,0,0,8,0,36
"Harrow","13:00:00","2018-09-18",22,0,0,4,0,26
"Hillingdon","13:00:00","2018-09-18",65,1,0,17,0,83
"Newham","13:00:00","2018-09-18",50,5,0,9,0,64
"Southwark","13:00:00","2018-09-18",471,12,18,176,28,705
"Bromley","14:00:00","2018-09-18",690,7,8,103,5,813
"Ealing","14:00:00","2018-09-18",2908,136,43,1090,307,4484
"Enfield","14:00:00","2018-09-18",53,0,0,12,0,65
"Harrow","14:00:00","2018-09-18",34,0,0,2,0,36
"Hillingdon","14:00:00","2018-09-18",64,3,0,9,0,76
"Newham","14:00:00","2018-09-18",49,5,0,16,2,72
"Southwark","14:00:00","2018-09-18",514,11,21,178,22,746
"Bromley","15:00:00","2018-09-18",859,10,9,105,4,987
"Ealing","15:00:00","2018-09-18",3075,111,28,1138,255,4607
"Enfield","15:00:00","2018-09-18",54,0,0,10,0,64
"Harrow","15:00:00","2018-09-18",39,0,0,5,0,44
"Hillingdon","15:00:00","2018-09-18",100,0,0,21,0,121
"Newham","15:00:00","2018-09-18",40,4,0,12,0,56
"Southwark","15:00:00","2018-09-18",594,22,21,185,14,836
"Bromley","16:00:00","2018-09-18",946,9,12,125,1,1093
"Ealing","16:00:00","2018-09-18",3615,161,36,1120,179,5111
"Enfield","16:00:00","2018-09-18",60,0,0,5,2,67
"Harrow","16:00:00","2018-09-18",23,0,0,6,0,29
"Hillingdon","16:00:00","2018-09-18",77,3,0,21,0,101
"Newham","16:00:00","2018-09-18",82,7,0,17,2,108
"Southwark","16:00:00","2018-09-18",701,28,21,180,5,935
"Bromley","17:00:00","2018-09-18",1110,9,7,117,1,1244
"Ealing","17:00:00","2018-09-18",3824,239,37,1029,167,5296
"Enfield","17:00:00","2018-09-18",72,0,0,8,0,80
"Harrow","17:00:00","2018-09-18",48,0,0,3,0,51
"Hillingdon","17:00:00","2018-09-18",93,1,0,6,0,100
"Newham","17:00:00","2018-09-18",74,7,0,21,0,102
"Southwark","17:00:00","2018-09-18",732,20,19,132,7,910
"Bromley","18:00:00","2018-09-18",957,14,8,64,0,1043
"Ealing","18:00:00","2018-09-18",4260,278,71,794,125,5528
"Enfield","18:00:00","2018-09-18",56,0,0,5,2,63
"Harrow","18:00:00","2018-09-18",57,0,0,6,0,63
"Hillingdon","18:00:00","2018-09-18",64,2,0,19,0,85
"Newham","18:00:00","2018-09-18",75,8,0,4,1,88
"Southwark","18:00:00","2018-09-18",751,21,21,116,3,912
"Brent","07:00:00","2018-09-19",507,20,21,190,47,785
"Hillingdon","07:00:00","2018-09-19",713,8,8,132,9,870
"Kingston upon Thames","07:00:00","2018-09-19",419,11,2,100,2,534
"Lambeth","07:00:00","2018-09-19",466,62,33,306,44,911
"Lewisham","07:00:00","2018-09-19",556,14,32,203,17,822
"Newham","07:00:00","2018-09-19",480,7,22,81,9,599
"Wandsworth","07:00:00","2018-09-19",488,49,18,188,5,748
"Brent","08:00:00","2018-09-19",741,35,25,149,45,995
"Hillingdon","08:00:00","2018-09-19",850,13,10,102,10,985
"Kingston upon Thames","08:00:00","2018-09-19",838,10,5,95,5,953
"Lambeth","08:00:00","2018-09-19",602,74,35,209,60,980
"Lewisham","08:00:00","2018-09-19",684,20,25,168,19,916
"Newham","08:00:00","2018-09-19",792,7,22,93,7,921
"Wandsworth","08:00:00","2018-09-19",396,39,18,122,7,582
"Brent","09:00:00","2018-09-19",561,15,26,211,64,877
"Hillingdon","09:00:00","2018-09-19",682,7,10,81,12,792
"Kingston upon Thames","09:00:00","2018-09-19",489,10,3,66,7,575
"Lambeth","09:00:00","2018-09-19",501,31,33,271,62,898
"Lewisham","09:00:00","2018-09-19",577,8,39,171,39,834
"Newham","09:00:00","2018-09-19",577,5,23,65,4,674
"Wandsworth","09:00:00","2018-09-19",250,13,10,105,3,381
"Brent","10:00:00","2018-09-19",431,11,29,173,52,696
"Hillingdon","10:00:00","2018-09-19",590,4,7,112,9,722
"Kingston upon Thames","10:00:00","2018-09-19",442,5,5,83,2,537
"Lambeth","10:00:00","2018-09-19",506,30,42,261,74,913
"Lewisham","10:00:00","2018-09-19",575,14,27,145,28,789
"Newham","10:00:00","2018-09-19",491,2,26,74,6,599
"Wandsworth","10:00:00","2018-09-19",251,11,11,88,8,369
"Brent","11:00:00","2018-09-19",390,17,26,153,52,638
"Hillingdon","11:00:00","2018-09-19",638,7,7,100,18,770
"Kingston upon Thames","11:00:00","2018-09-19",345,7,1,81,8,442
"Lambeth","11:00:00","2018-09-19",516,31,28,229,98,902
"Lewisham","11:00:00","2018-09-19",487,7,24,134,8,660
"Newham","11:00:00","2018-09-19",492,3,24,67,7,593
"Wandsworth","11:00:00","2018-09-19",249,9,12,97,14,381
"Brent","12:00:00","2018-09-19",325,25,19,129,35,533
"Hillingdon","12:00:00","2018-09-19",638,3,11,128,7,787
"Kingston upon Thames","12:00:00","2018-09-19",412,5,4,80,3,504
"Lambeth","12:00:00","2018-09-19",541,43,31,416,55,1086
"Lewisham","12:00:00","2018-09-19",500,4,26,110,23,663
"Newham","12:00:00","2018-09-19",534,12,21,76,6,649
"Wandsworth","12:00:00","2018-09-19",281,9,11,117,5,423
"Brent","13:00:00","2018-09-19",337,23,21,132,43,556
"Hillingdon","13:00:00","2018-09-19",587,16,9,108,9,729
"Kingston upon Thames","13:00:00","2018-09-19",387,8,1,75,0,471
"Lambeth","13:00:00","2018-09-19",552,41,38,376,62,1069
"Lewisham","13:00:00","2018-09-19",558,9,23,106,12,708
"Newham","13:00:00","2018-09-19",531,12,22,58,4,627
"Wandsworth","13:00:00","2018-09-19",278,14,15,124,9,440
"Brent","14:00:00","2018-09-19",475,21,22,168,43,729
"Hillingdon","14:00:00","2018-09-19",673,8,12,107,7,807
"Kingston upon Thames","14:00:00","2018-09-19",380,5,4,79,5,473
"Lambeth","14:00:00","2018-09-19",550,55,28,300,61,994
"Lewisham","14:00:00","2018-09-19",587,15,26,116,10,754
"Newham","14:00:00","2018-09-19",580,9,20,84,7,700
"Wandsworth","14:00:00","2018-09-19",237,15,10,96,9,367
"Brent","15:00:00","2018-09-19",560,23,17,154,42,796
"Hillingdon","15:00:00","2018-09-19",917,5,13,99,3,1037
"Kingston upon Thames","15:00:00","2018-09-19",641,4,6,109,6,766
"Lambeth","15:00:00","2018-09-19",660,44,28,377,30,1139
"Lewisham","15:00:00","2018-09-19",554,16,30,110,10,720
"Newham","15:00:00","2018-09-19",678,9,22,77,4,790
"Wandsworth","15:00:00","2018-09-19",311,13,13,117,4,458
"Brent","16:00:00","2018-09-19",667,20,12,149,25,873
"Hillingdon","16:00:00","2018-09-19",777,6,6,115,7,911
"Kingston upon Thames","16:00:00","2018-09-19",758,6,3,99,3,869
"Lambeth","16:00:00","2018-09-19",673,122,36,336,28,1195
"Lewisham","16:00:00","2018-09-19",683,13,28,132,5,861
"Newham","16:00:00","2018-09-19",711,11,22,104,6,854
"Wandsworth","16:00:00","2018-09-19",311,17,10,119,0,457
"Brent","17:00:00","2018-09-19",646,41,19,110,7,823
"Hillingdon","17:00:00","2018-09-19",887,15,10,108,5,1025
"Kingston upon Thames","17:00:00","2018-09-19",877,17,3,111,3,1011
"Lambeth","17:00:00","2018-09-19",742,154,36,268,24,1224
"Lewisham","17:00:00","2018-09-19",774,14,28,109,5,930
"Newham","17:00:00","2018-09-19",737,12,22,100,4,875
"Wandsworth","17:00:00","2018-09-19",294,40,10,86,3,433
"Brent","18:00:00","2018-09-19",530,40,14,60,5,649
"Hillingdon","18:00:00","2018-09-19",837,7,6,90,4,944
"Kingston upon Thames","18:00:00","2018-09-19",786,10,2,90,2,890
"Lambeth","18:00:00","2018-09-19",740,126,47,173,13,1099
"Lewisham","18:00:00","2018-09-19",798,20,26,70,0,914
"Newham","18:00:00","2018-09-19",772,24,19,72,1,888
"Wandsworth","18:00:00","2018-09-19",299,29,11,70,3,412
"Bexley","07:00:00","2018-09-20",760,7,14,181,14,976
"Bromley","07:00:00","2018-09-20",1518,34,66,332,38,1988
"Enfield","07:00:00","2018-09-20",653,6,25,121,4,809
"Hillingdon","07:00:00","2018-09-20",1966,27,38,246,136,2413
"Hounslow","07:00:00","2018-09-20",480,9,17,91,10,607
"Lewisham","07:00:00","2018-09-20",21,0,1,7,0,29
"Newham","07:00:00","2018-09-20",143,0,20,41,2,206
"Southwark","07:00:00","2018-09-20",91,2,4,39,4,140
"Sutton","07:00:00","2018-09-20",33,1,0,4,0,38
"Bexley","08:00:00","2018-09-20",797,7,8,133,9,954
"Bromley","08:00:00","2018-09-20",1684,19,61,276,42,2082
"Enfield","08:00:00","2018-09-20",652,3,28,84,6,773
"Hillingdon","08:00:00","2018-09-20",2003,24,37,242,113,2419
"Hounslow","08:00:00","2018-09-20",614,6,20,90,8,738
"Lewisham","08:00:00","2018-09-20",33,0,2,3,0,38
"Newham","08:00:00","2018-09-20",242,4,23,41,3,313
"Southwark","08:00:00","2018-09-20",84,2,1,29,3,119
"Sutton","08:00:00","2018-09-20",26,0,0,4,0,30
"Bexley","09:00:00","2018-09-20",645,4,11,131,14,805
"Bromley","09:00:00","2018-09-20",1517,18,58,244,41,1878
"Enfield","09:00:00","2018-09-20",668,9,24,106,14,821
"Hillingdon","09:00:00","2018-09-20",1225,7,37,195,118,1582
"Hounslow","09:00:00","2018-09-20",443,3,14,79,13,552
"Lewisham","09:00:00","2018-09-20",15,0,0,1,2,18
"Newham","09:00:00","2018-09-20",208,7,23,50,5,293
"Southwark","09:00:00","2018-09-20",85,2,0,32,1,120
"Sutton","09:00:00","2018-09-20",17,0,0,1,0,18
"Bexley","10:00:00","2018-09-20",624,6,13,118,19,780
"Bromley","10:00:00","2018-09-20",1409,17,62,330,64,1882
"Enfield","10:00:00","2018-09-20",573,6,20,80,9,688
"Hillingdon","10:00:00","2018-09-20",786,8,28,186,118,1126
"Hounslow","10:00:00","2018-09-20",355,4,15,66,6,446
"Lewisham","10:00:00","2018-09-20",19,0,0,5,0,24
"Newham","10:00:00","2018-09-20",205,1,22,47,3,278
"Southwark","10:00:00","2018-09-20",55,2,1,24,1,83
"Sutton","10:00:00","2018-09-20",21,0,0,7,0,28
"Bexley","11:00:00","2018-09-20",576,2,11,120,13,722
"Bromley","11:00:00","2018-09-20",1248,29,61,280,45,1663
"Enfield","11:00:00","2018-09-20",592,2,22,94,7,717
"Hillingdon","11:00:00","2018-09-20",861,4,25,190,115,1195
"Hounslow","11:00:00","2018-09-20",320,9,13,63,10,415
"Lewisham","11:00:00","2018-09-20",16,0,0,2,0,18
"Newham","11:00:00","2018-09-20",199,4,20,35,2,260
"Southwark","11:00:00","2018-09-20",44,1,0,20,3,68
"Sutton","11:00:00","2018-09-20",12,0,0,5,0,17
"Bexley","12:00:00","2018-09-20",592,4,6,99,9,710
"Bromley","12:00:00","2018-09-20",1241,12,58,230,42,1583
"Enfield","12:00:00","2018-09-20",628,4,20,90,7,749
"Hillingdon","12:00:00","2018-09-20",1056,8,30,193,125,1412
"Hounslow","12:00:00","2018-09-20",367,7,13,64,2,453
"Lewisham","12:00:00","2018-09-20",38,1,0,9,0,48
"Newham","12:00:00","2018-09-20",226,8,20,48,2,304
"Southwark","12:00:00","2018-09-20",45,5,0,18,1,69
"Sutton","12:00:00","2018-09-20",13,1,0,8,0,22
"Bexley","13:00:00","2018-09-20",681,7,7,119,18,832
"Bromley","13:00:00","2018-09-20",1413,24,55,252,38,1782
"Enfield","13:00:00","2018-09-20",664,9,20,120,1,814
"Hillingdon","13:00:00","2018-09-20",1249,17,31,186,119,1602
"Hounslow","13:00:00","2018-09-20",387,14,17,77,5,500
"Lewisham","13:00:00","2018-09-20",13,0,0,3,0,16
"Newham","13:00:00","2018-09-20",244,4,18,34,4,304
"Southwark","13:00:00","2018-09-20",61,2,0,29,5,97
"Sutton","13:00:00","2018-09-20",20,0,0,5,0,25
"Bexley","14:00:00","2018-09-20",666,3,8,120,15,812
"Bromley","14:00:00","2018-09-20",1396,30,69,321,40,1856
"Enfield","14:00:00","2018-09-20",739,10,18,121,9,897
"Hillingdon","14:00:00","2018-09-20",1301,19,35,177,106,1638
"Hounslow","14:00:00","2018-09-20",376,7,14,69,4,470
"Lewisham","14:00:00","2018-09-20",23,0,0,4,0,27
"Newham","14:00:00","2018-09-20",299,7,22,59,6,393
"Southwark","14:00:00","2018-09-20",78,1,1,19,3,102
"Sutton","14:00:00","2018-09-20",14,0,0,4,0,18
"Bexley","15:00:00","2018-09-20",787,3,8,108,9,915
"Bromley","15:00:00","2018-09-20",1429,29,49,225,23,1755
"Enfield","15:00:00","2018-09-20",793,11,19,100,3,926
"Hillingdon","15:00:00","2018-09-20",1226,12,23,239,112,1612
"Hounslow","15:00:00","2018-09-20",536,9,14,92,4,655
"Lewisham","15:00:00","2018-09-20",22,1,1,2,0,26
"Newham","15:00:00","2018-09-20",297,5,25,49,1,377
"Southwark","15:00:00","2018-09-20",92,5,4,35,7,143
"Sutton","15:00:00","2018-09-20",20,0,0,3,0,23
"Bexley","16:00:00","2018-09-20",838,14,10,154,6,1022
"Bromley","16:00:00","2018-09-20",1755,28,65,305,19,2172
"Enfield","16:00:00","2018-09-20",778,12,22,123,3,938
"Hillingdon","16:00:00","2018-09-20",1894,19,40,252,98,2303
"Hounslow","16:00:00","2018-09-20",557,13,18,100,4,692
"Lewisham","16:00:00","2018-09-20",30,5,0,9,0,44
"Newham","16:00:00","2018-09-20",301,8,25,37,0,371
"Southwark","16:00:00","2018-09-20",86,7,4,33,2,132
"Sutton","16:00:00","2018-09-20",19,0,0,3,0,22
"Bexley","17:00:00","2018-09-20",881,6,9,90,7,993
"Bromley","17:00:00","2018-09-20",1652,40,63,198,12,1965
"Enfield","17:00:00","2018-09-20",876,10,20,134,6,1046
"Hillingdon","17:00:00","2018-09-20",2190,28,44,257,80,2599
"Hounslow","17:00:00","2018-09-20",721,12,14,61,0,808
"Lewisham","17:00:00","2018-09-20",38,3,0,5,1,47
"Newham","17:00:00","2018-09-20",340,9,24,30,2,405
"Southwark","17:00:00","2018-09-20",110,12,1,24,3,150
"Sutton","17:00:00","2018-09-20",34,0,0,3,0,37
"Bexley","18:00:00","2018-09-20",760,8,14,70,6,858
"Bromley","18:00:00","2018-09-20",1935,38,58,201,20,2252
"Enfield","18:00:00","2018-09-20",868,17,21,127,0,1033
"Hillingdon","18:00:00","2018-09-20",1746,19,32,216,82,2095
"Hounslow","18:00:00","2018-09-20",614,17,12,75,2,720
"Lewisham","18:00:00","2018-09-20",37,5,0,4,0,46
"Newham","18:00:00","2018-09-20",287,10,21,28,0,346
"Southwark","18:00:00","2018-09-20",84,2,1,15,1,103
"Sutton","18:00:00","2018-09-20",49,0,0,2,0,51
"Camden","07:00:00","2018-09-21",847,151,46,428,87,1559
"Croydon","07:00:00","2018-09-21",1358,16,21,288,44,1727
"Haringey","07:00:00","2018-09-21",1149,50,41,481,129,1850
"Havering","07:00:00","2018-09-21",641,11,26,198,12,888
"Islington","07:00:00","2018-09-21",4,6,0,7,1,18
"Lambeth","07:00:00","2018-09-21",1042,112,111,425,39,1729
"Tower Hamlets","07:00:00","2018-09-21",2091,383,50,1023,396,3943
"Wandsworth","07:00:00","2018-09-21",1549,261,76,773,92,2751
"Camden","08:00:00","2018-09-21",798,133,53,317,65,1366
"Croydon","08:00:00","2018-09-21",1514,25,20,307,52,1918
"Haringey","08:00:00","2018-09-21",1352,53,36,475,117,2033
"Havering","08:00:00","2018-09-21",822,4,18,156,21,1021
"Islington","08:00:00","2018-09-21",8,6,0,9,2,25
"Lambeth","08:00:00","2018-09-21",1172,109,93,312,31,1717
"Tower Hamlets","08:00:00","2018-09-21",2308,282,48,905,430,3973
"Wandsworth","08:00:00","2018-09-21",1418,239,87,518,79,2341
"Camden","09:00:00","2018-09-21",779,90,40,343,75,1327
"Croydon","09:00:00","2018-09-21",1420,9,25,222,59,1735
"Haringey","09:00:00","2018-09-21",1349,43,44,478,114,2028
"Havering","09:00:00","2018-09-21",808,9,16,167,26,1026
"Islington","09:00:00","2018-09-21",4,7,0,10,1,22
"Lambeth","09:00:00","2018-09-21",951,72,88,331,42,1484
"Tower Hamlets","09:00:00","2018-09-21",2080,165,29,994,536,3804
"Wandsworth","09:00:00","2018-09-21",1574,160,96,535,102,2467
"Camden","10:00:00","2018-09-21",766,64,40,312,80,1262
"Croydon","10:00:00","2018-09-21",1192,9,25,209,66,1501
"Haringey","10:00:00","2018-09-21",1207,37,49,527,102,1922
"Havering","10:00:00","2018-09-21",691,4,16,175,19,905
"Islington","10:00:00","2018-09-21",12,1,0,10,3,26
"Lambeth","10:00:00","2018-09-21",829,51,79,351,38,1348
"Tower Hamlets","10:00:00","2018-09-21",2032,123,21,943,464,3583
"Wandsworth","10:00:00","2018-09-21",1329,86,65,520,81,2081
"Camden","11:00:00","2018-09-21",805,65,44,343,65,1322
"Croydon","11:00:00","2018-09-21",1022,12,22,219,55,1330
"Haringey","11:00:00","2018-09-21",1288,41,43,528,118,2018
"Havering","11:00:00","2018-09-21",739,3,16,197,24,979
"Islington","11:00:00","2018-09-21",8,5,0,11,1,25
"Lambeth","11:00:00","2018-09-21",805,51,84,308,41,1289
"Tower Hamlets","11:00:00","2018-09-21",2148,140,2,948,499,3737
"Wandsworth","11:00:00","2018-09-21",1380,91,64,535,54,2124
"Camden","12:00:00","2018-09-21",788,66,34,342,61,1291
"Croydon","12:00:00","2018-09-21",1123,8,16,189,50,1386
"Haringey","12:00:00","2018-09-21",1447,64,39,452,99,2101
"Havering","12:00:00","2018-09-21",764,5,14,161,16,960
"Islington","12:00:00","2018-09-21",7,4,0,9,1,21
"Lambeth","12:00:00","2018-09-21",858,60,87,269,33,1307
"Tower Hamlets","12:00:00","2018-09-21",2326,123,15,1001,400,3865
"Wandsworth","12:00:00","2018-09-21",1384,58,55,557,84,2138
"Camden","13:00:00","2018-09-21",781,76,39,311,50,1257
"Croydon","13:00:00","2018-09-21",1047,13,18,201,63,1342
"Haringey","13:00:00","2018-09-21",1306,47,43,466,109,1971
"Havering","13:00:00","2018-09-21",800,6,16,150,6,978
"Islington","13:00:00","2018-09-21",9,1,0,8,0,18
"Lambeth","13:00:00","2018-09-21",892,47,85,310,35,1369
"Tower Hamlets","13:00:00","2018-09-21",2188,153,8,1027,483,3859
"Wandsworth","13:00:00","2018-09-21",1341,63,61,452,50,1967
"Camden","14:00:00","2018-09-21",820,85,45,289,43,1282
"Croydon","14:00:00","2018-09-21",1060,11,16,208,47,1342
"Havering","14:00:00","2018-09-21",786,10,15,178,18,1007
"Islington","14:00:00","2018-09-21",13,1,0,5,0,19
"Lambeth","14:00:00","2018-09-21",1049,40,95,303,21,1508
"Tower Hamlets","14:00:00","2018-09-21",2590,155,10,980,391,4126
"Wandsworth","14:00:00","2018-09-21",1479,64,54,468,50,2115
"Camden","15:00:00","2018-09-21",869,74,37,279,36,1295
"Croydon","15:00:00","2018-09-21",1118,6,17,245,40,1426
"Havering","15:00:00","2018-09-21",992,4,22,195,15,1228
"Islington","15:00:00","2018-09-21",10,1,0,5,0,16
"Lambeth","15:00:00","2018-09-21",1111,47,98,249,16,1521
"Tower Hamlets","15:00:00","2018-09-21",2968,206,11,962,302,4449
"Wandsworth","15:00:00","2018-09-21",1799,60,65,347,35,2306
"Camden","16:00:00","2018-09-21",1104,77,44,301,33,1559
"Croydon","16:00:00","2018-09-21",1084,12,20,220,19,1355
"Havering","16:00:00","2018-09-21",961,9,22,198,4,1194
"Islington","16:00:00","2018-09-21",13,2,0,3,1,19
"Lambeth","16:00:00","2018-09-21",1137,68,93,239,7,1544
"Tower Hamlets","16:00:00","2018-09-21",3088,297,30,1000,242,4657
"Wandsworth","16:00:00","2018-09-21",1946,83,72,304,25,2430
"Camden","17:00:00","2018-09-21",1108,146,42,251,34,1581
"Croydon","17:00:00","2018-09-21",1485,13,27,214,16,1755
"Havering","17:00:00","2018-09-21",1055,8,15,149,5,1232
"Islington","17:00:00","2018-09-21",15,3,0,4,0,22
"Lambeth","17:00:00","2018-09-21",1205,102,96,210,7,1620
"Tower Hamlets","17:00:00","2018-09-21",3338,424,56,758,141,4717
"Wandsworth","17:00:00","2018-09-21",1807,106,48,300,19,2280
"Camden","18:00:00","2018-09-21",1345,109,42,245,36,1777
"Croydon","18:00:00","2018-09-21",1322,17,18,134,13,1504
"Havering","18:00:00","2018-09-21",1009,9,14,131,8,1171
"Islington","18:00:00","2018-09-21",13,6,0,3,0,22
"Lambeth","18:00:00","2018-09-21",1354,81,84,151,7,1677
"Tower Hamlets","18:00:00","2018-09-21",3614,339,47,629,128,4757
"Wandsworth","18:00:00","2018-09-21",2058,106,57,223,20,2464
"Barnet","07:00:00","2018-09-24",840,28,40,228,23,1159
"Bexley","07:00:00","2018-09-24",2045,37,15,529,66,2692
"Croydon","07:00:00","2018-09-24",668,12,16,155,12,863
"Havering","07:00:00","2018-09-24",993,10,44,297,15,1359
"Hillingdon","07:00:00","2018-09-24",160,1,0,29,1,191
"Islington","07:00:00","2018-09-24",63,2,0,39,4,108
"Kensington and Chelsea","07:00:00","2018-09-24",913,118,27,307,46,1411
"Lewisham","07:00:00","2018-09-24",1526,79,99,385,83,2172
"Richmond upon Thames","07:00:00","2018-09-24",51,2,0,13,1,67
"Wandsworth","07:00:00","2018-09-24",42,2,1,4,1,50
"Barnet","08:00:00","2018-09-24",1027,31,39,182,19,1298
"Bexley","08:00:00","2018-09-24",2495,33,14,475,62,3079
"Croydon","08:00:00","2018-09-24",654,9,14,133,23,833
"Havering","08:00:00","2018-09-24",1178,8,32,240,21,1479
"Hillingdon","08:00:00","2018-09-24",241,0,0,45,1,287
"Islington","08:00:00","2018-09-24",98,6,3,40,5,152
"Kensington and Chelsea","08:00:00","2018-09-24",832,87,28,272,76,1295
"Lewisham","08:00:00","2018-09-24",1569,74,107,364,87,2201
"Richmond upon Thames","08:00:00","2018-09-24",168,2,0,14,1,185
"Wandsworth","08:00:00","2018-09-24",68,0,0,9,0,77
"Barnet","09:00:00","2018-09-24",737,18,31,160,10,956
"Bexley","09:00:00","2018-09-24",2235,26,18,545,102,2926
"Croydon","09:00:00","2018-09-24",650,10,17,102,9,788
"Havering","09:00:00","2018-09-24",990,8,38,255,24,1315
"Hillingdon","09:00:00","2018-09-24",165,0,0,44,0,209
"Islington","09:00:00","2018-09-24",119,5,1,34,11,170
"Kensington and Chelsea","09:00:00","2018-09-24",786,55,25,292,78,1236
"Lewisham","09:00:00","2018-09-24",1599,71,141,466,138,2415
"Richmond upon Thames","09:00:00","2018-09-24",74,0,0,12,2,88
"Wandsworth","09:00:00","2018-09-24",25,2,0,2,2,31
"Barnet","10:00:00","2018-09-24",719,14,32,169,17,951
"Bexley","10:00:00","2018-09-24",2180,20,13,533,62,2808
"Croydon","10:00:00","2018-09-24",495,6,14,94,11,620
"Havering","10:00:00","2018-09-24",829,3,35,192,27,1086
"Hillingdon","10:00:00","2018-09-24",113,1,0,26,0,140
"Islington","10:00:00","2018-09-24",88,5,2,57,10,162
"Kensington and Chelsea","10:00:00","2018-09-24",756,41,27,370,76,1270
"Lewisham","10:00:00","2018-09-24",1398,36,102,533,119,2188
"Richmond upon Thames","10:00:00","2018-09-24",50,0,0,7,1,58
"Wandsworth","10:00:00","2018-09-24",21,1,0,8,4,34
"Barnet","11:00:00","2018-09-24",677,23,31,176,18,925
"Bexley","11:00:00","2018-09-24",1918,27,19,450,56,2470
"Croydon","11:00:00","2018-09-24",500,5,13,84,15,617
"Havering","11:00:00","2018-09-24",966,8,37,213,24,1248
"Hillingdon","11:00:00","2018-09-24",75,0,0,15,2,92
"Islington","11:00:00","2018-09-24",70,12,2,65,7,156
"Kensington and Chelsea","11:00:00","2018-09-24",758,36,20,344,90,1248
"Lewisham","11:00:00","2018-09-24",1323,34,117,472,115,2061
"Richmond upon Thames","11:00:00","2018-09-24",69,1,0,9,0,79
"Wandsworth","11:00:00","2018-09-24",25,0,0,7,0,32
"Barnet","12:00:00","2018-09-24",784,20,31,151,15,1001
"Bexley","12:00:00","2018-09-24",2356,32,21,432,65,2906
"Croydon","12:00:00","2018-09-24",457,4,15,92,20,588
"Havering","12:00:00","2018-09-24",819,6,32,176,17,1050
"Hillingdon","12:00:00","2018-09-24",57,0,0,14,0,71
"Islington","12:00:00","2018-09-24",67,10,3,50,7,137
"Kensington and Chelsea","12:00:00","2018-09-24",778,33,22,359,111,1303
"Lewisham","12:00:00","2018-09-24",1460,39,125,487,119,2230
"Richmond upon Thames","12:00:00","2018-09-24",49,2,0,13,0,64
"Wandsworth","12:00:00","2018-09-24",34,3,0,11,0,48
"Barnet","13:00:00","2018-09-24",817,18,30,163,22,1050
"Bexley","13:00:00","2018-09-24",2474,23,12,416,76,3001
"Croydon","13:00:00","2018-09-24",488,8,11,90,9,606
"Havering","13:00:00","2018-09-24",922,14,33,209,23,1201
"Hillingdon","13:00:00","2018-09-24",97,1,0,24,0,122
"Islington","13:00:00","2018-09-24",75,14,1,47,7,144
"Kensington and Chelsea","13:00:00","2018-09-24",706,47,24,363,110,1250
"Lewisham","13:00:00","2018-09-24",1235,40,110,461,103,1949
"Richmond upon Thames","13:00:00","2018-09-24",37,0,0,6,0,43
"Wandsworth","13:00:00","2018-09-24",25,4,0,6,0,35
"Barnet","14:00:00","2018-09-24",781,27,35,153,17,1013
"Bexley","14:00:00","2018-09-24",2223,37,21,492,60,2833
"Croydon","14:00:00","2018-09-24",460,2,10,65,7,544
"Havering","14:00:00","2018-09-24",1015,10,40,220,12,1297
"Hillingdon","14:00:00","2018-09-24",140,3,0,28,0,171
"Islington","14:00:00","2018-09-24",78,10,2,52,5,147
"Kensington and Chelsea","14:00:00","2018-09-24",708,32,34,365,95,1234
"Lewisham","14:00:00","2018-09-24",1319,51,110,473,107,2060
"Richmond upon Thames","14:00:00","2018-09-24",46,1,0,7,0,54
"Wandsworth","14:00:00","2018-09-24",33,3,0,4,0,40
"Barnet","15:00:00","2018-09-24",942,28,34,143,5,1152
"Bexley","15:00:00","2018-09-24",2325,45,21,410,60,2861
"Croydon","15:00:00","2018-09-24",544,3,9,86,9,651
"Havering","15:00:00","2018-09-24",907,16,34,216,21,1194
"Hillingdon","15:00:00","2018-09-24",226,1,1,29,2,259
"Islington","15:00:00","2018-09-24",88,10,6,41,2,147
"Kensington and Chelsea","15:00:00","2018-09-24",728,54,32,379,87,1280
"Lewisham","15:00:00","2018-09-24",1399,49,111,438,83,2080
"Richmond upon Thames","15:00:00","2018-09-24",91,1,0,8,0,100
"Wandsworth","15:00:00","2018-09-24",36,1,0,5,1,43
"Barnet","16:00:00","2018-09-24",910,24,36,125,5,1100
"Bexley","16:00:00","2018-09-24",2866,38,27,591,23,3545
"Croydon","16:00:00","2018-09-24",675,6,16,128,6,831
"Havering","16:00:00","2018-09-24",1075,17,41,271,9,1413
"Hillingdon","16:00:00","2018-09-24",134,1,0,24,0,159
"Islington","16:00:00","2018-09-24",87,12,3,37,4,143
"Kensington and Chelsea","16:00:00","2018-09-24",821,84,33,344,53,1335
"Lewisham","16:00:00","2018-09-24",1495,59,99,372,52,2077
"Richmond upon Thames","16:00:00","2018-09-24",87,2,0,11,0,100
"Wandsworth","16:00:00","2018-09-24",60,3,1,7,0,71
"Barnet","17:00:00","2018-09-24",946,38,34,137,6,1161
"Bexley","17:00:00","2018-09-24",2797,48,15,429,24,3313
"Croydon","17:00:00","2018-09-24",807,12,12,111,2,944
"Havering","17:00:00","2018-09-24",1245,14,39,239,13,1550
"Hillingdon","17:00:00","2018-09-24",166,4,0,19,0,189
"Islington","17:00:00","2018-09-24",103,15,0,29,3,150
"Kensington and Chelsea","17:00:00","2018-09-24",921,98,29,280,34,1362
"Lewisham","17:00:00","2018-09-24",1580,114,103,444,66,2307
"Richmond upon Thames","17:00:00","2018-09-24",94,1,0,6,0,101
"Wandsworth","17:00:00","2018-09-24",45,5,0,9,0,59
"Barnet","18:00:00","2018-09-24",927,30,36,105,3,1101
"Bexley","18:00:00","2018-09-24",2475,40,20,328,15,2878
"Croydon","18:00:00","2018-09-24",688,6,10,77,1,782
"Havering","18:00:00","2018-09-24",1303,10,42,141,6,1502
"Hillingdon","18:00:00","2018-09-24",167,1,0,16,0,184
"Islington","18:00:00","2018-09-24",121,22,0,20,0,163
"Kensington and Chelsea","18:00:00","2018-09-24",851,125,28,215,18,1237
"Lewisham","18:00:00","2018-09-24",1778,108,116,301,36,2339
"Richmond upon Thames","18:00:00","2018-09-24",70,3,0,7,1,81
"Wandsworth","18:00:00","2018-09-24",59,4,0,9,0,72
"Brent","07:00:00","2018-09-25",809,14,48,159,7,1037
"Hackney","07:00:00","2018-09-25",351,11,0,124,10,496
"Haringey","07:00:00","2018-09-25",404,11,13,93,4,525
"Hillingdon","07:00:00","2018-09-25",459,12,4,45,13,533
"Islington","07:00:00","2018-09-25",22,0,0,7,0,29
"Lambeth","07:00:00","2018-09-25",312,16,13,103,7,451
"Newham","07:00:00","2018-09-25",45,0,0,5,1,51
"Sutton","07:00:00","2018-09-25",700,28,7,164,36,935
"Tower Hamlets","07:00:00","2018-09-25",800,46,18,328,105,1297
"Brent","08:00:00","2018-09-25",1243,11,45,113,11,1423
"Hackney","08:00:00","2018-09-25",466,10,3,116,9,604
"Haringey","08:00:00","2018-09-25",378,5,13,65,9,470
"Hillingdon","08:00:00","2018-09-25",327,8,6,63,27,431
"Islington","08:00:00","2018-09-25",41,1,2,7,1,52
"Lambeth","08:00:00","2018-09-25",449,30,11,109,8,607
"Newham","08:00:00","2018-09-25",126,0,2,16,0,144
"Sutton","08:00:00","2018-09-25",739,21,7,121,35,923
"Tower Hamlets","08:00:00","2018-09-25",977,50,9,314,130,1480
"Brent","09:00:00","2018-09-25",776,10,39,97,12,934
"Hackney","09:00:00","2018-09-25",371,11,0,87,11,480
"Haringey","09:00:00","2018-09-25",287,6,11,63,10,377
"Hillingdon","09:00:00","2018-09-25",209,3,6,76,12,306
"Islington","09:00:00","2018-09-25",34,0,0,15,1,50
"Lambeth","09:00:00","2018-09-25",364,23,14,116,5,522
"Newham","09:00:00","2018-09-25",79,3,2,13,2,99
"Sutton","09:00:00","2018-09-25",694,14,16,173,69,966
"Tower Hamlets","09:00:00","2018-09-25",776,42,11,326,144,1299
"Brent","10:00:00","2018-09-25",665,16,34,114,14,843
"Hackney","10:00:00","2018-09-25",317,11,0,81,17,426
"Haringey","10:00:00","2018-09-25",235,5,10,57,11,318
"Hillingdon","10:00:00","2018-09-25",189,7,6,78,16,296
"Islington","10:00:00","2018-09-25",27,1,0,12,0,40
"Lambeth","10:00:00","2018-09-25",288,8,6,89,10,401
"Newham","10:00:00","2018-09-25",68,2,0,8,3,81
"Sutton","10:00:00","2018-09-25",667,11,20,175,39,912
"Tower Hamlets","10:00:00","2018-09-25",671,31,10,348,138,1198
"Brent","11:00:00","2018-09-25",723,23,35,123,21,925
"Hackney","11:00:00","2018-09-25",297,11,0,97,17,422
"Haringey","11:00:00","2018-09-25",260,7,10,81,10,368
"Hillingdon","11:00:00","2018-09-25",190,4,6,78,20,298
"Islington","11:00:00","2018-09-25",20,1,0,10,2,33
"Lambeth","11:00:00","2018-09-25",292,20,7,110,7,436
"Newham","11:00:00","2018-09-25",92,1,0,25,0,118
"Sutton","11:00:00","2018-09-25",618,14,13,161,45,851
"Tower Hamlets","11:00:00","2018-09-25",719,26,9,352,146,1252
"Brent","12:00:00","2018-09-25",659,20,28,112,18,837
"Hackney","12:00:00","2018-09-25",269,15,1,78,9,372
"Haringey","12:00:00","2018-09-25",287,9,12,77,1,386
"Hillingdon","12:00:00","2018-09-25",218,7,5,87,8,325
"Islington","12:00:00","2018-09-25",29,4,0,12,0,45
"Lambeth","12:00:00","2018-09-25",319,14,5,108,10,456
"Newham","12:00:00","2018-09-25",100,7,0,12,8,127
"Sutton","12:00:00","2018-09-25",644,13,12,158,33,860
"Tower Hamlets","12:00:00","2018-09-25",788,33,4,321,155,1301
"Brent","13:00:00","2018-09-25",694,22,32,121,19,888
"Hackney","13:00:00","2018-09-25",286,15,0,74,8,383
"Haringey","13:00:00","2018-09-25",264,4,8,73,8,357
"Hillingdon","13:00:00","2018-09-25",284,6,7,87,12,396
"Islington","13:00:00","2018-09-25",24,2,0,10,0,36
"Lambeth","13:00:00","2018-09-25",315,21,10,94,10,450
"Newham","13:00:00","2018-09-25",77,8,0,22,2,109
"Sutton","13:00:00","2018-09-25",702,11,11,148,31,903
"Tower Hamlets","13:00:00","2018-09-25",832,52,5,338,165,1392
"Brent","14:00:00","2018-09-25",729,18,43,111,15,916
"Hackney","14:00:00","2018-09-25",353,10,3,76,12,454
"Haringey","14:00:00","2018-09-25",239,12,11,57,7,326
"Hillingdon","14:00:00","2018-09-25",284,8,11,65,14,382
"Islington","14:00:00","2018-09-25",33,1,0,4,0,38
"Lambeth","14:00:00","2018-09-25",340,22,6,105,8,481
"Newham","14:00:00","2018-09-25",122,4,0,12,0,138
"Sutton","14:00:00","2018-09-25",733,12,11,169,40,965
"Tower Hamlets","14:00:00","2018-09-25",872,51,20,326,145,1414
"Brent","15:00:00","2018-09-25",839,20,39,91,14,1003
"Hackney","15:00:00","2018-09-25",402,13,1,92,12,520
"Haringey","15:00:00","2018-09-25",313,4,13,61,1,392
"Hillingdon","15:00:00","2018-09-25",268,13,16,67,8,372
"Islington","15:00:00","2018-09-25",40,2,1,9,1,53
"Lambeth","15:00:00","2018-09-25",372,24,8,110,12,526
"Newham","15:00:00","2018-09-25",142,9,0,16,2,169
"Sutton","15:00:00","2018-09-25",750,20,12,140,40,962
"Tower Hamlets","15:00:00","2018-09-25",1009,47,4,343,123,1526
"Brent","16:00:00","2018-09-25",929,27,46,115,1,1118
"Hackney","16:00:00","2018-09-25",418,18,2,104,17,559
"Haringey","16:00:00","2018-09-25",335,12,12,74,4,437
"Hillingdon","16:00:00","2018-09-25",270,6,9,62,8,355
"Islington","16:00:00","2018-09-25",51,1,0,11,0,63
"Lambeth","16:00:00","2018-09-25",376,24,11,132,5,548
"Newham","16:00:00","2018-09-25",180,3,0,20,5,208
"Sutton","16:00:00","2018-09-25",782,18,11,145,24,980
"Tower Hamlets","16:00:00","2018-09-25",1205,69,10,342,96,1722
"Brent","17:00:00","2018-09-25",1038,33,40,118,7,1236
"Hackney","17:00:00","2018-09-25",474,25,1,76,7,583
"Haringey","17:00:00","2018-09-25",408,21,11,58,0,498
"Hillingdon","17:00:00","2018-09-25",271,7,7,44,7,336
"Islington","17:00:00","2018-09-25",34,3,0,10,0,47
"Lambeth","17:00:00","2018-09-25",434,44,6,98,3,585
"Newham","17:00:00","2018-09-25",269,5,0,29,0,303
"Sutton","17:00:00","2018-09-25",844,25,12,122,14,1017
"Tower Hamlets","17:00:00","2018-09-25",1303,81,10,280,42,1716
"Brent","18:00:00","2018-09-25",939,23,32,110,0,1104
"Hackney","18:00:00","2018-09-25",556,22,0,76,12,666
"Haringey","18:00:00","2018-09-25",379,7,13,35,1,435
"Hillingdon","18:00:00","2018-09-25",207,5,9,29,2,252
"Islington","18:00:00","2018-09-25",47,6,0,4,0,57
"Lambeth","18:00:00","2018-09-25",424,40,5,68,2,539
"Newham","18:00:00","2018-09-25",211,11,0,21,3,246
"Sutton","18:00:00","2018-09-25",812,28,10,102,6,958
"Tower Hamlets","18:00:00","2018-09-25",1190,88,14,213,18,1523
"Bromley","07:00:00","2018-09-26",441,2,0,53,3,499
"Camden","07:00:00","2018-09-26",186,24,1,86,26,323
"Croydon","07:00:00","2018-09-26",582,27,22,180,10,821
"Ealing","07:00:00","2018-09-26",66,1,1,25,0,93
"Hillingdon","07:00:00","2018-09-26",330,6,3,34,2,375
"Kingston upon Thames","07:00:00","2018-09-26",103,1,4,14,1,123
"Lambeth","07:00:00","2018-09-26",107,3,0,37,5,152
"Richmond upon Thames","07:00:00","2018-09-26",1225,50,102,266,18,1661
"Bromley","08:00:00","2018-09-26",443,4,0,43,2,492
"Camden","08:00:00","2018-09-26",128,29,0,64,12,233
"Croydon","08:00:00","2018-09-26",674,22,25,204,9,934
"Ealing","08:00:00","2018-09-26",76,0,0,15,1,92
"Hillingdon","08:00:00","2018-09-26",522,1,4,28,0,555
"Kingston upon Thames","08:00:00","2018-09-26",190,2,6,14,0,212
"Lambeth","08:00:00","2018-09-26",200,9,1,55,7,272
"Richmond upon Thames","08:00:00","2018-09-26",1469,51,86,218,30,1854
"Bromley","09:00:00","2018-09-26",365,2,0,48,0,415
"Camden","09:00:00","2018-09-26",164,24,1,79,6,274
"Croydon","09:00:00","2018-09-26",499,5,18,104,6,632
"Ealing","09:00:00","2018-09-26",73,0,0,17,0,90
"Hillingdon","09:00:00","2018-09-26",171,1,0,29,5,206
"Kingston upon Thames","09:00:00","2018-09-26",109,3,6,16,0,134
"Lambeth","09:00:00","2018-09-26",152,15,0,44,4,215
"Richmond upon Thames","09:00:00","2018-09-26",1167,26,105,263,28,1589
"Bromley","10:00:00","2018-09-26",252,1,0,65,2,320
"Camden","10:00:00","2018-09-26",141,20,0,60,13,234
"Croydon","10:00:00","2018-09-26",412,10,21,87,5,535
"Ealing","10:00:00","2018-09-26",68,0,0,18,3,89
"Hillingdon","10:00:00","2018-09-26",117,2,0,29,3,151
"Kingston upon Thames","10:00:00","2018-09-26",106,3,4,22,2,137
"Lambeth","10:00:00","2018-09-26",135,5,0,54,2,196
"Richmond upon Thames","10:00:00","2018-09-26",1018,17,100,236,27,1398
"Bromley","11:00:00","2018-09-26",282,2,0,44,3,331
"Camden","11:00:00","2018-09-26",144,33,3,68,5,253
"Croydon","11:00:00","2018-09-26",368,4,16,79,5,472
"Ealing","11:00:00","2018-09-26",62,0,0,13,3,78
"Hillingdon","11:00:00","2018-09-26",121,2,0,21,0,144
"Kingston upon Thames","11:00:00","2018-09-26",97,1,4,19,1,122
"Lambeth","11:00:00","2018-09-26",121,8,0,49,2,180
"Richmond upon Thames","11:00:00","2018-09-26",970,20,91,250,31,1362
"Bromley","12:00:00","2018-09-26",271,0,0,38,5,314
"Camden","12:00:00","2018-09-26",120,40,0,49,7,216
"Croydon","12:00:00","2018-09-26",391,6,16,70,11,494
"Ealing","12:00:00","2018-09-26",121,0,0,23,4,148
"Hillingdon","12:00:00","2018-09-26",155,3,0,24,4,186
"Kingston upon Thames","12:00:00","2018-09-26",99,4,4,20,4,131
"Lambeth","12:00:00","2018-09-26",131,9,0,53,3,196
"Richmond upon Thames","12:00:00","2018-09-26",984,24,96,222,10,1336
"Bromley","13:00:00","2018-09-26",288,5,0,40,2,335
"Camden","13:00:00","2018-09-26",142,39,2,69,5,257
"Croydon","13:00:00","2018-09-26",465,9,18,97,3,592
"Ealing","13:00:00","2018-09-26",132,0,0,28,4,164
"Hillingdon","13:00:00","2018-09-26",162,1,2,23,2,190
"Kingston upon Thames","13:00:00","2018-09-26",77,3,4,15,3,102
"Lambeth","13:00:00","2018-09-26",122,8,0,42,2,174
"Richmond upon Thames","13:00:00","2018-09-26",932,28,98,169,17,1244
"Bromley","14:00:00","2018-09-26",344,1,0,38,1,384
"Camden","14:00:00","2018-09-26",160,40,1,65,6,272
"Croydon","14:00:00","2018-09-26",405,5,15,81,8,514
"Ealing","14:00:00","2018-09-26",135,2,0,26,2,165
"Hillingdon","14:00:00","2018-09-26",199,2,0,29,2,232
"Kingston upon Thames","14:00:00","2018-09-26",98,1,5,17,1,122
"Lambeth","14:00:00","2018-09-26",94,16,0,31,3,144
"Richmond upon Thames","14:00:00","2018-09-26",1032,31,99,194,24,1380
"Bromley","15:00:00","2018-09-26",424,0,0,47,2,473
"Camden","15:00:00","2018-09-26",217,26,1,93,9,346
"Croydon","15:00:00","2018-09-26",425,9,15,96,9,554
"Ealing","15:00:00","2018-09-26",152,0,0,27,1,180
"Hillingdon","15:00:00","2018-09-26",337,4,2,31,0,374
"Kingston upon Thames","15:00:00","2018-09-26",192,1,4,19,0,216
"Lambeth","15:00:00","2018-09-26",93,4,1,38,2,138
"Richmond upon Thames","15:00:00","2018-09-26",1220,26,105,194,6,1551
"Bromley","16:00:00","2018-09-26",374,3,0,45,0,422
"Camden","16:00:00","2018-09-26",214,40,1,89,8,352
"Croydon","16:00:00","2018-09-26",470,9,18,84,4,585
"Ealing","16:00:00","2018-09-26",143,1,0,26,1,171
"Hillingdon","16:00:00","2018-09-26",247,7,2,28,2,286
"Kingston upon Thames","16:00:00","2018-09-26",141,0,4,20,0,165
"Lambeth","16:00:00","2018-09-26",118,11,1,28,0,158
"Richmond upon Thames","16:00:00","2018-09-26",1301,36,92,200,3,1632
"Bromley","17:00:00","2018-09-26",423,2,1,43,0,469
"Camden","17:00:00","2018-09-26",234,62,2,76,3,377
"Croydon","17:00:00","2018-09-26",697,24,24,106,4,855
"Ealing","17:00:00","2018-09-26",153,3,0,15,0,171
"Hillingdon","17:00:00","2018-09-26",339,2,0,29,0,370
"Kingston upon Thames","17:00:00","2018-09-26",128,1,4,18,0,151
"Lambeth","17:00:00","2018-09-26",107,18,0,22,1,148
"Richmond upon Thames","17:00:00","2018-09-26",1444,57,95,153,1,1750
"Bromley","18:00:00","2018-09-26",565,10,0,35,2,612
"Camden","18:00:00","2018-09-26",248,39,2,28,4,321
"Croydon","18:00:00","2018-09-26",558,18,18,80,1,675
"Ealing","18:00:00","2018-09-26",178,0,0,37,1,216
"Hillingdon","18:00:00","2018-09-26",248,2,0,20,0,270
"Kingston upon Thames","18:00:00","2018-09-26",118,0,4,10,0,132
"Lambeth","18:00:00","2018-09-26",136,18,0,19,0,173
"Richmond upon Thames","18:00:00","2018-09-26",1466,69,100,117,3,1755
"Barking and Dagenham","07:00:00","2018-09-27",3,0,0,2,0,5
"Brent","07:00:00","2018-09-27",98,2,0,19,1,120
"Camden","07:00:00","2018-09-27",723,81,124,330,66,1324
"Croydon","07:00:00","2018-09-27",648,6,28,169,14,865
"Greenwich","07:00:00","2018-09-27",77,1,0,16,1,95
"Richmond upon Thames","07:00:00","2018-09-27",287,5,5,66,1,364
"Southwark","07:00:00","2018-09-27",621,99,112,227,23,1082
"Westminster","07:00:00","2018-09-27",1263,101,122,549,106,2141
"Barking and Dagenham","08:00:00","2018-09-27",8,0,0,1,0,9
"Brent","08:00:00","2018-09-27",159,2,1,24,2,188
"Camden","08:00:00","2018-09-27",776,119,124,303,44,1366
"Croydon","08:00:00","2018-09-27",720,7,28,155,8,918
"Greenwich","08:00:00","2018-09-27",118,0,2,25,1,146
"Richmond upon Thames","08:00:00","2018-09-27",378,6,6,67,7,464
"Southwark","08:00:00","2018-09-27",691,97,97,162,23,1070
"Westminster","08:00:00","2018-09-27",1247,116,128,420,71,1982
"Barking and Dagenham","09:00:00","2018-09-27",7,0,0,1,0,8
"Brent","09:00:00","2018-09-27",67,1,0,5,0,73
"Camden","09:00:00","2018-09-27",822,80,124,325,53,1404
"Croydon","09:00:00","2018-09-27",504,5,32,85,9,635
"Greenwich","09:00:00","2018-09-27",131,2,0,31,1,165
"Richmond upon Thames","09:00:00","2018-09-27",340,0,7,77,7,431
"Southwark","09:00:00","2018-09-27",688,65,107,174,35,1069
"Westminster","09:00:00","2018-09-27",1127,66,145,413,107,1858
"Barking and Dagenham","10:00:00","2018-09-27",3,0,0,3,0,6
"Brent","10:00:00","2018-09-27",64,2,0,10,0,76
"Camden","10:00:00","2018-09-27",814,66,116,351,59,1406
"Croydon","10:00:00","2018-09-27",411,8,27,103,8,557
"Greenwich","10:00:00","2018-09-27",85,5,0,37,3,130
"Richmond upon Thames","10:00:00","2018-09-27",190,2,5,51,3,251
"Southwark","10:00:00","2018-09-27",581,36,104,199,25,945
"Westminster","10:00:00","2018-09-27",1091,74,135,451,75,1826
"Barking and Dagenham","11:00:00","2018-09-27",2,0,0,2,0,4
"Brent","11:00:00","2018-09-27",72,1,0,28,1,102
"Camden","11:00:00","2018-09-27",675,75,110,368,45,1273
"Croydon","11:00:00","2018-09-27",389,7,25,120,17,558
"Greenwich","11:00:00","2018-09-27",112,0,1,29,2,144
"Richmond upon Thames","11:00:00","2018-09-27",182,2,4,39,1,228
"Southwark","11:00:00","2018-09-27",569,40,89,165,32,895
"Westminster","11:00:00","2018-09-27",1035,59,124,398,80,1696
"Barking and Dagenham","12:00:00","2018-09-27",3,0,0,3,0,6
"Brent","12:00:00","2018-09-27",83,10,0,20,0,113
"Camden","12:00:00","2018-09-27",645,53,110,311,43,1162
"Croydon","12:00:00","2018-09-27",437,12,30,116,20,615
"Greenwich","12:00:00","2018-09-27",116,1,1,36,3,157
"Richmond upon Thames","12:00:00","2018-09-27",222,3,8,47,9,289
"Southwark","12:00:00","2018-09-27",573,46,91,198,36,944
"Westminster","12:00:00","2018-09-27",1113,70,111,422,80,1796
"Barking and Dagenham","13:00:00","2018-09-27",4,0,0,3,0,7
"Brent","13:00:00","2018-09-27",72,4,0,16,0,92
"Camden","13:00:00","2018-09-27",730,75,114,356,43,1318
"Croydon","13:00:00","2018-09-27",464,12,30,115,7,628
"Greenwich","13:00:00","2018-09-27",92,3,1,28,7,131
"Richmond upon Thames","13:00:00","2018-09-27",203,5,6,35,3,252
"Southwark","13:00:00","2018-09-27",620,54,103,197,20,994
"Westminster","13:00:00","2018-09-27",1243,57,126,454,79,1959
"Barking and Dagenham","14:00:00","2018-09-27",3,0,0,2,0,5
"Brent","14:00:00","2018-09-27",99,4,0,17,0,120
"Camden","14:00:00","2018-09-27",697,90,111,294,38,1230
"Croydon","14:00:00","2018-09-27",485,7,24,131,5,652
"Greenwich","14:00:00","2018-09-27",87,6,0,32,2,127
"Richmond upon Thames","14:00:00","2018-09-27",219,2,5,33,1,260
"Southwark","14:00:00","2018-09-27",614,40,103,189,21,967
"Westminster","14:00:00","2018-09-27",1383,62,121,405,79,2050
"Barking and Dagenham","15:00:00","2018-09-27",5,0,0,3,0,8
"Brent","15:00:00","2018-09-27",124,1,1,20,1,147
"Camden","15:00:00","2018-09-27",828,75,121,341,28,1393
"Croydon","15:00:00","2018-09-27",675,5,20,165,3,868
"Greenwich","15:00:00","2018-09-27",158,5,14,24,0,201
"Richmond upon Thames","15:00:00","2018-09-27",271,7,8,50,0,336
"Southwark","15:00:00","2018-09-27",698,55,104,195,18,1070
"Westminster","15:00:00","2018-09-27",1383,86,145,509,41,2164
"Barking and Dagenham","16:00:00","2018-09-27",4,0,0,2,0,6
"Brent","16:00:00","2018-09-27",123,0,0,23,4,150
"Camden","16:00:00","2018-09-27",860,124,121,310,21,1436
"Croydon","16:00:00","2018-09-27",723,8,26,167,8,932
"Greenwich","16:00:00","2018-09-27",125,3,0,20,1,149
"Richmond upon Thames","16:00:00","2018-09-27",302,6,3,52,0,363
"Southwark","16:00:00","2018-09-27",760,71,116,187,10,1144
"Westminster","16:00:00","2018-09-27",1500,112,135,431,33,2211
"Barking and Dagenham","17:00:00","2018-09-27",4,0,0,1,0,5
"Brent","17:00:00","2018-09-27",170,8,0,34,0,212
"Camden","17:00:00","2018-09-27",808,148,108,254,20,1338
"Croydon","17:00:00","2018-09-27",712,16,15,145,7,895
"Greenwich","17:00:00","2018-09-27",116,9,0,22,1,148
"Richmond upon Thames","17:00:00","2018-09-27",298,9,6,38,0,351
"Southwark","17:00:00","2018-09-27",685,95,88,142,7,1017
"Westminster","17:00:00","2018-09-27",1221,89,128,339,31,1808
"Barking and Dagenham","18:00:00","2018-09-27",4,0,0,1,0,5
"Brent","18:00:00","2018-09-27",167,10,0,18,1,196
"Camden","18:00:00","2018-09-27",1086,171,128,260,17,1662
"Croydon","18:00:00","2018-09-27",807,5,20,115,2,949
"Greenwich","18:00:00","2018-09-27",138,5,0,11,0,154
"Richmond upon Thames","18:00:00","2018-09-27",402,6,4,30,1,443
"Southwark","18:00:00","2018-09-27",754,110,96,145,8,1113
"Westminster","18:00:00","2018-09-27",1248,84,127,212,29,1700
"Bexley","07:00:00","2018-09-28",1592,31,27,480,338,2468
"Camden","07:00:00","2018-09-28",49,19,0,33,14,115
"Croydon","07:00:00","2018-09-28",1025,17,36,258,14,1350
"Hackney","07:00:00","2018-09-28",47,3,0,28,0,78
"Harrow","07:00:00","2018-09-28",783,4,14,139,17,957
"Hounslow","07:00:00","2018-09-28",444,11,42,130,7,634
"Lambeth","07:00:00","2018-09-28",813,182,271,443,74,1783
"Waltham Forest","07:00:00","2018-09-28",1341,32,40,347,51,1811
"Bexley","08:00:00","2018-09-28",1322,18,23,431,316,2110
"Camden","08:00:00","2018-09-28",71,17,0,50,13,151
"Croydon","08:00:00","2018-09-28",1132,17,37,190,20,1396
"Hackney","08:00:00","2018-09-28",68,1,2,9,2,82
"Harrow","08:00:00","2018-09-28",1057,6,9,110,21,1203
"Hounslow","08:00:00","2018-09-28",465,14,36,79,12,606
"Lambeth","08:00:00","2018-09-28",854,229,274,437,62,1856
"Waltham Forest","08:00:00","2018-09-28",1308,23,44,280,61,1716
"Bexley","09:00:00","2018-09-28",1237,15,32,475,381,2140
"Camden","09:00:00","2018-09-28",82,30,0,50,10,172
"Croydon","09:00:00","2018-09-28",1088,26,32,255,27,1428
"Hackney","09:00:00","2018-09-28",79,2,0,27,2,110
"Harrow","09:00:00","2018-09-28",888,7,11,112,14,1032
"Hounslow","09:00:00","2018-09-28",504,13,46,129,19,711
"Lambeth","09:00:00","2018-09-28",1002,166,298,462,41,1969
"Waltham Forest","09:00:00","2018-09-28",1238,23,32,368,65,1726
"Bexley","10:00:00","2018-09-28",1220,18,21,454,350,2063
"Camden","10:00:00","2018-09-28",109,28,0,54,8,199
"Croydon","10:00:00","2018-09-28",967,23,26,246,18,1280
"Hackney","10:00:00","2018-09-28",76,3,0,32,2,113
"Harrow","10:00:00","2018-09-28",816,6,9,108,21,960
"Hounslow","10:00:00","2018-09-28",381,14,42,122,16,575
"Lambeth","10:00:00","2018-09-28",995,95,291,389,60,1830
"Waltham Forest","10:00:00","2018-09-28",1310,21,34,401,91,1857
"Bexley","11:00:00","2018-09-28",1133,12,18,418,313,1894
"Camden","11:00:00","2018-09-28",84,22,0,69,0,175
"Croydon","11:00:00","2018-09-28",967,24,29,255,27,1302
"Hackney","11:00:00","2018-09-28",61,6,0,48,0,115
"Harrow","11:00:00","2018-09-28",793,4,13,137,29,976
"Hounslow","11:00:00","2018-09-28",440,8,35,98,13,594
"Lambeth","11:00:00","2018-09-28",959,92,236,429,37,1753
"Waltham Forest","11:00:00","2018-09-28",1381,26,32,378,85,1902
"Bexley","12:00:00","2018-09-28",1212,23,21,427,303,1986
"Camden","12:00:00","2018-09-28",118,18,0,73,2,211
"Croydon","12:00:00","2018-09-28",1086,32,29,250,24,1421
"Hackney","12:00:00","2018-09-28",72,3,0,29,0,104
"Harrow","12:00:00","2018-09-28",884,6,10,126,20,1046
"Hounslow","12:00:00","2018-09-28",576,12,45,110,14,757
"Lambeth","12:00:00","2018-09-28",1065,96,230,428,38,1857
"Waltham Forest","12:00:00","2018-09-28",1330,32,34,319,80,1795
"Bexley","13:00:00","2018-09-28",1385,19,17,414,329,2164
"Camden","13:00:00","2018-09-28",111,29,0,66,5,211
"Croydon","13:00:00","2018-09-28",1135,30,29,249,19,1462
"Hackney","13:00:00","2018-09-28",51,10,0,18,3,82
"Harrow","13:00:00","2018-09-28",841,3,11,126,12,993
"Hounslow","13:00:00","2018-09-28",586,15,35,102,6,744
"Lambeth","13:00:00","2018-09-28",963,111,256,388,49,1767
"Waltham Forest","13:00:00","2018-09-28",1363,32,36,319,67,1817
"Bexley","14:00:00","2018-09-28",1402,23,19,415,343,2202
"Camden","14:00:00","2018-09-28",112,28,0,71,11,222
"Croydon","14:00:00","2018-09-28",1181,41,30,257,24,1533
"Hackney","14:00:00","2018-09-28",61,7,0,25,1,94
"Harrow","14:00:00","2018-09-28",890,9,12,112,17,1040
"Hounslow","14:00:00","2018-09-28",463,15,35,96,5,614
"Lambeth","14:00:00","2018-09-28",1047,117,245,360,47,1816
"Waltham Forest","14:00:00","2018-09-28",1467,21,49,290,53,1880
"Bexley","15:00:00","2018-09-28",1546,28,28,424,350,2376
"Camden","15:00:00","2018-09-28",101,24,0,67,1,193
"Croydon","15:00:00","2018-09-28",1213,32,32,246,21,1544
"Hackney","15:00:00","2018-09-28",117,4,0,15,0,136
"Harrow","15:00:00","2018-09-28",1000,8,12,119,17,1156
"Hounslow","15:00:00","2018-09-28",610,20,40,111,8,789
"Lambeth","15:00:00","2018-09-28",1101,152,251,383,31,1918
"Waltham Forest","15:00:00","2018-09-28",1599,29,38,274,45,1985
"Bexley","16:00:00","2018-09-28",1804,28,21,445,189,2487
"Camden","16:00:00","2018-09-28",97,24,0,41,0,162
"Croydon","16:00:00","2018-09-28",1266,49,28,248,7,1598
"Hackney","16:00:00","2018-09-28",83,8,1,20,1,113
"Harrow","16:00:00","2018-09-28",971,10,16,134,11,1142
"Hounslow","16:00:00","2018-09-28",568,14,45,80,4,711
"Lambeth","16:00:00","2018-09-28",1077,176,298,324,15,1890
"Waltham Forest","16:00:00","2018-09-28",1835,46,41,325,31,2278
"Bexley","17:00:00","2018-09-28",1900,42,14,327,143,2426
"Camden","17:00:00","2018-09-28",115,25,0,50,3,193
"Croydon","17:00:00","2018-09-28",1354,34,35,187,7,1617
"Hackney","17:00:00","2018-09-28",95,7,0,16,0,118
"Harrow","17:00:00","2018-09-28",1062,12,9,103,3,1189
"Hounslow","17:00:00","2018-09-28",656,27,32,59,1,775
"Lambeth","17:00:00","2018-09-28",1146,211,266,247,15,1885
"Waltham Forest","17:00:00","2018-09-28",1853,33,43,267,11,2207
"Bexley","18:00:00","2018-09-28",1963,29,15,273,159,2439
"Camden","18:00:00","2018-09-28",100,22,1,34,3,160
"Croydon","18:00:00","2018-09-28",1260,56,41,161,4,1522
"Hackney","18:00:00","2018-09-28",116,4,0,15,0,135
"Harrow","18:00:00","2018-09-28",1077,10,13,65,1,1166
"Hounslow","18:00:00","2018-09-28",704,28,41,46,2,821
"Lambeth","18:00:00","2018-09-28",1372,209,278,195,13,2067
"Waltham Forest","18:00:00","2018-09-28",1887,37,37,223,9,2193
"Bromley","07:00:00","2018-10-01",159,0,7,35,0,201
"Greenwich","07:00:00","2018-10-01",913,64,20,185,13,1195
"Hillingdon","07:00:00","2018-10-01",80,0,0,6,0,86
"Islington","07:00:00","2018-10-01",57,2,0,14,3,76
"Lambeth","07:00:00","2018-10-01",125,0,0,30,0,155
"Richmond upon Thames","07:00:00","2018-10-01",159,2,0,18,1,180
"Sutton","07:00:00","2018-10-01",109,0,0,6,0,115
"Westminster","07:00:00","2018-10-01",1084,113,92,592,113,1994
"Bromley","08:00:00","2018-10-01",205,1,7,38,0,251
"Greenwich","08:00:00","2018-10-01",1054,41,27,164,15,1301
"Hillingdon","08:00:00","2018-10-01",197,0,1,7,3,208
"Islington","08:00:00","2018-10-01",55,7,0,12,1,75
"Lambeth","08:00:00","2018-10-01",224,1,1,30,1,257
"Richmond upon Thames","08:00:00","2018-10-01",245,5,0,22,1,273
"Sutton","08:00:00","2018-10-01",145,0,0,9,0,154
"Westminster","08:00:00","2018-10-01",1086,108,85,447,80,1806
"Bromley","09:00:00","2018-10-01",122,0,6,19,0,147
"Greenwich","09:00:00","2018-10-01",939,19,34,135,11,1138
"Hillingdon","09:00:00","2018-10-01",40,0,0,9,3,52
"Islington","09:00:00","2018-10-01",61,1,0,13,2,77
"Lambeth","09:00:00","2018-10-01",82,0,2,18,0,102
"Richmond upon Thames","09:00:00","2018-10-01",136,6,0,22,0,164
"Sutton","09:00:00","2018-10-01",85,0,0,12,1,98
"Westminster","09:00:00","2018-10-01",1041,78,100,360,82,1661
"Bromley","10:00:00","2018-10-01",90,2,5,16,1,114
"Greenwich","10:00:00","2018-10-01",792,16,20,146,15,989
"Hillingdon","10:00:00","2018-10-01",28,0,0,3,1,32
"Islington","10:00:00","2018-10-01",36,2,0,15,2,55
"Lambeth","10:00:00","2018-10-01",71,6,0,16,0,93
"Richmond upon Thames","10:00:00","2018-10-01",92,0,0,21,0,113
"Sutton","10:00:00","2018-10-01",63,0,0,9,1,73
"Westminster","10:00:00","2018-10-01",975,52,127,405,75,1634
"Bromley","11:00:00","2018-10-01",87,0,6,14,1,108
"Greenwich","11:00:00","2018-10-01",707,18,24,165,17,931
"Hillingdon","11:00:00","2018-10-01",46,0,0,8,1,55
"Islington","11:00:00","2018-10-01",40,7,1,13,3,64
"Lambeth","11:00:00","2018-10-01",63,3,0,18,0,84
"Richmond upon Thames","11:00:00","2018-10-01",113,0,0,18,4,135
"Sutton","11:00:00","2018-10-01",55,0,0,14,1,70
"Westminster","11:00:00","2018-10-01",990,59,107,416,107,1679
"Bromley","12:00:00","2018-10-01",121,1,6,24,2,154
"Greenwich","12:00:00","2018-10-01",853,20,20,174,18,1085
"Hillingdon","12:00:00","2018-10-01",37,0,0,9,0,46
"Islington","12:00:00","2018-10-01",47,21,0,11,1,80
"Lambeth","12:00:00","2018-10-01",55,2,0,14,0,71
"Richmond upon Thames","12:00:00","2018-10-01",96,1,0,20,2,119
"Sutton","12:00:00","2018-10-01",64,1,0,7,0,72
"Westminster","12:00:00","2018-10-01",1049,59,97,370,74,1649
"Bromley","13:00:00","2018-10-01",73,0,7,17,1,98
"Greenwich","13:00:00","2018-10-01",863,16,27,123,18,1047
"Hillingdon","13:00:00","2018-10-01",36,0,0,6,1,43
"Islington","13:00:00","2018-10-01",52,18,0,12,3,85
"Lambeth","13:00:00","2018-10-01",65,3,1,15,1,85
"Richmond upon Thames","13:00:00","2018-10-01",90,4,0,22,0,116
"Sutton","13:00:00","2018-10-01",70,1,0,10,1,82
"Westminster","13:00:00","2018-10-01",1058,64,121,337,73,1653
"Bromley","14:00:00","2018-10-01",92,0,6,19,0,117
"Greenwich","14:00:00","2018-10-01",787,19,26,186,11,1029
"Hillingdon","14:00:00","2018-10-01",62,1,0,5,0,68
"Islington","14:00:00","2018-10-01",48,15,0,15,4,82
"Lambeth","14:00:00","2018-10-01",91,0,0,24,0,115
"Richmond upon Thames","14:00:00","2018-10-01",121,1,0,21,1,144
"Sutton","14:00:00","2018-10-01",82,3,0,10,1,96
"Westminster","14:00:00","2018-10-01",1196,84,103,437,76,1896
"Bromley","15:00:00","2018-10-01",142,3,8,25,0,178
"Greenwich","15:00:00","2018-10-01",1008,27,28,190,7,1260
"Hillingdon","15:00:00","2018-10-01",115,1,0,6,0,122
"Islington","15:00:00","2018-10-01",55,11,0,11,0,77
"Lambeth","15:00:00","2018-10-01",147,3,1,36,0,187
"Richmond upon Thames","15:00:00","2018-10-01",138,1,0,18,1,158
"Sutton","15:00:00","2018-10-01",124,0,0,11,0,135
"Westminster","15:00:00","2018-10-01",1231,73,110,418,75,1907
"Bromley","16:00:00","2018-10-01",162,2,5,35,0,204
"Greenwich","16:00:00","2018-10-01",1129,31,25,173,5,1363
"Hillingdon","16:00:00","2018-10-01",122,0,0,6,0,128
"Islington","16:00:00","2018-10-01",71,16,0,18,1,106
"Lambeth","16:00:00","2018-10-01",151,1,2,40,0,194
"Richmond upon Thames","16:00:00","2018-10-01",181,3,0,22,0,206
"Sutton","16:00:00","2018-10-01",93,2,0,12,0,107
"Westminster","16:00:00","2018-10-01",1340,120,105,381,36,1982
"Bromley","17:00:00","2018-10-01",160,3,7,22,0,192
"Greenwich","17:00:00","2018-10-01",998,59,22,135,7,1221
"Hillingdon","17:00:00","2018-10-01",89,0,0,5,0,94
"Islington","17:00:00","2018-10-01",91,19,0,14,3,127
"Lambeth","17:00:00","2018-10-01",201,7,0,47,0,255
"Richmond upon Thames","17:00:00","2018-10-01",189,3,0,13,0,205
"Sutton","17:00:00","2018-10-01",102,1,0,9,0,112
"Westminster","17:00:00","2018-10-01",1422,137,104,427,40,2130
"Bromley","18:00:00","2018-10-01",119,4,5,12,0,140
"Greenwich","18:00:00","2018-10-01",1087,61,28,111,2,1289
"Hillingdon","18:00:00","2018-10-01",46,0,0,2,0,48
"Islington","18:00:00","2018-10-01",84,19,1,13,0,117
"Lambeth","18:00:00","2018-10-01",158,10,0,31,0,199
"Richmond upon Thames","18:00:00","2018-10-01",161,1,0,13,0,175
"Sutton","18:00:00","2018-10-01",152,1,0,10,0,163
"Westminster","18:00:00","2018-10-01",1465,137,99,292,38,2031
"Croydon","07:00:00","2018-10-02",280,6,12,41,5,344
"Hackney","07:00:00","2018-10-02",29,3,0,18,1,51
"Hillingdon","07:00:00","2018-10-02",2011,28,3,319,252,2613
"Lambeth","07:00:00","2018-10-02",306,18,18,91,5,438
"Lewisham","07:00:00","2018-10-02",1074,52,42,347,28,1543
"Merton","07:00:00","2018-10-02",263,0,0,54,0,317
"Richmond upon Thames","07:00:00","2018-10-02",774,26,11,180,14,1005
"Sutton","07:00:00","2018-10-02",562,6,6,107,3,684
"Tower Hamlets","07:00:00","2018-10-02",436,26,40,249,10,761
"Waltham Forest","07:00:00","2018-10-02",509,5,23,122,5,664
"Croydon","08:00:00","2018-10-02",393,2,15,46,4,460
"Hackney","08:00:00","2018-10-02",50,3,0,25,5,83
"Hillingdon","08:00:00","2018-10-02",1972,21,14,248,211,2466
"Lambeth","08:00:00","2018-10-02",403,17,14,93,9,536
"Lewisham","08:00:00","2018-10-02",1162,58,39,274,41,1574
"Merton","08:00:00","2018-10-02",293,2,1,38,1,335
"Richmond upon Thames","08:00:00","2018-10-02",647,32,7,131,10,827
"Sutton","08:00:00","2018-10-02",798,6,3,75,2,884
"Tower Hamlets","08:00:00","2018-10-02",588,27,44,200,9,868
"Waltham Forest","08:00:00","2018-10-02",668,2,25,107,10,812
"Croydon","09:00:00","2018-10-02",293,7,21,61,9,391
"Hackney","09:00:00","2018-10-02",38,0,0,25,3,66
"Hillingdon","09:00:00","2018-10-02",1230,10,10,239,219,1708
"Lambeth","09:00:00","2018-10-02",333,17,14,85,7,456
"Lewisham","09:00:00","2018-10-02",976,26,45,285,30,1362
"Merton","09:00:00","2018-10-02",252,0,0,35,2,289
"Richmond upon Thames","09:00:00","2018-10-02",510,14,8,138,17,687
"Sutton","09:00:00","2018-10-02",448,5,4,49,3,509
"Tower Hamlets","09:00:00","2018-10-02",565,12,40,193,6,816
"Waltham Forest","09:00:00","2018-10-02",494,6,26,94,8,628
"Croydon","10:00:00","2018-10-02",231,5,14,48,8,306
"Hackney","10:00:00","2018-10-02",32,1,0,26,3,62
"Hillingdon","10:00:00","2018-10-02",702,8,3,223,246,1182
"Lambeth","10:00:00","2018-10-02",237,13,12,63,6,331
"Lewisham","10:00:00","2018-10-02",840,22,48,307,30,1247
"Merton","10:00:00","2018-10-02",156,3,0,26,0,185
"Richmond upon Thames","10:00:00","2018-10-02",367,13,4,127,21,532
"Sutton","10:00:00","2018-10-02",331,3,6,54,4,398
"Tower Hamlets","10:00:00","2018-10-02",465,13,41,169,1,689
"Waltham Forest","10:00:00","2018-10-02",413,14,27,77,7,538
"Croydon","11:00:00","2018-10-02",206,4,15,49,4,278
"Hackney","11:00:00","2018-10-02",45,4,0,25,4,78
"Hillingdon","11:00:00","2018-10-02",685,10,5,242,247,1189
"Lambeth","11:00:00","2018-10-02",169,6,8,54,6,243
"Lewisham","11:00:00","2018-10-02",785,18,44,235,27,1109
"Merton","11:00:00","2018-10-02",127,4,0,29,0,160
"Richmond upon Thames","11:00:00","2018-10-02",371,11,5,114,11,512
"Sutton","11:00:00","2018-10-02",328,2,5,58,2,395
"Tower Hamlets","11:00:00","2018-10-02",407,14,41,188,9,659
"Waltham Forest","11:00:00","2018-10-02",390,6,23,76,8,503
"Croydon","12:00:00","2018-10-02",217,9,16,43,15,300
"Hackney","12:00:00","2018-10-02",51,1,0,29,2,83
"Hillingdon","12:00:00","2018-10-02",809,5,1,247,234,1296
"Lambeth","12:00:00","2018-10-02",193,11,10,38,6,258
"Lewisham","12:00:00","2018-10-02",799,33,36,266,31,1165
"Merton","12:00:00","2018-10-02",118,15,1,38,0,172
"Richmond upon Thames","12:00:00","2018-10-02",366,17,5,99,17,504
"Sutton","12:00:00","2018-10-02",316,9,6,60,9,400
"Tower Hamlets","12:00:00","2018-10-02",403,25,36,197,14,675
"Waltham Forest","12:00:00","2018-10-02",413,10,23,92,4,542
"Croydon","13:00:00","2018-10-02",244,9,15,38,6,312
"Hackney","13:00:00","2018-10-02",37,2,0,22,4,65
"Hillingdon","13:00:00","2018-10-02",1014,13,4,214,203,1448
"Lambeth","13:00:00","2018-10-02",201,10,9,56,7,283
"Lewisham","13:00:00","2018-10-02",840,26,42,287,34,1229
"Merton","13:00:00","2018-10-02",109,8,0,34,1,152
"Richmond upon Thames","13:00:00","2018-10-02",377,15,8,117,9,526
"Sutton","13:00:00","2018-10-02",368,7,6,57,2,440
"Tower Hamlets","13:00:00","2018-10-02",417,22,42,184,4,669
"Waltham Forest","13:00:00","2018-10-02",427,5,22,84,4,542
"Croydon","14:00:00","2018-10-02",268,7,17,56,1,349
"Hackney","14:00:00","2018-10-02",56,2,0,26,4,88
"Hillingdon","14:00:00","2018-10-02",1036,10,4,243,198,1491
"Lambeth","14:00:00","2018-10-02",239,6,13,57,1,316
"Lewisham","14:00:00","2018-10-02",957,26,43,316,28,1370
"Merton","14:00:00","2018-10-02",160,13,0,24,0,197
"Richmond upon Thames","14:00:00","2018-10-02",426,10,11,117,19,583
"Sutton","14:00:00","2018-10-02",449,5,5,64,3,526
"Tower Hamlets","14:00:00","2018-10-02",431,22,37,203,6,699
"Waltham Forest","14:00:00","2018-10-02",456,13,23,85,12,589
"Croydon","15:00:00","2018-10-02",368,11,18,60,2,459
"Hackney","15:00:00","2018-10-02",55,2,0,18,1,76
"Hillingdon","15:00:00","2018-10-02",1102,15,7,276,248,1648
"Lambeth","15:00:00","2018-10-02",334,15,9,88,4,450
"Lewisham","15:00:00","2018-10-02",1092,29,49,306,28,1504
"Merton","15:00:00","2018-10-02",218,5,1,37,1,262
"Richmond upon Thames","15:00:00","2018-10-02",473,19,4,122,13,631
"Sutton","15:00:00","2018-10-02",492,12,6,67,1,578
"Tower Hamlets","15:00:00","2018-10-02",427,28,41,172,9,677
"Waltham Forest","15:00:00","2018-10-02",538,9,23,94,9,673
"Croydon","16:00:00","2018-10-02",387,9,18,56,2,472
"Hackney","16:00:00","2018-10-02",61,2,0,22,0,85
"Hillingdon","16:00:00","2018-10-02",1834,21,5,323,211,2394
"Lambeth","16:00:00","2018-10-02",312,19,17,94,2,444
"Lewisham","16:00:00","2018-10-02",1240,34,45,389,16,1724
"Merton","16:00:00","2018-10-02",255,7,0,44,0,306
"Richmond upon Thames","16:00:00","2018-10-02",643,23,13,124,13,816
"Sutton","16:00:00","2018-10-02",711,11,7,110,2,841
"Tower Hamlets","16:00:00","2018-10-02",466,30,48,174,4,722
"Waltham Forest","16:00:00","2018-10-02",578,10,24,89,3,704
"Croydon","17:00:00","2018-10-02",401,9,14,51,0,475
"Hackney","17:00:00","2018-10-02",56,6,0,16,1,79
"Hillingdon","17:00:00","2018-10-02",2077,22,9,257,194,2559
"Lambeth","17:00:00","2018-10-02",364,29,7,76,1,477
"Lewisham","17:00:00","2018-10-02",1377,64,43,318,13,1815
"Merton","17:00:00","2018-10-02",279,4,1,30,0,314
"Richmond upon Thames","17:00:00","2018-10-02",610,32,8,110,5,765
"Sutton","17:00:00","2018-10-02",598,11,4,68,0,681
"Tower Hamlets","17:00:00","2018-10-02",547,34,34,124,5,744
"Waltham Forest","17:00:00","2018-10-02",651,14,26,90,4,785
"Croydon","18:00:00","2018-10-02",321,9,17,36,1,384
"Hackney","18:00:00","2018-10-02",55,2,0,10,0,67
"Hillingdon","18:00:00","2018-10-02",1494,20,4,211,162,1891
"Lambeth","18:00:00","2018-10-02",388,49,10,51,0,498
"Lewisham","18:00:00","2018-10-02",1377,75,40,197,9,1698
"Merton","18:00:00","2018-10-02",213,12,0,24,0,249
"Richmond upon Thames","18:00:00","2018-10-02",703,35,5,71,7,821
"Sutton","18:00:00","2018-10-02",607,12,5,51,0,675
"Tower Hamlets","18:00:00","2018-10-02",454,23,44,70,3,594
"Waltham Forest","18:00:00","2018-10-02",589,6,21,69,1,686
"Bexley","07:00:00","2018-10-03",969,10,12,165,3,1159
"Greenwich","07:00:00","2018-10-03",3198,270,45,1195,345,5053
"Haringey","07:00:00","2018-10-03",12,0,0,1,0,13
"Havering","07:00:00","2018-10-03",45,0,0,8,3,56
"Redbridge","07:00:00","2018-10-03",178,0,2,30,5,215
"Richmond upon Thames","07:00:00","2018-10-03",258,3,7,64,6,338
"Sutton","07:00:00","2018-10-03",888,12,9,207,24,1140
"Wandsworth","07:00:00","2018-10-03",43,0,0,4,0,47
"Westminster","07:00:00","2018-10-03",97,17,21,49,10,194
"Bexley","08:00:00","2018-10-03",1045,8,13,142,5,1213
"Greenwich","08:00:00","2018-10-03",3375,230,39,883,403,4930
"Haringey","08:00:00","2018-10-03",13,2,0,4,1,20
"Havering","08:00:00","2018-10-03",75,0,0,6,0,81
"Redbridge","08:00:00","2018-10-03",286,4,0,29,1,320
"Richmond upon Thames","08:00:00","2018-10-03",350,5,4,63,9,431
"Sutton","08:00:00","2018-10-03",1015,6,9,174,27,1231
"Wandsworth","08:00:00","2018-10-03",54,5,0,11,1,71
"Westminster","08:00:00","2018-10-03",122,32,22,50,13,239
"Bexley","09:00:00","2018-10-03",768,12,12,141,2,935
"Greenwich","09:00:00","2018-10-03",3050,103,51,888,530,4622
"Haringey","09:00:00","2018-10-03",5,0,0,3,0,8
"Havering","09:00:00","2018-10-03",38,0,0,7,0,45
"Redbridge","09:00:00","2018-10-03",229,1,1,25,3,259
"Richmond upon Thames","09:00:00","2018-10-03",226,3,10,41,4,284
"Sutton","09:00:00","2018-10-03",768,10,14,190,29,1011
"Wandsworth","09:00:00","2018-10-03",42,0,0,7,0,49
"Westminster","09:00:00","2018-10-03",161,35,20,67,10,293
"Bexley","10:00:00","2018-10-03",736,16,18,160,5,935
"Greenwich","10:00:00","2018-10-03",2390,49,32,734,471,3676
"Haringey","10:00:00","2018-10-03",7,0,0,2,0,9
"Havering","10:00:00","2018-10-03",45,0,0,4,0,49
"Redbridge","10:00:00","2018-10-03",203,0,1,26,6,236
"Richmond upon Thames","10:00:00","2018-10-03",182,2,8,54,3,249
"Sutton","10:00:00","2018-10-03",637,6,9,163,31,846
"Wandsworth","10:00:00","2018-10-03",37,0,0,8,1,46
"Westminster","10:00:00","2018-10-03",182,24,22,78,20,326
"Bexley","11:00:00","2018-10-03",736,17,15,143,0,911
"Greenwich","11:00:00","2018-10-03",2491,49,8,859,460,3867
"Haringey","11:00:00","2018-10-03",6,0,0,2,0,8
"Havering","11:00:00","2018-10-03",52,0,0,7,1,60
"Redbridge","11:00:00","2018-10-03",131,0,0,28,2,161
"Richmond upon Thames","11:00:00","2018-10-03",191,3,6,46,9,255
"Sutton","11:00:00","2018-10-03",740,4,4,155,33,936
"Wandsworth","11:00:00","2018-10-03",40,1,0,12,0,53
"Westminster","11:00:00","2018-10-03",190,44,18,79,14,345
"Bexley","12:00:00","2018-10-03",756,18,11,156,3,944
"Greenwich","12:00:00","2018-10-03",2592,33,12,848,513,3998
"Haringey","12:00:00","2018-10-03",7,0,0,7,0,14
"Havering","12:00:00","2018-10-03",48,0,0,9,2,59
"Redbridge","12:00:00","2018-10-03",178,5,1,31,1,216
"Richmond upon Thames","12:00:00","2018-10-03",167,6,9,38,7,227
"Sutton","12:00:00","2018-10-03",871,11,8,171,34,1095
"Wandsworth","12:00:00","2018-10-03",39,0,0,13,0,52
"Westminster","12:00:00","2018-10-03",212,43,16,72,14,357
"Bexley","13:00:00","2018-10-03",835,13,9,144,6,1007
"Greenwich","13:00:00","2018-10-03",2712,51,16,967,497,4243
"Haringey","13:00:00","2018-10-03",8,0,0,3,0,11
"Havering","13:00:00","2018-10-03",40,0,0,10,1,51
"Redbridge","13:00:00","2018-10-03",178,6,1,31,4,220
"Richmond upon Thames","13:00:00","2018-10-03",206,5,8,42,2,263
"Sutton","13:00:00","2018-10-03",761,14,10,170,35,990
"Wandsworth","13:00:00","2018-10-03",38,1,0,10,0,49
"Westminster","13:00:00","2018-10-03",229,58,25,54,23,389
"Bexley","14:00:00","2018-10-03",736,16,13,130,2,897
"Greenwich","14:00:00","2018-10-03",3048,54,22,1058,424,4606
"Haringey","14:00:00","2018-10-03",9,0,0,3,0,12
"Havering","14:00:00","2018-10-03",41,0,0,10,0,51
"Redbridge","14:00:00","2018-10-03",202,4,2,34,1,243
"Richmond upon Thames","14:00:00","2018-10-03",215,5,5,47,5,277
"Sutton","14:00:00","2018-10-03",827,3,13,187,42,1072
"Wandsworth","14:00:00","2018-10-03",35,0,0,13,0,48
"Westminster","14:00:00","2018-10-03",228,44,22,64,15,373
"Bexley","15:00:00","2018-10-03",778,13,13,121,1,926
"Greenwich","15:00:00","2018-10-03",3324,91,19,1311,345,5090
"Haringey","15:00:00","2018-10-03",8,0,0,0,0,8
"Havering","15:00:00","2018-10-03",61,0,1,8,0,70
"Redbridge","15:00:00","2018-10-03",247,4,3,23,2,279
"Richmond upon Thames","15:00:00","2018-10-03",324,5,9,44,2,384
"Sutton","15:00:00","2018-10-03",943,10,15,183,26,1177
"Wandsworth","15:00:00","2018-10-03",32,4,0,5,1,42
"Westminster","15:00:00","2018-10-03",264,31,24,47,5,371
"Bexley","16:00:00","2018-10-03",863,12,11,151,2,1039
"Greenwich","16:00:00","2018-10-03",3555,196,34,1184,260,5229
"Haringey","16:00:00","2018-10-03",8,0,0,0,0,8
"Havering","16:00:00","2018-10-03",58,0,1,6,0,65
"Redbridge","16:00:00","2018-10-03",251,2,2,20,1,276
"Richmond upon Thames","16:00:00","2018-10-03",296,3,8,46,1,354
"Sutton","16:00:00","2018-10-03",922,19,12,208,8,1169
"Wandsworth","16:00:00","2018-10-03",45,0,1,8,0,54
"Westminster","16:00:00","2018-10-03",256,28,20,47,4,355
"Bexley","17:00:00","2018-10-03",839,25,11,117,1,993
"Greenwich","17:00:00","2018-10-03",3719,245,37,838,129,4968
"Haringey","17:00:00","2018-10-03",14,1,0,2,0,17
"Havering","17:00:00","2018-10-03",74,0,0,8,0,82
"Redbridge","17:00:00","2018-10-03",275,2,0,25,0,302
"Richmond upon Thames","17:00:00","2018-10-03",303,15,7,36,1,362
"Sutton","17:00:00","2018-10-03",1120,28,8,165,7,1328
"Wandsworth","17:00:00","2018-10-03",72,2,0,7,0,81
"Westminster","17:00:00","2018-10-03",252,48,22,28,2,352
"Bexley","18:00:00","2018-10-03",622,13,10,65,0,710
"Greenwich","18:00:00","2018-10-03",3889,267,47,687,137,5027
"Haringey","18:00:00","2018-10-03",14,0,0,1,0,15
"Havering","18:00:00","2018-10-03",63,1,0,9,0,73
"Redbridge","18:00:00","2018-10-03",302,6,1,22,0,331
"Richmond upon Thames","18:00:00","2018-10-03",345,9,7,51,0,412
"Sutton","18:00:00","2018-10-03",1123,10,10,153,6,1302
"Wandsworth","18:00:00","2018-10-03",51,6,0,7,0,64
"Westminster","18:00:00","2018-10-03",253,68,19,30,7,377
"Brent","07:00:00","2018-10-04",4733,187,14,1639,568,7141
"Bromley","07:00:00","2018-10-04",89,0,0,10,0,99
"Camden","07:00:00","2018-10-04",195,5,4,66,12,282
"Hammersmith and Fulham","07:00:00","2018-10-04",332,18,66,93,10,519
"Havering","07:00:00","2018-10-04",825,8,13,198,19,1063
"Hounslow","07:00:00","2018-10-04",65,1,2,8,1,77
"Lambeth","07:00:00","2018-10-04",107,1,0,22,1,131
"Merton","07:00:00","2018-10-04",400,7,9,82,4,502
"Richmond upon Thames","07:00:00","2018-10-04",88,1,1,17,2,109
"Sutton","07:00:00","2018-10-04",339,2,0,79,0,420
"Tower Hamlets","07:00:00","2018-10-04",346,22,23,91,13,495
"Wandsworth","07:00:00","2018-10-04",37,1,0,8,1,47
"Westminster","07:00:00","2018-10-04",267,97,22,197,15,598
"Brent","08:00:00","2018-10-04",4888,157,24,1258,565,6892
"Bromley","08:00:00","2018-10-04",124,1,0,16,1,142
"Camden","08:00:00","2018-10-04",263,5,8,80,13,369
"Hammersmith and Fulham","08:00:00","2018-10-04",489,24,71,89,8,681
"Havering","08:00:00","2018-10-04",1009,3,13,140,7,1172
"Hounslow","08:00:00","2018-10-04",98,0,3,20,0,121
"Lambeth","08:00:00","2018-10-04",125,1,1,18,0,145
"Merton","08:00:00","2018-10-04",550,6,5,91,10,662
"Richmond upon Thames","08:00:00","2018-10-04",110,1,3,20,3,137
"Sutton","08:00:00","2018-10-04",386,3,0,59,2,450
"Tower Hamlets","08:00:00","2018-10-04",551,24,15,93,35,718
"Wandsworth","08:00:00","2018-10-04",72,1,0,15,1,89
"Westminster","08:00:00","2018-10-04",334,157,25,155,20,691
"Brent","09:00:00","2018-10-04",4475,109,11,1359,708,6662
"Bromley","09:00:00","2018-10-04",119,0,0,21,0,140
"Camden","09:00:00","2018-10-04",215,12,7,106,13,353
"Hammersmith and Fulham","09:00:00","2018-10-04",439,18,68,102,13,640
"Havering","09:00:00","2018-10-04",720,3,16,140,8,887
"Hounslow","09:00:00","2018-10-04",90,0,3,17,0,110
"Lambeth","09:00:00","2018-10-04",86,1,0,9,0,96
"Merton","09:00:00","2018-10-04",239,0,10,49,7,305
"Richmond upon Thames","09:00:00","2018-10-04",95,1,1,11,3,111
"Sutton","09:00:00","2018-10-04",321,3,0,60,9,393
"Tower Hamlets","09:00:00","2018-10-04",475,20,15,133,45,688
"Wandsworth","09:00:00","2018-10-04",82,0,0,17,1,100
"Westminster","09:00:00","2018-10-04",334,88,20,152,17,611
"Brent","10:00:00","2018-10-04",4176,81,11,1400,740,6408
"Bromley","10:00:00","2018-10-04",88,0,0,17,2,107
"Camden","10:00:00","2018-10-04",226,10,5,139,13,393
"Hammersmith and Fulham","10:00:00","2018-10-04",441,24,78,144,11,698
"Havering","10:00:00","2018-10-04",682,3,8,149,11,853
"Hounslow","10:00:00","2018-10-04",59,0,1,5,2,67
"Lambeth","10:00:00","2018-10-04",67,1,0,17,1,86
"Merton","10:00:00","2018-10-04",165,2,7,43,9,226
"Richmond upon Thames","10:00:00","2018-10-04",57,1,0,20,2,80
"Sutton","10:00:00","2018-10-04",284,0,0,51,5,340
"Tower Hamlets","10:00:00","2018-10-04",436,27,18,151,28,660
"Wandsworth","10:00:00","2018-10-04",45,2,0,16,1,64
"Westminster","10:00:00","2018-10-04",357,42,9,126,25,559
"Brent","11:00:00","2018-10-04",3977,91,19,1313,770,6170
"Bromley","11:00:00","2018-10-04",71,0,0,16,0,87
"Camden","11:00:00","2018-10-04",285,12,6,130,16,449
"Hammersmith and Fulham","11:00:00","2018-10-04",455,23,68,129,9,684
"Havering","11:00:00","2018-10-04",712,6,8,126,15,867
"Hounslow","11:00:00","2018-10-04",52,0,3,15,2,72
"Lambeth","11:00:00","2018-10-04",66,5,0,6,1,78
"Merton","11:00:00","2018-10-04",182,2,5,36,9,234
"Richmond upon Thames","11:00:00","2018-10-04",52,0,0,20,2,74
"Sutton","11:00:00","2018-10-04",207,2,0,46,5,260
"Tower Hamlets","11:00:00","2018-10-04",373,29,13,139,31,585
"Wandsworth","11:00:00","2018-10-04",34,3,0,10,1,48
"Westminster","11:00:00","2018-10-04",319,33,5,122,13,492
"Brent","12:00:00","2018-10-04",4178,80,4,1375,702,6339
"Bromley","12:00:00","2018-10-04",102,0,0,12,2,116
"Camden","12:00:00","2018-10-04",284,19,5,138,21,467
"Hammersmith and Fulham","12:00:00","2018-10-04",450,40,71,130,8,699
"Havering","12:00:00","2018-10-04",720,6,10,138,15,889
"Hounslow","12:00:00","2018-10-04",63,0,2,12,1,78
"Lambeth","12:00:00","2018-10-04",75,1,0,14,0,90
"Merton","12:00:00","2018-10-04",169,2,5,34,12,222
"Richmond upon Thames","12:00:00","2018-10-04",64,1,1,14,1,81
"Sutton","12:00:00","2018-10-04",239,3,0,48,2,292
"Tower Hamlets","12:00:00","2018-10-04",374,41,12,127,24,578
"Wandsworth","12:00:00","2018-10-04",56,3,0,16,0,75
"Westminster","12:00:00","2018-10-04",348,34,6,79,15,482
"Brent","13:00:00","2018-10-04",4133,84,7,1401,695,6320
"Bromley","13:00:00","2018-10-04",73,1,0,9,2,85
"Camden","13:00:00","2018-10-04",299,16,2,105,6,428
"Hammersmith and Fulham","13:00:00","2018-10-04",453,28,76,166,18,741
"Havering","13:00:00","2018-10-04",703,9,9,147,14,882
"Hounslow","13:00:00","2018-10-04",69,0,3,12,2,86
"Lambeth","13:00:00","2018-10-04",68,4,0,13,0,85
"Merton","13:00:00","2018-10-04",245,2,5,61,7,320
"Richmond upon Thames","13:00:00","2018-10-04",56,0,0,11,0,67
"Sutton","13:00:00","2018-10-04",230,1,0,52,4,287
"Tower Hamlets","13:00:00","2018-10-04",442,50,14,126,22,654
"Wandsworth","13:00:00","2018-10-04",35,4,0,8,0,47
"Westminster","13:00:00","2018-10-04",351,36,5,118,21,531
"Brent","14:00:00","2018-10-04",4539,98,15,1343,634,6629
"Bromley","14:00:00","2018-10-04",88,0,0,9,2,99
"Camden","14:00:00","2018-10-04",327,17,8,80,12,444
"Hammersmith and Fulham","14:00:00","2018-10-04",480,28,72,199,12,791
"Havering","14:00:00","2018-10-04",815,4,14,151,11,995
"Hounslow","14:00:00","2018-10-04",57,0,2,14,3,76
"Lambeth","14:00:00","2018-10-04",65,0,0,17,0,82
"Merton","14:00:00","2018-10-04",239,12,9,45,10,315
"Richmond upon Thames","14:00:00","2018-10-04",65,2,0,17,1,85
"Sutton","14:00:00","2018-10-04",253,4,1,63,8,329
"Tower Hamlets","14:00:00","2018-10-04",464,33,10,105,16,628
"Wandsworth","14:00:00","2018-10-04",51,3,0,5,1,60
"Westminster","14:00:00","2018-10-04",317,30,6,125,16,494
"Brent","15:00:00","2018-10-04",4967,153,11,1508,644,7283
"Bromley","15:00:00","2018-10-04",80,0,0,12,0,92
"Camden","15:00:00","2018-10-04",308,22,9,131,14,484
"Hammersmith and Fulham","15:00:00","2018-10-04",478,23,77,170,16,764
"Havering","15:00:00","2018-10-04",927,1,21,164,11,1124
"Hounslow","15:00:00","2018-10-04",98,1,2,8,0,109
"Lambeth","15:00:00","2018-10-04",121,1,0,13,0,135
"Merton","15:00:00","2018-10-04",292,6,9,56,7,370
"Richmond upon Thames","15:00:00","2018-10-04",91,0,3,15,0,109
"Sutton","15:00:00","2018-10-04",303,7,1,71,3,385
"Tower Hamlets","15:00:00","2018-10-04",512,29,11,113,6,671
"Wandsworth","15:00:00","2018-10-04",98,3,0,13,0,114
"Westminster","15:00:00","2018-10-04",369,37,8,110,11,535
"Brent","16:00:00","2018-10-04",5716,182,21,1489,503,7911
"Bromley","16:00:00","2018-10-04",115,2,0,14,0,131
"Camden","16:00:00","2018-10-04",348,34,4,81,10,477
"Hammersmith and Fulham","16:00:00","2018-10-04",524,44,79,187,11,845
"Havering","16:00:00","2018-10-04",1019,6,13,203,7,1248
"Hounslow","16:00:00","2018-10-04",103,0,2,25,1,131
"Lambeth","16:00:00","2018-10-04",123,6,0,19,1,149
"Merton","16:00:00","2018-10-04",369,11,11,77,5,473
"Richmond upon Thames","16:00:00","2018-10-04",161,1,1,22,1,186
"Sutton","16:00:00","2018-10-04",332,5,1,73,2,413
"Tower Hamlets","16:00:00","2018-10-04",559,36,22,99,12,728
"Wandsworth","16:00:00","2018-10-04",74,4,0,7,0,85
"Westminster","16:00:00","2018-10-04",360,49,20,95,8,532
"Brent","17:00:00","2018-10-04",5215,195,8,1079,249,6746
"Bromley","17:00:00","2018-10-04",97,1,0,11,0,109
"Camden","17:00:00","2018-10-04",453,52,7,65,5,582
"Hammersmith and Fulham","17:00:00","2018-10-04",551,45,65,148,5,814
"Havering","17:00:00","2018-10-04",1153,12,10,179,5,1359
"Hounslow","17:00:00","2018-10-04",126,0,2,20,0,148
"Lambeth","17:00:00","2018-10-04",131,0,0,19,0,150
"Merton","17:00:00","2018-10-04",374,12,6,80,4,476
"Richmond upon Thames","17:00:00","2018-10-04",203,5,0,26,0,234
"Sutton","17:00:00","2018-10-04",396,7,0,52,0,455
"Tower Hamlets","17:00:00","2018-10-04",661,40,16,78,4,799
"Wandsworth","17:00:00","2018-10-04",113,7,0,9,0,129
"Westminster","17:00:00","2018-10-04",357,59,22,87,8,533
"Brent","18:00:00","2018-10-04",5273,173,7,793,178,6424
"Bromley","18:00:00","2018-10-04",86,0,0,5,0,91
"Camden","18:00:00","2018-10-04",282,37,6,42,6,373
"Hammersmith and Fulham","18:00:00","2018-10-04",589,45,76,97,3,810
"Havering","18:00:00","2018-10-04",1071,11,6,127,0,1215
"Hounslow","18:00:00","2018-10-04",134,0,2,22,0,158
"Lambeth","18:00:00","2018-10-04",94,1,0,14,0,109
"Merton","18:00:00","2018-10-04",327,18,6,52,2,405
"Richmond upon Thames","18:00:00","2018-10-04",152,1,0,19,0,172
"Sutton","18:00:00","2018-10-04",396,13,0,50,0,459
"Tower Hamlets","18:00:00","2018-10-04",658,70,17,47,5,797
"Wandsworth","18:00:00","2018-10-04",95,9,0,10,1,115
"Westminster","18:00:00","2018-10-04",430,55,19,68,11,583
"Bexley","07:00:00","2018-10-05",255,2,1,52,6,316
"Brent","07:00:00","2018-10-05",399,30,50,166,35,680
"Greenwich","07:00:00","2018-10-05",791,41,35,235,52,1154
"Islington","07:00:00","2018-10-05",466,43,74,250,58,891
"Lambeth","07:00:00","2018-10-05",24,0,0,5,0,29
"Lewisham","07:00:00","2018-10-05",1468,135,44,662,158,2467
"Newham","07:00:00","2018-10-05",35,0,2,21,6,64
"Redbridge","07:00:00","2018-10-05",457,4,16,74,11,562
"Richmond upon Thames","07:00:00","2018-10-05",84,0,0,13,0,97
"Southwark","07:00:00","2018-10-05",258,5,2,128,7,400
"Sutton","07:00:00","2018-10-05",235,5,4,42,2,288
"Bexley","08:00:00","2018-10-05",524,3,3,76,4,610
"Brent","08:00:00","2018-10-05",554,29,61,138,24,806
"Greenwich","08:00:00","2018-10-05",859,20,42,184,55,1160
"Islington","08:00:00","2018-10-05",427,44,61,222,34,788
"Lambeth","08:00:00","2018-10-05",26,0,0,3,0,29
"Lewisham","08:00:00","2018-10-05",1616,133,55,553,184,2541
"Newham","08:00:00","2018-10-05",32,2,0,19,8,61
"Redbridge","08:00:00","2018-10-05",719,4,16,74,7,820
"Richmond upon Thames","08:00:00","2018-10-05",208,1,0,24,0,233
"Southwark","08:00:00","2018-10-05",285,7,1,81,7,381
"Sutton","08:00:00","2018-10-05",360,3,3,42,1,409
"Bexley","09:00:00","2018-10-05",321,2,5,57,8,393
"Brent","09:00:00","2018-10-05",494,23,54,147,31,749
"Greenwich","09:00:00","2018-10-05",869,18,48,213,51,1199
"Islington","09:00:00","2018-10-05",469,34,67,215,40,825
"Lambeth","09:00:00","2018-10-05",33,1,0,10,0,44
"Lewisham","09:00:00","2018-10-05",1560,74,70,565,193,2462
"Newham","09:00:00","2018-10-05",30,0,3,15,5,53
"Redbridge","09:00:00","2018-10-05",534,1,15,83,7,640
"Richmond upon Thames","09:00:00","2018-10-05",155,3,4,11,2,175
"Southwark","09:00:00","2018-10-05",184,5,8,40,5,242
"Sutton","09:00:00","2018-10-05",224,2,7,37,2,272
"Bexley","10:00:00","2018-10-05",295,1,1,58,7,362
"Brent","10:00:00","2018-10-05",474,29,53,150,30,736
"Greenwich","10:00:00","2018-10-05",814,19,45,261,73,1212
"Islington","10:00:00","2018-10-05",450,37,49,236,52,824
"Lambeth","10:00:00","2018-10-05",15,0,0,6,0,21
"Lewisham","10:00:00","2018-10-05",1492,71,62,605,191,2421
"Newham","10:00:00","2018-10-05",38,0,1,28,5,72
"Redbridge","10:00:00","2018-10-05",491,5,13,79,7,595
"Richmond upon Thames","10:00:00","2018-10-05",118,1,2,21,4,146
"Southwark","10:00:00","2018-10-05",149,0,3,34,10,196
"Sutton","10:00:00","2018-10-05",196,0,4,28,0,228
"Bexley","11:00:00","2018-10-05",348,2,2,62,9,423
"Brent","11:00:00","2018-10-05",510,37,53,133,23,756
"Greenwich","11:00:00","2018-10-05",756,28,50,220,43,1097
"Islington","11:00:00","2018-10-05",415,45,47,211,36,754
"Lambeth","11:00:00","2018-10-05",26,0,0,8,0,34
"Lewisham","11:00:00","2018-10-05",1407,52,71,583,199,2312
"Newham","11:00:00","2018-10-05",36,3,3,19,8,69
"Redbridge","11:00:00","2018-10-05",476,2,13,91,7,589
"Richmond upon Thames","11:00:00","2018-10-05",132,3,4,14,5,158
"Southwark","11:00:00","2018-10-05",198,4,1,46,2,251
"Sutton","11:00:00","2018-10-05",195,6,4,32,2,239
"Bexley","12:00:00","2018-10-05",310,4,1,55,9,379
"Brent","12:00:00","2018-10-05",511,54,56,121,17,759
"Greenwich","12:00:00","2018-10-05",942,26,42,197,58,1265
"Islington","12:00:00","2018-10-05",413,45,60,203,52,773
"Lambeth","12:00:00","2018-10-05",41,2,0,9,0,52
"Lewisham","12:00:00","2018-10-05",1587,71,52,512,172,2394
"Newham","12:00:00","2018-10-05",42,1,1,19,4,67
"Redbridge","12:00:00","2018-10-05",480,2,11,91,13,597
"Richmond upon Thames","12:00:00","2018-10-05",142,2,2,17,4,167
"Southwark","12:00:00","2018-10-05",176,6,5,35,10,232
"Sutton","12:00:00","2018-10-05",197,3,3,37,1,241
"Bexley","13:00:00","2018-10-05",296,1,1,52,4,354
"Brent","13:00:00","2018-10-05",517,55,47,120,19,758
"Greenwich","13:00:00","2018-10-05",1007,32,43,208,57,1347
"Islington","13:00:00","2018-10-05",429,30,51,174,47,731
"Lambeth","13:00:00","2018-10-05",42,1,0,6,0,49
"Lewisham","13:00:00","2018-10-05",1638,69,73,578,228,2586
"Newham","13:00:00","2018-10-05",31,1,0,16,9,57
"Redbridge","13:00:00","2018-10-05",483,3,12,78,10,586
"Richmond upon Thames","13:00:00","2018-10-05",149,3,3,14,2,171
"Southwark","13:00:00","2018-10-05",144,4,1,30,10,189
"Sutton","13:00:00","2018-10-05",223,0,7,28,0,258
"Bexley","14:00:00","2018-10-05",316,2,1,58,3,380
"Brent","14:00:00","2018-10-05",574,65,50,140,16,845
"Greenwich","14:00:00","2018-10-05",941,32,46,194,54,1267
"Islington","14:00:00","2018-10-05",400,34,51,184,27,696
"Lambeth","14:00:00","2018-10-05",25,6,0,3,0,34
"Lewisham","14:00:00","2018-10-05",1671,59,66,577,165,2538
"Newham","14:00:00","2018-10-05",45,0,0,18,1,64
"Redbridge","14:00:00","2018-10-05",528,6,13,66,12,625
"Richmond upon Thames","14:00:00","2018-10-05",151,3,3,19,0,176
"Southwark","14:00:00","2018-10-05",231,9,0,68,6,314
"Sutton","14:00:00","2018-10-05",237,5,4,43,1,290
"Bexley","15:00:00","2018-10-05",421,5,3,74,4,507
"Brent","15:00:00","2018-10-05",610,51,53,97,18,829
"Greenwich","15:00:00","2018-10-05",1053,31,39,173,46,1342
"Islington","15:00:00","2018-10-05",471,43,54,165,23,756
"Lambeth","15:00:00","2018-10-05",21,1,0,3,0,25
"Lewisham","15:00:00","2018-10-05",1896,91,58,590,111,2746
"Newham","15:00:00","2018-10-05",36,1,5,27,6,75
"Redbridge","15:00:00","2018-10-05",625,7,15,93,8,748
"Richmond upon Thames","15:00:00","2018-10-05",155,2,7,11,0,175
"Southwark","15:00:00","2018-10-05",300,3,2,106,4,415
"Sutton","15:00:00","2018-10-05",268,1,9,33,0,311
"Bexley","16:00:00","2018-10-05",446,3,2,77,4,532
"Brent","16:00:00","2018-10-05",608,61,54,123,6,852
"Greenwich","16:00:00","2018-10-05",1114,46,47,197,37,1441
"Islington","16:00:00","2018-10-05",495,54,71,142,9,771
"Lambeth","16:00:00","2018-10-05",34,1,0,9,0,44
"Newham","16:00:00","2018-10-05",35,2,3,19,3,62
"Redbridge","16:00:00","2018-10-05",669,6,13,94,5,787
"Richmond upon Thames","16:00:00","2018-10-05",206,4,0,21,0,231
"Southwark","16:00:00","2018-10-05",209,7,1,49,4,270
"Sutton","16:00:00","2018-10-05",350,2,3,40,0,395
"Bexley","17:00:00","2018-10-05",355,3,2,57,3,420
"Brent","17:00:00","2018-10-05",633,73,54,101,2,863
"Greenwich","17:00:00","2018-10-05",1339,35,38,168,35,1615
"Islington","17:00:00","2018-10-05",534,78,45,134,7,798
"Lambeth","17:00:00","2018-10-05",27,1,0,3,0,31
"Newham","17:00:00","2018-10-05",41,1,0,10,1,53
"Redbridge","17:00:00","2018-10-05",678,6,13,75,1,773
"Richmond upon Thames","17:00:00","2018-10-05",247,1,0,25,0,273
"Southwark","17:00:00","2018-10-05",361,13,0,67,1,442
"Sutton","17:00:00","2018-10-05",389,5,4,40,0,438
"Bexley","18:00:00","2018-10-05",354,5,1,50,0,410
"Brent","18:00:00","2018-10-05",648,80,47,99,4,878
"Greenwich","18:00:00","2018-10-05",1327,34,38,141,23,1563
"Islington","18:00:00","2018-10-05",602,94,61,104,7,868
"Lambeth","18:00:00","2018-10-05",36,3,0,7,0,46
"Lewisham","18:00:00","2018-10-05",1932,131,66,433,50,2612
"Newham","18:00:00","2018-10-05",50,2,0,11,0,63
"Redbridge","18:00:00","2018-10-05",695,10,12,72,1,790
"Richmond upon Thames","18:00:00","2018-10-05",173,3,0,9,0,185
"Southwark","18:00:00","2018-10-05",336,7,1,45,1,390
"Sutton","18:00:00","2018-10-05",347,11,3,35,0,396
"Barnet","07:00:00","2018-10-08",975,16,18,188,15,1212
"Camden","07:00:00","2018-10-08",18,3,0,14,2,37
"Enfield","07:00:00","2018-10-08",449,0,19,68,2,538
"Greenwich","07:00:00","2018-10-08",266,3,10,42,8,329
"Hammersmith and Fulham","07:00:00","2018-10-08",21,1,0,3,0,25
"Harrow","07:00:00","2018-10-08",9,0,0,2,0,11
"Merton","07:00:00","2018-10-08",424,11,0,75,0,510
"Richmond upon Thames","07:00:00","2018-10-08",2426,81,35,459,37,3038
"Waltham Forest","07:00:00","2018-10-08",273,0,6,48,6,333
"Barnet","08:00:00","2018-10-08",1401,12,17,145,10,1585
"Camden","08:00:00","2018-10-08",22,2,1,10,2,37
"Enfield","08:00:00","2018-10-08",750,4,8,85,6,853
"Greenwich","08:00:00","2018-10-08",365,1,13,45,2,426
"Hammersmith and Fulham","08:00:00","2018-10-08",35,2,0,7,0,44
"Harrow","08:00:00","2018-10-08",8,0,0,4,2,14
"Merton","08:00:00","2018-10-08",503,13,0,73,0,589
"Richmond upon Thames","08:00:00","2018-10-08",2118,77,30,335,47,2607
"Waltham Forest","08:00:00","2018-10-08",377,0,5,64,2,448
"Barnet","09:00:00","2018-10-08",983,7,20,122,28,1160
"Camden","09:00:00","2018-10-08",24,1,0,11,2,38
"Enfield","09:00:00","2018-10-08",560,9,12,82,6,669
"Greenwich","09:00:00","2018-10-08",207,0,16,34,4,261
"Hammersmith and Fulham","09:00:00","2018-10-08",27,4,0,4,0,35
"Harrow","09:00:00","2018-10-08",5,0,0,1,0,6
"Merton","09:00:00","2018-10-08",435,7,0,82,2,526
"Richmond upon Thames","09:00:00","2018-10-08",1651,39,37,371,58,2156
"Waltham Forest","09:00:00","2018-10-08",218,2,7,43,1,271
"Barnet","10:00:00","2018-10-08",743,11,13,119,16,902
"Camden","10:00:00","2018-10-08",23,0,0,10,5,38
"Enfield","10:00:00","2018-10-08",369,0,13,63,7,452
"Greenwich","10:00:00","2018-10-08",173,0,13,40,6,232
"Hammersmith and Fulham","10:00:00","2018-10-08",25,0,0,6,0,31
"Harrow","10:00:00","2018-10-08",6,0,0,4,1,11
"Merton","10:00:00","2018-10-08",360,4,0,97,0,461
"Richmond upon Thames","10:00:00","2018-10-08",1231,21,22,341,50,1665
"Waltham Forest","10:00:00","2018-10-08",200,2,5,35,4,246
"Barnet","11:00:00","2018-10-08",761,8,10,122,16,917
"Camden","11:00:00","2018-10-08",31,9,0,14,4,58
"Enfield","11:00:00","2018-10-08",349,3,9,69,4,434
"Greenwich","11:00:00","2018-10-08",236,0,15,27,0,278
"Hammersmith and Fulham","11:00:00","2018-10-08",20,1,0,8,0,29
"Harrow","11:00:00","2018-10-08",12,0,0,3,0,15
"Merton","11:00:00","2018-10-08",359,10,0,77,2,448
"Richmond upon Thames","11:00:00","2018-10-08",1161,30,27,308,61,1587
"Waltham Forest","11:00:00","2018-10-08",219,0,3,33,3,258
"Barnet","12:00:00","2018-10-08",876,12,11,121,16,1036
"Camden","12:00:00","2018-10-08",27,0,0,10,2,39
"Enfield","12:00:00","2018-10-08",392,4,10,62,3,471
"Greenwich","12:00:00","2018-10-08",266,1,12,48,7,334
"Hammersmith and Fulham","12:00:00","2018-10-08",15,0,0,10,0,25
"Harrow","12:00:00","2018-10-08",7,0,0,1,0,8
"Merton","12:00:00","2018-10-08",374,9,0,87,2,472
"Richmond upon Thames","12:00:00","2018-10-08",1320,33,28,303,55,1739
"Waltham Forest","12:00:00","2018-10-08",206,1,4,33,1,245
"Barnet","13:00:00","2018-10-08",848,9,11,104,21,993
"Camden","13:00:00","2018-10-08",39,4,0,17,0,60
"Enfield","13:00:00","2018-10-08",402,6,11,98,4,521
"Greenwich","13:00:00","2018-10-08",242,2,13,45,0,302
"Hammersmith and Fulham","13:00:00","2018-10-08",22,2,0,3,0,27
"Harrow","13:00:00","2018-10-08",9,0,0,3,0,12
"Merton","13:00:00","2018-10-08",382,7,0,71,1,461
"Richmond upon Thames","13:00:00","2018-10-08",1217,23,27,295,51,1613
"Waltham Forest","13:00:00","2018-10-08",234,3,7,32,4,280
"Barnet","14:00:00","2018-10-08",963,14,15,121,22,1135
"Camden","14:00:00","2018-10-08",35,8,1,10,1,55
"Enfield","14:00:00","2018-10-08",429,5,8,63,0,505
"Greenwich","14:00:00","2018-10-08",264,2,16,45,1,328
"Hammersmith and Fulham","14:00:00","2018-10-08",23,0,0,10,0,33
"Harrow","14:00:00","2018-10-08",8,0,0,2,0,10
"Merton","14:00:00","2018-10-08",445,13,1,90,0,549
"Richmond upon Thames","14:00:00","2018-10-08",1320,27,30,337,53,1767
"Waltham Forest","14:00:00","2018-10-08",226,2,7,30,1,266
"Barnet","15:00:00","2018-10-08",1243,13,17,121,20,1414
"Camden","15:00:00","2018-10-08",46,8,2,7,1,64
"Enfield","15:00:00","2018-10-08",488,1,8,68,4,569
"Greenwich","15:00:00","2018-10-08",319,1,11,52,4,387
"Hammersmith and Fulham","15:00:00","2018-10-08",35,2,0,13,0,50
"Harrow","15:00:00","2018-10-08",10,0,0,2,0,12
"Merton","15:00:00","2018-10-08",632,10,2,83,0,727
"Richmond upon Thames","15:00:00","2018-10-08",1383,43,35,326,39,1826
"Waltham Forest","15:00:00","2018-10-08",301,4,6,36,2,349
"Barnet","16:00:00","2018-10-08",1302,13,12,136,4,1467
"Camden","16:00:00","2018-10-08",40,0,0,7,0,47
"Enfield","16:00:00","2018-10-08",493,2,13,91,1,600
"Greenwich","16:00:00","2018-10-08",375,1,14,42,0,432
"Hammersmith and Fulham","16:00:00","2018-10-08",33,0,0,13,0,46
"Harrow","16:00:00","2018-10-08",12,0,0,3,0,15
"Merton","16:00:00","2018-10-08",596,13,1,115,0,725
"Richmond upon Thames","16:00:00","2018-10-08",1817,61,36,382,19,2315
"Waltham Forest","16:00:00","2018-10-08",321,4,4,49,0,378
"Barnet","17:00:00","2018-10-08",1379,16,16,112,6,1529
"Camden","17:00:00","2018-10-08",36,5,0,6,0,47
"Enfield","17:00:00","2018-10-08",566,6,11,69,1,653
"Greenwich","17:00:00","2018-10-08",455,12,15,52,0,534
"Hammersmith and Fulham","17:00:00","2018-10-08",38,1,0,10,0,49
"Harrow","17:00:00","2018-10-08",17,0,0,0,0,17
"Merton","17:00:00","2018-10-08",597,14,0,75,0,686
"Richmond upon Thames","17:00:00","2018-10-08",1998,78,35,310,7,2428
"Waltham Forest","17:00:00","2018-10-08",289,2,4,35,0,330
"Barnet","18:00:00","2018-10-08",1222,19,15,91,2,1349
"Camden","18:00:00","2018-10-08",34,4,0,2,0,40
"Enfield","18:00:00","2018-10-08",516,7,11,90,1,625
"Greenwich","18:00:00","2018-10-08",368,7,10,42,1,428
"Hammersmith and Fulham","18:00:00","2018-10-08",40,5,0,5,0,50
"Harrow","18:00:00","2018-10-08",18,0,0,1,0,19
"Merton","18:00:00","2018-10-08",651,15,0,74,1,741
"Richmond upon Thames","18:00:00","2018-10-08",2136,72,32,244,13,2497
"Waltham Forest","18:00:00","2018-10-08",251,2,5,21,0,279
"Bromley","07:00:00","2018-10-09",661,22,10,149,7,849
"Ealing","07:00:00","2018-10-09",23,0,1,6,0,30
"Harrow","07:00:00","2018-10-09",686,11,8,90,3,798
"Hounslow","07:00:00","2018-10-09",571,6,9,54,1,641
"Kingston upon Thames","07:00:00","2018-10-09",545,6,0,113,2,666
"Lewisham","07:00:00","2018-10-09",30,1,0,5,0,36
"Richmond upon Thames","07:00:00","2018-10-09",23,0,0,2,0,25
"Waltham Forest","07:00:00","2018-10-09",136,0,0,10,1,147
"Wandsworth","07:00:00","2018-10-09",30,1,0,9,1,41
"Bromley","08:00:00","2018-10-09",639,15,6,115,22,797
"Ealing","08:00:00","2018-10-09",15,1,0,7,1,24
"Harrow","08:00:00","2018-10-09",707,7,3,67,9,793
"Hounslow","08:00:00","2018-10-09",790,3,15,62,3,873
"Kingston upon Thames","08:00:00","2018-10-09",636,6,0,83,0,725
"Lewisham","08:00:00","2018-10-09",37,3,0,4,0,44
"Richmond upon Thames","08:00:00","2018-10-09",45,0,0,2,0,47
"Waltham Forest","08:00:00","2018-10-09",149,0,0,20,1,170
"Wandsworth","08:00:00","2018-10-09",48,0,0,11,0,59
"Bromley","09:00:00","2018-10-09",640,3,11,128,20,802
"Ealing","09:00:00","2018-10-09",19,1,0,4,0,24
"Harrow","09:00:00","2018-10-09",542,2,3,66,3,616
"Hounslow","09:00:00","2018-10-09",356,5,12,43,0,416
"Kingston upon Thames","09:00:00","2018-10-09",320,11,0,73,2,406
"Lewisham","09:00:00","2018-10-09",29,0,0,6,1,36
"Richmond upon Thames","09:00:00","2018-10-09",50,0,0,4,0,54
"Waltham Forest","09:00:00","2018-10-09",130,0,0,11,2,143
"Wandsworth","09:00:00","2018-10-09",53,2,0,15,1,71
"Bromley","10:00:00","2018-10-09",596,5,7,123,27,758
"Ealing","10:00:00","2018-10-09",19,0,0,5,0,24
"Harrow","10:00:00","2018-10-09",430,3,2,81,3,519
"Hounslow","10:00:00","2018-10-09",187,0,9,32,1,229
"Kingston upon Thames","10:00:00","2018-10-09",211,7,0,68,0,286
"Lewisham","10:00:00","2018-10-09",21,3,0,10,0,34
"Richmond upon Thames","10:00:00","2018-10-09",22,0,0,9,0,31
"Waltham Forest","10:00:00","2018-10-09",104,0,0,8,0,112
"Wandsworth","10:00:00","2018-10-09",26,0,0,8,0,34
"Bromley","11:00:00","2018-10-09",636,3,9,141,21,810
"Ealing","11:00:00","2018-10-09",14,0,0,5,0,19
"Harrow","11:00:00","2018-10-09",467,8,0,53,7,535
"Hounslow","11:00:00","2018-10-09",208,4,6,32,4,254
"Kingston upon Thames","11:00:00","2018-10-09",260,6,0,59,3,328
"Lewisham","11:00:00","2018-10-09",23,0,0,10,0,33
"Richmond upon Thames","11:00:00","2018-10-09",16,0,0,2,0,18
"Waltham Forest","11:00:00","2018-10-09",91,0,0,24,2,117
"Wandsworth","11:00:00","2018-10-09",22,0,0,6,1,29
"Bromley","12:00:00","2018-10-09",735,7,7,144,20,913
"Ealing","12:00:00","2018-10-09",14,2,0,8,0,24
"Harrow","12:00:00","2018-10-09",451,1,0,66,1,519
"Hounslow","12:00:00","2018-10-09",228,4,7,30,3,272
"Kingston upon Thames","12:00:00","2018-10-09",252,5,0,52,2,311
"Lewisham","12:00:00","2018-10-09",24,0,0,8,1,33
"Richmond upon Thames","12:00:00","2018-10-09",21,0,0,2,0,23
"Waltham Forest","12:00:00","2018-10-09",96,1,0,21,1,119
"Wandsworth","12:00:00","2018-10-09",37,2,0,8,0,47
"Bromley","13:00:00","2018-10-09",646,4,8,141,22,821
"Ealing","13:00:00","2018-10-09",12,1,0,4,0,17
"Harrow","13:00:00","2018-10-09",460,6,2,75,2,545
"Hounslow","13:00:00","2018-10-09",206,2,5,32,2,247
"Kingston upon Thames","13:00:00","2018-10-09",230,6,0,76,3,315
"Lewisham","13:00:00","2018-10-09",25,0,0,4,0,29
"Richmond upon Thames","13:00:00","2018-10-09",14,0,0,1,1,16
"Waltham Forest","13:00:00","2018-10-09",94,0,1,17,0,112
"Wandsworth","13:00:00","2018-10-09",23,0,0,7,0,30
"Bromley","14:00:00","2018-10-09",623,9,8,159,29,828
"Ealing","14:00:00","2018-10-09",12,2,0,4,1,19
"Harrow","14:00:00","2018-10-09",464,7,1,83,2,557
"Hounslow","14:00:00","2018-10-09",226,4,5,36,1,272
"Kingston upon Thames","14:00:00","2018-10-09",235,4,0,58,3,300
"Lewisham","14:00:00","2018-10-09",33,1,0,14,0,48
"Richmond upon Thames","14:00:00","2018-10-09",15,0,0,4,1,20
"Waltham Forest","14:00:00","2018-10-09",109,4,0,21,0,134
"Wandsworth","14:00:00","2018-10-09",29,4,0,12,0,45
"Bromley","15:00:00","2018-10-09",670,12,8,133,21,844
"Ealing","15:00:00","2018-10-09",11,0,0,2,0,13
"Harrow","15:00:00","2018-10-09",551,6,4,59,2,622
"Hounslow","15:00:00","2018-10-09",360,6,6,43,2,417
"Kingston upon Thames","15:00:00","2018-10-09",306,6,0,68,3,383
"Lewisham","15:00:00","2018-10-09",43,2,0,9,0,54
"Richmond upon Thames","15:00:00","2018-10-09",24,0,0,0,0,24
"Waltham Forest","15:00:00","2018-10-09",129,0,0,21,2,152
"Wandsworth","15:00:00","2018-10-09",33,0,0,9,0,42
"Bromley","16:00:00","2018-10-09",654,15,8,135,13,825
"Ealing","16:00:00","2018-10-09",15,0,1,2,0,18
"Harrow","16:00:00","2018-10-09",644,4,1,78,1,728
"Hounslow","16:00:00","2018-10-09",420,7,12,28,1,468
"Kingston upon Thames","16:00:00","2018-10-09",469,5,0,110,1,585
"Lewisham","16:00:00","2018-10-09",38,4,0,6,0,48
"Richmond upon Thames","16:00:00","2018-10-09",28,0,0,0,0,28
"Waltham Forest","16:00:00","2018-10-09",133,0,1,23,0,157
"Wandsworth","16:00:00","2018-10-09",48,1,0,7,0,56
"Bromley","17:00:00","2018-10-09",746,30,8,141,11,936
"Ealing","17:00:00","2018-10-09",23,2,0,3,0,28
"Harrow","17:00:00","2018-10-09",736,9,1,78,1,825
"Hounslow","17:00:00","2018-10-09",524,9,11,33,0,577
"Kingston upon Thames","17:00:00","2018-10-09",513,9,0,62,0,584
"Lewisham","17:00:00","2018-10-09",45,2,0,9,1,57
"Richmond upon Thames","17:00:00","2018-10-09",18,0,0,4,0,22
"Waltham Forest","17:00:00","2018-10-09",156,0,1,16,0,173
"Wandsworth","17:00:00","2018-10-09",60,0,0,14,0,74
"Bromley","18:00:00","2018-10-09",751,17,7,81,6,862
"Ealing","18:00:00","2018-10-09",23,3,0,1,0,27
"Harrow","18:00:00","2018-10-09",784,3,0,43,1,831
"Hounslow","18:00:00","2018-10-09",439,7,11,33,0,490
"Kingston upon Thames","18:00:00","2018-10-09",524,8,0,69,0,601
"Lewisham","18:00:00","2018-10-09",47,2,0,4,0,53
"Richmond upon Thames","18:00:00","2018-10-09",21,0,0,0,0,21
"Waltham Forest","18:00:00","2018-10-09",138,0,0,12,0,150
"Wandsworth","18:00:00","2018-10-09",56,0,0,11,0,67
"Bexley","07:00:00","2018-10-10",376,7,25,90,17,515
"Croydon","07:00:00","2018-10-10",391,8,0,77,8,484
"Enfield","07:00:00","2018-10-10",818,14,17,261,131,1241
"Hammersmith and Fulham","07:00:00","2018-10-10",222,3,2,66,2,295
"Haringey","07:00:00","2018-10-10",400,9,0,78,2,489
"Harrow","07:00:00","2018-10-10",269,2,15,60,3,349
"Richmond upon Thames","07:00:00","2018-10-10",1746,44,21,340,39,2190
"Sutton","07:00:00","2018-10-10",669,7,0,122,2,800
"Tower Hamlets","07:00:00","2018-10-10",91,8,1,118,7,225
"Bexley","08:00:00","2018-10-10",667,1,25,104,25,822
"Bromley","08:00:00","2018-10-10",1769,15,9,399,54,2246
"Croydon","08:00:00","2018-10-10",537,10,0,82,6,635
"Enfield","08:00:00","2018-10-10",1155,17,20,245,165,1602
"Hammersmith and Fulham","08:00:00","2018-10-10",286,4,1,90,3,384
"Haringey","08:00:00","2018-10-10",676,7,2,65,2,752
"Harrow","08:00:00","2018-10-10",385,3,19,37,7,451
"Richmond upon Thames","08:00:00","2018-10-10",1723,35,27,248,35,2068
"Sutton","08:00:00","2018-10-10",869,5,3,100,10,987
"Tower Hamlets","08:00:00","2018-10-10",113,14,3,109,11,250
"Bexley","09:00:00","2018-10-10",427,4,25,101,34,591
"Bromley","09:00:00","2018-10-10",1122,8,14,246,32,1422
"Croydon","09:00:00","2018-10-10",408,15,4,66,2,495
"Enfield","09:00:00","2018-10-10",821,23,21,217,227,1309
"Hammersmith and Fulham","09:00:00","2018-10-10",247,17,0,63,0,327
"Haringey","09:00:00","2018-10-10",421,5,0,82,4,512
"Harrow","09:00:00","2018-10-10",240,0,15,31,4,290
"Richmond upon Thames","09:00:00","2018-10-10",1542,31,21,291,27,1912
"Sutton","09:00:00","2018-10-10",557,4,0,107,12,680
"Tower Hamlets","09:00:00","2018-10-10",107,6,2,86,11,212
"Bexley","10:00:00","2018-10-10",260,1,29,94,37,421
"Bromley","10:00:00","2018-10-10",896,9,4,150,42,1101
"Croydon","10:00:00","2018-10-10",240,6,2,57,9,314
"Enfield","10:00:00","2018-10-10",748,15,25,271,207,1266
"Hammersmith and Fulham","10:00:00","2018-10-10",157,8,0,63,2,230
"Haringey","10:00:00","2018-10-10",282,5,0,66,0,353
"Harrow","10:00:00","2018-10-10",192,0,19,46,8,265
"Richmond upon Thames","10:00:00","2018-10-10",1163,16,22,285,39,1525
"Sutton","10:00:00","2018-10-10",425,6,1,82,12,526
"Tower Hamlets","10:00:00","2018-10-10",109,11,0,93,7,220
"Bexley","11:00:00","2018-10-10",243,2,15,91,37,388
"Bromley","11:00:00","2018-10-10",778,6,9,149,22,964
"Croydon","11:00:00","2018-10-10",228,17,0,74,7,326
"Enfield","11:00:00","2018-10-10",741,13,22,233,193,1202
"Hammersmith and Fulham","11:00:00","2018-10-10",148,6,0,64,4,222
"Haringey","11:00:00","2018-10-10",270,3,1,56,1,331
"Harrow","11:00:00","2018-10-10",198,1,15,48,5,267
"Richmond upon Thames","11:00:00","2018-10-10",1291,18,19,286,36,1650
"Sutton","11:00:00","2018-10-10",385,3,0,63,12,463
"Tower Hamlets","11:00:00","2018-10-10",102,11,0,60,8,181
"Bexley","12:00:00","2018-10-10",311,7,14,85,23,440
"Bromley","12:00:00","2018-10-10",825,5,8,149,38,1025
"Croydon","12:00:00","2018-10-10",243,16,2,78,5,344
"Enfield","12:00:00","2018-10-10",801,16,15,211,132,1175
"Hammersmith and Fulham","12:00:00","2018-10-10",165,11,0,67,0,243
"Haringey","12:00:00","2018-10-10",283,17,3,61,1,365
"Harrow","12:00:00","2018-10-10",219,1,17,40,6,283
"Richmond upon Thames","12:00:00","2018-10-10",1305,17,14,258,41,1635
"Sutton","12:00:00","2018-10-10",449,6,0,85,13,553
"Tower Hamlets","12:00:00","2018-10-10",103,8,1,50,9,171
"Bexley","13:00:00","2018-10-10",337,5,18,114,34,508
"Bromley","13:00:00","2018-10-10",963,12,3,167,32,1177
"Croydon","13:00:00","2018-10-10",239,10,0,73,6,328
"Enfield","13:00:00","2018-10-10",802,26,17,233,170,1248
"Hammersmith and Fulham","13:00:00","2018-10-10",150,13,0,65,1,229
"Haringey","13:00:00","2018-10-10",315,9,1,61,3,389
"Harrow","13:00:00","2018-10-10",177,6,18,45,5,251
"Richmond upon Thames","13:00:00","2018-10-10",1202,25,18,246,30,1521
"Sutton","13:00:00","2018-10-10",414,5,1,81,11,512
"Tower Hamlets","13:00:00","2018-10-10",116,3,0,67,2,188
"Bexley","14:00:00","2018-10-10",373,2,18,94,17,504
"Bromley","14:00:00","2018-10-10",904,3,5,163,38,1113
"Croydon","14:00:00","2018-10-10",319,25,2,81,1,428
"Enfield","14:00:00","2018-10-10",1029,24,26,278,155,1512
"Hammersmith and Fulham","14:00:00","2018-10-10",191,17,0,48,3,259
"Haringey","14:00:00","2018-10-10",293,15,1,81,4,394
"Harrow","14:00:00","2018-10-10",203,1,18,41,2,265
"Richmond upon Thames","14:00:00","2018-10-10",1478,25,22,210,36,1771
"Sutton","14:00:00","2018-10-10",428,9,0,80,9,526
"Tower Hamlets","14:00:00","2018-10-10",115,8,0,44,6,173
"Bexley","15:00:00","2018-10-10",549,7,26,108,22,712
"Bromley","15:00:00","2018-10-10",1079,9,9,181,19,1297
"Croydon","15:00:00","2018-10-10",374,16,1,99,8,498
"Enfield","15:00:00","2018-10-10",985,15,21,279,126,1426
"Hammersmith and Fulham","15:00:00","2018-10-10",291,14,0,76,2,383
"Haringey","15:00:00","2018-10-10",443,6,5,94,2,550
"Harrow","15:00:00","2018-10-10",219,3,17,38,3,280
"Richmond upon Thames","15:00:00","2018-10-10",1437,24,23,216,18,1718
"Sutton","15:00:00","2018-10-10",673,6,1,117,9,806
"Tower Hamlets","15:00:00","2018-10-10",93,6,0,32,4,135
"Bexley","16:00:00","2018-10-10",460,7,23,111,18,619
"Bromley","16:00:00","2018-10-10",1422,18,12,238,17,1707
"Croydon","16:00:00","2018-10-10",432,18,3,89,2,544
"Enfield","16:00:00","2018-10-10",959,25,25,252,123,1384
"Hammersmith and Fulham","16:00:00","2018-10-10",308,17,6,84,1,416
"Haringey","16:00:00","2018-10-10",500,6,2,101,0,609
"Harrow","16:00:00","2018-10-10",297,2,18,56,2,375
"Richmond upon Thames","16:00:00","2018-10-10",1692,41,20,247,17,2017
"Sutton","16:00:00","2018-10-10",684,8,1,132,4,829
"Tower Hamlets","16:00:00","2018-10-10",99,6,0,20,1,126
"Bexley","17:00:00","2018-10-10",534,6,23,82,10,655
"Bromley","17:00:00","2018-10-10",1570,10,1,235,10,1826
"Croydon","17:00:00","2018-10-10",565,33,0,90,1,689
"Enfield","17:00:00","2018-10-10",1098,32,20,258,89,1497
"Hammersmith and Fulham","17:00:00","2018-10-10",342,26,0,63,1,432
"Haringey","17:00:00","2018-10-10",544,20,3,73,0,640
"Harrow","17:00:00","2018-10-10",468,1,14,45,1,529
"Richmond upon Thames","17:00:00","2018-10-10",1924,44,15,198,17,2198
"Sutton","17:00:00","2018-10-10",770,7,1,106,1,885
"Tower Hamlets","17:00:00","2018-10-10",141,18,0,27,2,188
"Bexley","18:00:00","2018-10-10",470,6,18,49,8,551
"Bromley","18:00:00","2018-10-10",1301,17,3,136,9,1466
"Croydon","18:00:00","2018-10-10",456,20,0,50,0,526
"Enfield","18:00:00","2018-10-10",1075,19,25,186,79,1384
"Hammersmith and Fulham","18:00:00","2018-10-10",332,20,0,35,0,387
"Haringey","18:00:00","2018-10-10",590,26,0,59,0,675
"Harrow","18:00:00","2018-10-10",483,5,15,99,2,604
"Richmond upon Thames","18:00:00","2018-10-10",1787,33,18,155,10,2003
"Sutton","18:00:00","2018-10-10",613,13,0,48,3,677
"Tower Hamlets","18:00:00","2018-10-10",210,7,0,23,0,240
"Bromley","07:00:00","2018-10-11",499,9,8,159,1,676
"Croydon","07:00:00","2018-10-11",19,0,0,2,1,22
"Havering","07:00:00","2018-10-11",31,0,0,4,0,35
"Hounslow","07:00:00","2018-10-11",248,5,20,61,1,335
"Islington","07:00:00","2018-10-11",276,8,0,113,0,397
"Kensington and Chelsea","07:00:00","2018-10-11",708,87,108,253,42,1198
"Tower Hamlets","07:00:00","2018-10-11",40,1,2,31,3,77
"Bromley","08:00:00","2018-10-11",564,7,8,103,4,686
"Croydon","08:00:00","2018-10-11",28,0,0,3,1,32
"Havering","08:00:00","2018-10-11",41,0,1,17,1,60
"Hounslow","08:00:00","2018-10-11",335,6,22,46,1,410
"Islington","08:00:00","2018-10-11",268,15,0,86,1,370
"Kensington and Chelsea","08:00:00","2018-10-11",1129,108,99,243,35,1614
"Tower Hamlets","08:00:00","2018-10-11",71,6,4,33,6,120
"Bromley","09:00:00","2018-10-11",526,2,10,99,4,641
"Croydon","09:00:00","2018-10-11",28,0,0,8,2,38
"Havering","09:00:00","2018-10-11",36,0,0,6,1,43
"Hounslow","09:00:00","2018-10-11",311,4,22,37,1,375
"Islington","09:00:00","2018-10-11",280,14,1,112,0,407
"Kensington and Chelsea","09:00:00","2018-10-11",1070,87,104,313,44,1618
"Tower Hamlets","09:00:00","2018-10-11",103,6,2,41,4,156
"Bromley","10:00:00","2018-10-11",511,2,8,96,6,623
"Croydon","10:00:00","2018-10-11",10,0,0,6,0,16
"Havering","10:00:00","2018-10-11",31,0,0,9,0,40
"Hounslow","10:00:00","2018-10-11",199,5,22,47,7,280
"Islington","10:00:00","2018-10-11",226,7,0,81,1,315
"Kensington and Chelsea","10:00:00","2018-10-11",970,56,96,295,45,1462
"Tower Hamlets","10:00:00","2018-10-11",103,14,3,33,1,154
"Bromley","11:00:00","2018-10-11",493,3,7,115,7,625
"Croydon","11:00:00","2018-10-11",21,1,0,8,0,30
"Havering","11:00:00","2018-10-11",37,0,0,10,0,47
"Hounslow","11:00:00","2018-10-11",180,4,19,48,7,258
"Islington","11:00:00","2018-10-11",200,2,0,104,2,308
"Kensington and Chelsea","11:00:00","2018-10-11",1001,58,104,347,46,1556
"Tower Hamlets","11:00:00","2018-10-11",129,19,2,38,3,191
"Bromley","12:00:00","2018-10-11",504,6,7,98,11,626
"Croydon","12:00:00","2018-10-11",13,4,0,6,0,23
"Havering","12:00:00","2018-10-11",39,0,0,4,1,44
"Hounslow","12:00:00","2018-10-11",218,6,17,38,7,286
"Islington","12:00:00","2018-10-11",217,12,0,88,0,317
"Kensington and Chelsea","12:00:00","2018-10-11",912,76,84,234,44,1350
"Tower Hamlets","12:00:00","2018-10-11",119,23,5,37,2,186
"Bromley","13:00:00","2018-10-11",488,6,11,108,5,618
"Croydon","13:00:00","2018-10-11",8,0,0,8,1,17
"Havering","13:00:00","2018-10-11",27,0,0,2,0,29
"Hounslow","13:00:00","2018-10-11",197,5,19,30,6,257
"Islington","13:00:00","2018-10-11",238,7,0,89,0,334
"Kensington and Chelsea","13:00:00","2018-10-11",715,95,93,209,30,1142
"Tower Hamlets","13:00:00","2018-10-11",111,21,4,35,1,172
"Bromley","14:00:00","2018-10-11",557,7,8,129,2,703
"Croydon","14:00:00","2018-10-11",21,0,0,4,0,25
"Havering","14:00:00","2018-10-11",33,0,0,4,0,37
"Hounslow","14:00:00","2018-10-11",206,5,20,44,2,277
"Islington","14:00:00","2018-10-11",232,10,1,95,2,340
"Kensington and Chelsea","14:00:00","2018-10-11",837,84,96,211,29,1257
"Tower Hamlets","14:00:00","2018-10-11",150,15,4,29,2,200
"Bromley","15:00:00","2018-10-11",648,4,11,128,8,799
"Croydon","15:00:00","2018-10-11",18,0,0,1,1,20
"Havering","15:00:00","2018-10-11",48,0,1,4,0,53
"Hounslow","15:00:00","2018-10-11",275,4,17,54,2,352
"Islington","15:00:00","2018-10-11",255,17,1,112,2,387
"Kensington and Chelsea","15:00:00","2018-10-11",890,82,93,196,25,1286
"Tower Hamlets","15:00:00","2018-10-11",148,14,2,21,1,186
"Bromley","16:00:00","2018-10-11",704,6,13,163,0,886
"Croydon","16:00:00","2018-10-11",20,0,0,4,0,24
"Havering","16:00:00","2018-10-11",34,0,0,7,0,41
"Hounslow","16:00:00","2018-10-11",273,3,16,60,1,353
"Islington","16:00:00","2018-10-11",270,11,0,102,0,383
"Kensington and Chelsea","16:00:00","2018-10-11",861,96,91,140,11,1199
"Tower Hamlets","16:00:00","2018-10-11",159,22,4,24,2,211
"Bromley","17:00:00","2018-10-11",739,5,5,99,0,848
"Croydon","17:00:00","2018-10-11",42,1,0,2,0,45
"Havering","17:00:00","2018-10-11",36,0,0,6,0,42
"Hounslow","17:00:00","2018-10-11",285,2,23,47,2,359
"Islington","17:00:00","2018-10-11",312,24,0,65,0,401
"Kensington and Chelsea","17:00:00","2018-10-11",1079,132,102,123,6,1442
"Tower Hamlets","17:00:00","2018-10-11",154,10,4,12,1,181
"Bromley","18:00:00","2018-10-11",662,5,9,99,3,778
"Croydon","18:00:00","2018-10-11",25,4,0,3,0,32
"Havering","18:00:00","2018-10-11",40,0,0,8,0,48
"Hounslow","18:00:00","2018-10-11",336,4,17,20,1,378
"Islington","18:00:00","2018-10-11",355,19,0,49,0,423
"Kensington and Chelsea","18:00:00","2018-10-11",1062,119,85,78,8,1352
"Tower Hamlets","18:00:00","2018-10-11",131,12,2,14,0,159
"Bexley","07:00:00","2018-10-12",952,12,15,222,11,1212
"Brent","07:00:00","2018-10-12",530,9,54,222,110,925
"Camden","07:00:00","2018-10-12",222,37,44,207,41,551
"City of London","07:00:00","2018-10-12",344,51,30,176,41,642
"Ealing","07:00:00","2018-10-12",307,4,2,41,4,358
"Enfield","07:00:00","2018-10-12",266,1,5,42,5,319
"Hounslow","07:00:00","2018-10-12",4,1,0,1,0,6
"Islington","07:00:00","2018-10-12",81,2,0,65,3,151
"Kingston upon Thames","07:00:00","2018-10-12",191,10,0,27,1,229
"Tower Hamlets","07:00:00","2018-10-12",80,1,13,16,0,110
"Waltham Forest","07:00:00","2018-10-12",484,5,61,135,20,705
"Wandsworth","07:00:00","2018-10-12",521,57,2,231,18,829
"Bexley","08:00:00","2018-10-12",936,8,8,145,14,1111
"Brent","08:00:00","2018-10-12",655,16,47,224,80,1022
"Camden","08:00:00","2018-10-12",343,41,38,158,25,605
"City of London","08:00:00","2018-10-12",409,56,39,143,30,677
"Ealing","08:00:00","2018-10-12",605,7,2,108,18,740
"Enfield","08:00:00","2018-10-12",563,1,5,59,9,637
"Hounslow","08:00:00","2018-10-12",11,1,0,1,0,13
"Islington","08:00:00","2018-10-12",102,3,2,38,1,146
"Kingston upon Thames","08:00:00","2018-10-12",295,16,0,27,2,340
"Tower Hamlets","08:00:00","2018-10-12",151,1,13,17,1,183
"Waltham Forest","08:00:00","2018-10-12",537,3,62,98,12,712
"Wandsworth","08:00:00","2018-10-12",500,101,5,214,22,842
"Bexley","09:00:00","2018-10-12",1008,5,8,165,11,1197
"Brent","09:00:00","2018-10-12",604,24,52,226,122,1028
"Camden","09:00:00","2018-10-12",315,33,35,139,19,541
"City of London","09:00:00","2018-10-12",444,53,28,153,25,703
"Ealing","09:00:00","2018-10-12",373,4,3,101,16,497
"Enfield","09:00:00","2018-10-12",338,4,5,40,1,388
"Hounslow","09:00:00","2018-10-12",6,0,0,3,0,9
"Islington","09:00:00","2018-10-12",120,2,1,58,0,181
"Kingston upon Thames","09:00:00","2018-10-12",207,8,0,31,3,249
"Tower Hamlets","09:00:00","2018-10-12",137,1,15,16,3,172
"Waltham Forest","09:00:00","2018-10-12",522,3,76,102,19,722
"Wandsworth","09:00:00","2018-10-12",499,53,2,202,26,782
"Bexley","10:00:00","2018-10-12",756,6,5,148,15,930
"Brent","10:00:00","2018-10-12",754,27,50,276,137,1244
"Camden","10:00:00","2018-10-12",343,26,44,161,29,603
"City of London","10:00:00","2018-10-12",474,45,31,148,33,731
"Ealing","10:00:00","2018-10-12",330,3,1,110,21,465
"Enfield","10:00:00","2018-10-12",318,2,4,50,6,380
"Hounslow","10:00:00","2018-10-12",3,0,0,3,0,6
"Islington","10:00:00","2018-10-12",89,2,0,37,2,130
"Kingston upon Thames","10:00:00","2018-10-12",144,7,0,30,1,182
"Tower Hamlets","10:00:00","2018-10-12",122,0,14,14,1,151
"Waltham Forest","10:00:00","2018-10-12",448,7,65,86,17,623
"Wandsworth","10:00:00","2018-10-12",534,29,2,214,22,801
"Bexley","11:00:00","2018-10-12",795,4,5,105,14,923
"Brent","11:00:00","2018-10-12",777,21,47,281,133,1259
"Camden","11:00:00","2018-10-12",322,30,33,166,14,565
"City of London","11:00:00","2018-10-12",436,47,28,156,24,691
"Ealing","11:00:00","2018-10-12",319,7,1,81,23,431
"Enfield","11:00:00","2018-10-12",320,0,4,45,10,379
"Hounslow","11:00:00","2018-10-12",3,0,0,2,0,5
"Islington","11:00:00","2018-10-12",75,4,0,35,1,115
"Kingston upon Thames","11:00:00","2018-10-12",123,3,0,30,0,156
"Tower Hamlets","11:00:00","2018-10-12",102,6,9,14,0,131
"Waltham Forest","11:00:00","2018-10-12",464,4,65,87,8,628
"Wandsworth","11:00:00","2018-10-12",541,20,5,234,19,819
"Bexley","12:00:00","2018-10-12",1105,15,5,151,14,1290
"Brent","12:00:00","2018-10-12",959,33,41,273,103,1409
"Camden","12:00:00","2018-10-12",418,30,38,196,18,700
"City of London","12:00:00","2018-10-12",474,56,27,141,22,720
"Ealing","12:00:00","2018-10-12",375,7,6,97,10,495
"Enfield","12:00:00","2018-10-12",348,4,4,43,4,403
"Hounslow","12:00:00","2018-10-12",5,0,0,1,0,6
"Islington","12:00:00","2018-10-12",70,6,0,38,2,116
"Kingston upon Thames","12:00:00","2018-10-12",129,5,0,22,1,157
"Tower Hamlets","12:00:00","2018-10-12",140,5,10,12,0,167
"Waltham Forest","12:00:00","2018-10-12",540,10,65,92,8,715
"Wandsworth","12:00:00","2018-10-12",537,34,1,235,23,830
"Bexley","13:00:00","2018-10-12",1099,8,8,134,15,1264
"Brent","13:00:00","2018-10-12",976,23,44,284,108,1435
"Camden","13:00:00","2018-10-12",317,42,32,164,18,573
"City of London","13:00:00","2018-10-12",401,58,23,122,13,617
"Ealing","13:00:00","2018-10-12",350,5,0,81,13,449
"Enfield","13:00:00","2018-10-12",305,1,5,43,1,355
"Hounslow","13:00:00","2018-10-12",2,0,0,3,0,5
"Islington","13:00:00","2018-10-12",78,11,0,35,2,126
"Kingston upon Thames","13:00:00","2018-10-12",113,2,0,11,3,129
"Tower Hamlets","13:00:00","2018-10-12",121,4,14,10,0,149
"Waltham Forest","13:00:00","2018-10-12",541,9,62,92,17,721
"Wandsworth","13:00:00","2018-10-12",565,29,2,242,18,856
"Bexley","14:00:00","2018-10-12",1001,8,8,143,9,1169
"Brent","14:00:00","2018-10-12",1054,30,46,242,98,1470
"Camden","14:00:00","2018-10-12",303,46,25,123,13,510
"City of London","14:00:00","2018-10-12",444,51,26,131,12,664
"Ealing","14:00:00","2018-10-12",531,5,0,106,16,658
"Enfield","14:00:00","2018-10-12",301,4,9,44,6,364
"Hounslow","14:00:00","2018-10-12",7,0,0,0,0,7
"Islington","14:00:00","2018-10-12",85,6,0,44,2,137
"Kingston upon Thames","14:00:00","2018-10-12",158,5,0,30,0,193
"Tower Hamlets","14:00:00","2018-10-12",129,5,11,14,0,159
"Waltham Forest","14:00:00","2018-10-12",464,3,58,77,3,605
"Wandsworth","14:00:00","2018-10-12",658,38,6,202,27,931
"Bexley","15:00:00","2018-10-12",1184,18,6,183,8,1399
"Brent","15:00:00","2018-10-12",1058,24,59,228,90,1459
"Camden","15:00:00","2018-10-12",397,54,38,178,19,686
"City of London","15:00:00","2018-10-12",514,63,30,126,8,741
"Ealing","15:00:00","2018-10-12",449,2,0,99,13,563
"Enfield","15:00:00","2018-10-12",443,3,5,51,1,503
"Hounslow","15:00:00","2018-10-12",5,0,0,0,0,5
"Islington","15:00:00","2018-10-12",100,6,0,15,4,125
"Kingston upon Thames","15:00:00","2018-10-12",256,10,0,27,1,294
"Tower Hamlets","15:00:00","2018-10-12",231,7,13,26,1,278
"Waltham Forest","15:00:00","2018-10-12",599,10,61,94,3,767
"Wandsworth","15:00:00","2018-10-12",674,28,3,223,7,935
"Bexley","16:00:00","2018-10-12",1239,12,7,182,2,1442
"Brent","16:00:00","2018-10-12",1227,45,38,216,49,1575
"Camden","16:00:00","2018-10-12",360,53,42,116,13,584
"City of London","16:00:00","2018-10-12",503,72,33,108,7,723
"Ealing","16:00:00","2018-10-12",475,7,5,78,9,574
"Enfield","16:00:00","2018-10-12",397,6,4,58,3,468
"Hounslow","16:00:00","2018-10-12",4,0,0,0,0,4
"Islington","16:00:00","2018-10-12",96,4,0,21,1,122
"Kingston upon Thames","16:00:00","2018-10-12",277,3,2,29,1,312
"Tower Hamlets","16:00:00","2018-10-12",160,9,16,15,0,200
"Waltham Forest","16:00:00","2018-10-12",585,8,63,95,3,754
"Wandsworth","16:00:00","2018-10-12",712,58,4,196,16,986
"Bexley","17:00:00","2018-10-12",1177,17,7,123,4,1328
"Brent","17:00:00","2018-10-12",1306,36,46,165,15,1568
"Camden","17:00:00","2018-10-12",361,45,37,90,3,536
"City of London","17:00:00","2018-10-12",543,73,38,84,8,746
"Ealing","17:00:00","2018-10-12",664,2,5,131,9,811
"Enfield","17:00:00","2018-10-12",421,6,8,52,1,488
"Hounslow","17:00:00","2018-10-12",10,2,0,2,0,14
"Islington","17:00:00","2018-10-12",110,7,0,29,0,146
"Kingston upon Thames","17:00:00","2018-10-12",227,19,0,22,0,268
"Tower Hamlets","17:00:00","2018-10-12",173,8,13,19,0,213
"Waltham Forest","17:00:00","2018-10-12",594,5,53,68,3,723
"Wandsworth","17:00:00","2018-10-12",625,71,5,146,5,852
"Bexley","18:00:00","2018-10-12",1023,19,6,95,1,1144
"Brent","18:00:00","2018-10-12",1138,18,40,153,15,1364
"Camden","18:00:00","2018-10-12",477,83,37,65,14,676
"City of London","18:00:00","2018-10-12",542,69,35,64,6,716
"Ealing","18:00:00","2018-10-12",588,8,5,59,6,666
"Enfield","18:00:00","2018-10-12",402,7,3,36,0,448
"Hounslow","18:00:00","2018-10-12",4,0,0,1,0,5
"Islington","18:00:00","2018-10-12",141,20,0,14,1,176
"Kingston upon Thames","18:00:00","2018-10-12",179,17,0,13,0,209
"Tower Hamlets","18:00:00","2018-10-12",162,4,14,19,0,199
"Waltham Forest","18:00:00","2018-10-12",540,7,62,61,2,672
"Wandsworth","18:00:00","2018-10-12",715,68,2,101,1,887
"Barnet","07:00:00","2018-10-15",12,0,0,6,0,18
"Bexley","07:00:00","2018-10-15",199,1,0,23,0,223
"Croydon","07:00:00","2018-10-15",252,2,9,19,0,282
"Ealing","07:00:00","2018-10-15",456,13,22,123,13,627
"Kingston upon Thames","07:00:00","2018-10-15",578,15,1,43,5,642
"Lambeth","07:00:00","2018-10-15",282,12,5,97,4,400
"Merton","07:00:00","2018-10-15",121,0,15,9,1,146
"Richmond upon Thames","07:00:00","2018-10-15",466,7,3,80,3,559
"Barnet","08:00:00","2018-10-15",8,0,0,5,0,13
"Bexley","08:00:00","2018-10-15",370,2,2,42,0,416
"Croydon","08:00:00","2018-10-15",377,3,8,29,0,417
"Ealing","08:00:00","2018-10-15",585,14,29,100,13,741
"Kingston upon Thames","08:00:00","2018-10-15",672,18,1,36,2,729
"Lambeth","08:00:00","2018-10-15",359,17,8,85,8,477
"Merton","08:00:00","2018-10-15",153,0,14,9,2,178
"Richmond upon Thames","08:00:00","2018-10-15",389,6,3,50,4,452
"Barnet","09:00:00","2018-10-15",19,0,0,2,0,21
"Bexley","09:00:00","2018-10-15",177,1,1,35,1,215
"Croydon","09:00:00","2018-10-15",189,0,8,20,0,217
"Ealing","09:00:00","2018-10-15",527,16,35,125,17,720
"Kingston upon Thames","09:00:00","2018-10-15",560,7,0,32,4,603
"Lambeth","09:00:00","2018-10-15",299,22,4,72,5,402
"Merton","09:00:00","2018-10-15",175,5,12,23,3,218
"Richmond upon Thames","09:00:00","2018-10-15",513,8,1,70,7,599
"Barnet","10:00:00","2018-10-15",15,0,0,4,0,19
"Bexley","10:00:00","2018-10-15",137,1,0,29,1,168
"Croydon","10:00:00","2018-10-15",114,0,11,21,0,146
"Ealing","10:00:00","2018-10-15",462,5,31,162,20,680
"Kingston upon Thames","10:00:00","2018-10-15",433,5,0,38,3,479
"Lambeth","10:00:00","2018-10-15",243,8,3,84,8,346
"Merton","10:00:00","2018-10-15",196,2,14,16,2,230
"Richmond upon Thames","10:00:00","2018-10-15",483,3,1,91,12,590
"Barnet","11:00:00","2018-10-15",9,0,0,4,1,14
"Bexley","11:00:00","2018-10-15",171,1,1,30,3,206
"Croydon","11:00:00","2018-10-15",108,0,10,18,0,136
"Ealing","11:00:00","2018-10-15",380,7,24,142,18,571
"Kingston upon Thames","11:00:00","2018-10-15",375,4,1,25,2,407
"Lambeth","11:00:00","2018-10-15",228,8,3,81,9,329
"Merton","11:00:00","2018-10-15",261,1,14,22,0,298
"Richmond upon Thames","11:00:00","2018-10-15",449,3,0,85,8,545
"Barnet","12:00:00","2018-10-15",7,0,0,3,1,11
"Bexley","12:00:00","2018-10-15",153,0,0,31,1,185
"Croydon","12:00:00","2018-10-15",111,0,10,21,0,142
"Ealing","12:00:00","2018-10-15",387,11,30,112,10,550
"Kingston upon Thames","12:00:00","2018-10-15",330,8,1,39,1,379
"Lambeth","12:00:00","2018-10-15",221,11,1,88,6,327
"Merton","12:00:00","2018-10-15",239,3,14,25,0,281
"Richmond upon Thames","12:00:00","2018-10-15",444,2,3,81,6,536
"Barnet","13:00:00","2018-10-15",10,0,0,2,0,12
"Bexley","13:00:00","2018-10-15",157,1,0,18,0,176
"Croydon","13:00:00","2018-10-15",103,2,14,19,1,139
"Ealing","13:00:00","2018-10-15",364,17,26,112,16,535
"Kingston upon Thames","13:00:00","2018-10-15",350,6,0,37,1,394
"Lambeth","13:00:00","2018-10-15",245,12,2,92,9,360
"Merton","13:00:00","2018-10-15",239,2,12,20,0,273
"Richmond upon Thames","13:00:00","2018-10-15",421,4,0,79,8,512
"Barnet","14:00:00","2018-10-15",18,0,0,9,0,27
"Bexley","14:00:00","2018-10-15",170,0,3,29,0,202
"Croydon","14:00:00","2018-10-15",113,4,11,21,0,149
"Ealing","14:00:00","2018-10-15",391,12,27,103,7,540
"Kingston upon Thames","14:00:00","2018-10-15",406,5,1,40,1,453
"Lambeth","14:00:00","2018-10-15",253,7,5,97,7,369
"Merton","14:00:00","2018-10-15",274,4,16,17,0,311
"Richmond upon Thames","14:00:00","2018-10-15",458,8,1,95,10,572
"Barnet","15:00:00","2018-10-15",9,0,0,3,0,12
"Bexley","15:00:00","2018-10-15",276,0,0,38,1,315
"Croydon","15:00:00","2018-10-15",165,0,9,20,0,194
"Ealing","15:00:00","2018-10-15",508,15,23,120,5,671
"Kingston upon Thames","15:00:00","2018-10-15",447,4,2,24,0,477
"Lambeth","15:00:00","2018-10-15",263,16,6,86,2,373
"Merton","15:00:00","2018-10-15",277,3,14,14,0,308
"Richmond upon Thames","15:00:00","2018-10-15",502,5,1,55,4,567
"Barnet","16:00:00","2018-10-15",14,0,0,8,0,22
"Bexley","16:00:00","2018-10-15",265,0,1,42,0,308
"Croydon","16:00:00","2018-10-15",264,2,15,44,1,326
"Ealing","16:00:00","2018-10-15",543,14,24,87,7,675
"Kingston upon Thames","16:00:00","2018-10-15",593,12,0,29,3,637
"Lambeth","16:00:00","2018-10-15",240,19,6,75,3,343
"Merton","16:00:00","2018-10-15",204,2,14,21,0,241
"Richmond upon Thames","16:00:00","2018-10-15",525,11,4,62,2,604
"Barnet","17:00:00","2018-10-15",7,0,0,2,0,9
"Bexley","17:00:00","2018-10-15",292,2,1,43,2,340
"Croydon","17:00:00","2018-10-15",297,1,12,29,1,340
"Ealing","17:00:00","2018-10-15",574,17,24,89,3,707
"Kingston upon Thames","17:00:00","2018-10-15",549,14,0,28,1,592
"Lambeth","17:00:00","2018-10-15",286,23,3,45,1,358
"Merton","17:00:00","2018-10-15",186,5,14,20,0,225
"Richmond upon Thames","17:00:00","2018-10-15",500,10,2,62,1,575
"Barnet","18:00:00","2018-10-15",10,0,0,0,0,10
"Bexley","18:00:00","2018-10-15",131,1,0,16,1,149
"Croydon","18:00:00","2018-10-15",226,3,12,26,1,268
"Ealing","18:00:00","2018-10-15",593,20,22,51,5,691
"Kingston upon Thames","18:00:00","2018-10-15",325,7,0,18,0,350
"Lambeth","18:00:00","2018-10-15",314,25,5,36,0,380
"Merton","18:00:00","2018-10-15",147,8,12,17,0,184
"Richmond upon Thames","18:00:00","2018-10-15",443,6,1,37,5,492
"Camden","07:00:00","2018-10-16",4,0,0,1,0,5
"Ealing","07:00:00","2018-10-16",23,0,0,3,0,26
"Haringey","07:00:00","2018-10-16",13,1,0,1,0,15
"Hounslow","07:00:00","2018-10-16",9,0,0,5,0,14
"Kingston upon Thames","07:00:00","2018-10-16",1452,31,66,331,33,1913
"Lewisham","07:00:00","2018-10-16",1061,79,45,451,60,1696
"Merton","07:00:00","2018-10-16",843,16,35,197,24,1115
"Redbridge","07:00:00","2018-10-16",1186,9,12,159,19,1385
"Tower Hamlets","07:00:00","2018-10-16",346,4,6,89,1,446
"Wandsworth","07:00:00","2018-10-16",813,199,67,407,114,1600
"Westminster","07:00:00","2018-10-16",215,35,51,120,36,457
"Camden","08:00:00","2018-10-16",4,0,0,1,0,5
"Ealing","08:00:00","2018-10-16",36,0,0,3,1,40
"Haringey","08:00:00","2018-10-16",19,0,0,4,0,23
"Hounslow","08:00:00","2018-10-16",13,1,0,4,1,19
"Kingston upon Thames","08:00:00","2018-10-16",1547,35,47,259,35,1923
"Lewisham","08:00:00","2018-10-16",1090,78,51,308,80,1607
"Merton","08:00:00","2018-10-16",754,24,38,140,30,986
"Redbridge","08:00:00","2018-10-16",1294,12,16,142,19,1483
"Tower Hamlets","08:00:00","2018-10-16",469,5,7,78,3,562
"Wandsworth","08:00:00","2018-10-16",958,270,64,352,94,1738
"Westminster","08:00:00","2018-10-16",433,42,62,134,43,714
"Camden","09:00:00","2018-10-16",3,2,0,5,0,10
"Ealing","09:00:00","2018-10-16",26,0,1,5,1,33
"Haringey","09:00:00","2018-10-16",14,0,0,4,0,18
"Hounslow","09:00:00","2018-10-16",4,0,0,9,2,15
"Kingston upon Thames","09:00:00","2018-10-16",1326,19,65,279,36,1725
"Lewisham","09:00:00","2018-10-16",1074,46,44,349,71,1584
"Merton","09:00:00","2018-10-16",668,17,32,150,45,912
"Redbridge","09:00:00","2018-10-16",1169,10,14,194,27,1414
"Tower Hamlets","09:00:00","2018-10-16",304,9,7,52,6,378
"Wandsworth","09:00:00","2018-10-16",735,135,57,427,118,1472
"Westminster","09:00:00","2018-10-16",491,53,56,141,43,784
"Camden","10:00:00","2018-10-16",1,0,0,2,0,3
"Ealing","10:00:00","2018-10-16",22,0,0,4,0,26
"Haringey","10:00:00","2018-10-16",7,0,0,5,0,12
"Hounslow","10:00:00","2018-10-16",9,0,0,8,0,17
"Kingston upon Thames","10:00:00","2018-10-16",1204,12,69,292,44,1621
"Lewisham","10:00:00","2018-10-16",1089,33,57,378,90,1647
"Merton","10:00:00","2018-10-16",642,18,34,141,50,885
"Redbridge","10:00:00","2018-10-16",1104,8,17,207,24,1360
"Tower Hamlets","10:00:00","2018-10-16",221,6,4,75,3,309
"Wandsworth","10:00:00","2018-10-16",706,59,64,396,147,1372
"Westminster","10:00:00","2018-10-16",490,42,49,188,27,796
"Camden","11:00:00","2018-10-16",5,2,0,4,0,11
"Ealing","11:00:00","2018-10-16",23,1,0,5,0,29
"Haringey","11:00:00","2018-10-16",15,1,0,6,0,22
"Hounslow","11:00:00","2018-10-16",10,0,0,11,0,21
"Kingston upon Thames","11:00:00","2018-10-16",1081,11,54,230,20,1396
"Lewisham","11:00:00","2018-10-16",1057,21,44,409,98,1629
"Merton","11:00:00","2018-10-16",513,18,28,142,38,739
"Redbridge","11:00:00","2018-10-16",1152,10,11,193,21,1387
"Tower Hamlets","11:00:00","2018-10-16",199,12,0,74,18,303
"Wandsworth","11:00:00","2018-10-16",851,64,49,393,132,1489
"Westminster","11:00:00","2018-10-16",478,45,39,205,34,801
"Camden","12:00:00","2018-10-16",1,0,0,2,0,3
"Ealing","12:00:00","2018-10-16",23,0,0,4,0,27
"Haringey","12:00:00","2018-10-16",15,1,0,6,0,22
"Hounslow","12:00:00","2018-10-16",9,1,0,5,2,17
"Kingston upon Thames","12:00:00","2018-10-16",1204,33,60,267,32,1596
"Lewisham","12:00:00","2018-10-16",1072,34,39,383,89,1617
"Merton","12:00:00","2018-10-16",606,28,31,123,26,814
"Redbridge","12:00:00","2018-10-16",1006,8,14,205,25,1258
"Tower Hamlets","12:00:00","2018-10-16",198,10,0,37,2,247
"Wandsworth","12:00:00","2018-10-16",639,64,48,378,104,1233
"Westminster","12:00:00","2018-10-16",519,55,44,169,24,811
"Camden","13:00:00","2018-10-16",2,1,0,2,0,5
"Ealing","13:00:00","2018-10-16",26,2,0,2,0,30
"Haringey","13:00:00","2018-10-16",15,2,0,6,0,23
"Hounslow","13:00:00","2018-10-16",12,0,0,8,0,20
"Kingston upon Thames","13:00:00","2018-10-16",1211,29,67,253,29,1589
"Lewisham","13:00:00","2018-10-16",1087,45,51,379,100,1662
"Merton","13:00:00","2018-10-16",587,16,29,147,44,823
"Redbridge","13:00:00","2018-10-16",1066,6,7,190,20,1289
"Tower Hamlets","13:00:00","2018-10-16",283,8,3,65,12,371
"Wandsworth","13:00:00","2018-10-16",614,63,51,298,119,1145
"Westminster","13:00:00","2018-10-16",547,79,43,177,24,870
"Camden","14:00:00","2018-10-16",2,1,0,5,0,8
"Ealing","14:00:00","2018-10-16",27,0,0,3,0,30
"Haringey","14:00:00","2018-10-16",20,1,0,5,0,26
"Hounslow","14:00:00","2018-10-16",9,0,0,7,0,16
"Kingston upon Thames","14:00:00","2018-10-16",1283,16,65,275,43,1682
"Lewisham","14:00:00","2018-10-16",1032,41,48,380,62,1563
"Merton","14:00:00","2018-10-16",580,21,31,138,45,815
"Redbridge","14:00:00","2018-10-16",1105,12,10,165,21,1313
"Tower Hamlets","14:00:00","2018-10-16",329,9,3,60,5,406
"Wandsworth","14:00:00","2018-10-16",679,53,58,374,86,1250
"Westminster","14:00:00","2018-10-16",554,54,44,168,20,840
"Camden","15:00:00","2018-10-16",6,3,0,4,0,13
"Ealing","15:00:00","2018-10-16",35,0,2,6,0,43
"Haringey","15:00:00","2018-10-16",19,2,0,5,0,26
"Hounslow","15:00:00","2018-10-16",12,0,0,1,0,13
"Kingston upon Thames","15:00:00","2018-10-16",1530,21,64,310,16,1941
"Lewisham","15:00:00","2018-10-16",1236,33,56,307,56,1688
"Merton","15:00:00","2018-10-16",755,26,29,133,41,984
"Redbridge","15:00:00","2018-10-16",1214,13,17,183,16,1443
"Tower Hamlets","15:00:00","2018-10-16",485,9,8,55,1,558
"Wandsworth","15:00:00","2018-10-16",646,88,50,330,62,1176
"Westminster","15:00:00","2018-10-16",620,55,48,138,9,870
"Camden","16:00:00","2018-10-16",1,0,0,1,0,2
"Ealing","16:00:00","2018-10-16",67,4,1,6,0,78
"Haringey","16:00:00","2018-10-16",28,0,0,5,0,33
"Hounslow","16:00:00","2018-10-16",26,0,0,3,0,29
"Kingston upon Thames","16:00:00","2018-10-16",1589,28,53,296,9,1975
"Lewisham","16:00:00","2018-10-16",1369,76,47,351,28,1871
"Merton","16:00:00","2018-10-16",800,26,44,158,19,1047
"Redbridge","16:00:00","2018-10-16",1264,21,13,185,8,1491
"Tower Hamlets","16:00:00","2018-10-16",572,25,10,77,0,684
"Wandsworth","16:00:00","2018-10-16",885,130,63,308,58,1444
"Westminster","16:00:00","2018-10-16",620,68,53,149,11,901
"Camden","17:00:00","2018-10-16",5,0,0,0,0,5
"Ealing","17:00:00","2018-10-16",17,2,0,1,0,20
"Haringey","17:00:00","2018-10-16",16,0,0,5,0,21
"Hounslow","17:00:00","2018-10-16",15,2,0,1,0,18
"Kingston upon Thames","17:00:00","2018-10-16",1634,37,49,179,7,1906
"Lewisham","17:00:00","2018-10-16",1382,96,45,261,25,1809
"Merton","17:00:00","2018-10-16",889,33,33,124,10,1089
"Redbridge","17:00:00","2018-10-16",1193,6,6,138,8,1351
"Tower Hamlets","17:00:00","2018-10-16",593,24,3,74,1,695
"Wandsworth","17:00:00","2018-10-16",970,194,66,212,39,1481
"Westminster","17:00:00","2018-10-16",645,85,51,76,3,860
"Camden","18:00:00","2018-10-16",4,1,0,0,0,5
"Ealing","18:00:00","2018-10-16",19,0,0,4,0,23
"Haringey","18:00:00","2018-10-16",31,3,0,0,0,34
"Hounslow","18:00:00","2018-10-16",17,0,0,1,0,18
"Kingston upon Thames","18:00:00","2018-10-16",1739,32,61,139,7,1978
"Lewisham","18:00:00","2018-10-16",1560,95,55,215,12,1937
"Merton","18:00:00","2018-10-16",964,38,38,90,5,1135
"Redbridge","18:00:00","2018-10-16",1356,17,8,124,8,1513
"Tower Hamlets","18:00:00","2018-10-16",486,11,2,45,0,544
"Wandsworth","18:00:00","2018-10-16",1083,248,68,160,23,1582
"Westminster","18:00:00","2018-10-16",771,108,55,47,8,989
"Barking and Dagenham","07:00:00","2018-10-17",8,0,0,1,0,9
"Barnet","07:00:00","2018-10-17",303,1,0,20,1,325
"Bromley","07:00:00","2018-10-17",103,0,0,15,1,119
"City of London","07:00:00","2018-10-17",765,279,34,585,156,1819
"Croydon","07:00:00","2018-10-17",315,4,13,55,0,387
"Hillingdon","07:00:00","2018-10-17",76,0,0,22,1,99
"Islington","07:00:00","2018-10-17",481,87,61,242,52,923
"Lambeth","07:00:00","2018-10-17",1042,181,39,400,85,1747
"Lewisham","07:00:00","2018-10-17",140,1,2,34,0,177
"Merton","07:00:00","2018-10-17",642,21,37,227,10,937
"Tower Hamlets","07:00:00","2018-10-17",383,9,27,113,5,537
"Barking and Dagenham","08:00:00","2018-10-17",15,0,2,4,0,21
"Barnet","08:00:00","2018-10-17",359,2,2,35,1,399
"Bromley","08:00:00","2018-10-17",118,0,0,13,0,131
"City of London","08:00:00","2018-10-17",764,306,45,458,157,1730
"Croydon","08:00:00","2018-10-17",476,4,13,68,7,568
"Hillingdon","08:00:00","2018-10-17",111,0,0,13,1,125
"Islington","08:00:00","2018-10-17",490,130,58,251,68,997
"Lambeth","08:00:00","2018-10-17",1148,257,43,352,92,1892
"Lewisham","08:00:00","2018-10-17",182,2,1,40,2,227
"Merton","08:00:00","2018-10-17",811,15,26,139,4,995
"Tower Hamlets","08:00:00","2018-10-17",701,12,33,119,5,870
"Barking and Dagenham","09:00:00","2018-10-17",5,0,0,2,0,7
"Barnet","09:00:00","2018-10-17",269,2,1,20,0,292
"Bromley","09:00:00","2018-10-17",71,0,0,15,2,88
"City of London","09:00:00","2018-10-17",836,184,51,520,165,1756
"Croydon","09:00:00","2018-10-17",250,3,13,57,7,330
"Hillingdon","09:00:00","2018-10-17",114,0,1,19,3,137
"Islington","09:00:00","2018-10-17",475,89,61,289,73,987
"Lambeth","09:00:00","2018-10-17",1032,113,39,356,100,1640
"Lewisham","09:00:00","2018-10-17",242,2,0,48,2,294
"Merton","09:00:00","2018-10-17",624,10,34,124,8,800
"Tower Hamlets","09:00:00","2018-10-17",524,5,32,116,9,686
"Barking and Dagenham","10:00:00","2018-10-17",4,0,0,6,0,10
"Barnet","10:00:00","2018-10-17",221,0,1,32,2,256
"Bromley","10:00:00","2018-10-17",48,0,0,7,2,57
"City of London","10:00:00","2018-10-17",802,151,47,516,183,1699
"Croydon","10:00:00","2018-10-17",255,4,13,50,8,330
"Hillingdon","10:00:00","2018-10-17",73,0,0,15,1,89
"Islington","10:00:00","2018-10-17",428,46,57,243,61,835
"Lambeth","10:00:00","2018-10-17",828,61,36,354,100,1379
"Lewisham","10:00:00","2018-10-17",102,1,0,31,1,135
"Merton","10:00:00","2018-10-17",422,12,43,111,4,592
"Tower Hamlets","10:00:00","2018-10-17",390,4,20,113,13,540
"Barking and Dagenham","11:00:00","2018-10-17",6,0,0,1,1,8
"Barnet","11:00:00","2018-10-17",191,2,0,22,1,216
"Bromley","11:00:00","2018-10-17",40,0,0,10,0,50
"City of London","11:00:00","2018-10-17",877,118,49,504,159,1707
"Croydon","11:00:00","2018-10-17",178,7,10,66,1,262
"Hillingdon","11:00:00","2018-10-17",77,0,0,17,4,98
"Islington","11:00:00","2018-10-17",484,50,54,251,58,897
"Lambeth","11:00:00","2018-10-17",918,64,36,356,84,1458
"Lewisham","11:00:00","2018-10-17",97,0,0,24,2,123
"Merton","11:00:00","2018-10-17",483,8,36,96,13,636
"Tower Hamlets","11:00:00","2018-10-17",414,6,15,100,4,539
"Barking and Dagenham","12:00:00","2018-10-17",11,0,0,5,0,16
"Barnet","12:00:00","2018-10-17",226,7,0,17,1,251
"Bromley","12:00:00","2018-10-17",31,0,0,5,2,38
"City of London","12:00:00","2018-10-17",908,131,49,483,157,1728
"Croydon","12:00:00","2018-10-17",185,11,11,56,6,269
"Hillingdon","12:00:00","2018-10-17",80,0,0,13,6,99
"Islington","12:00:00","2018-10-17",456,35,44,233,48,816
"Lambeth","12:00:00","2018-10-17",969,58,35,342,69,1473
"Lewisham","12:00:00","2018-10-17",95,1,0,28,2,126
"Merton","12:00:00","2018-10-17",472,10,36,112,13,643
"Tower Hamlets","12:00:00","2018-10-17",388,11,21,102,0,522
"Barking and Dagenham","13:00:00","2018-10-17",7,0,0,3,0,10
"Barnet","13:00:00","2018-10-17",146,5,0,21,2,174
"Bromley","13:00:00","2018-10-17",27,0,0,2,0,29
"City of London","13:00:00","2018-10-17",884,96,44,374,170,1568
"Croydon","13:00:00","2018-10-17",233,14,13,42,11,313
"Hillingdon","13:00:00","2018-10-17",76,0,0,12,8,96
"Islington","13:00:00","2018-10-17",485,64,45,273,56,923
"Lambeth","13:00:00","2018-10-17",1041,70,36,347,73,1567
"Lewisham","13:00:00","2018-10-17",139,2,0,25,0,166
"Merton","13:00:00","2018-10-17",475,9,39,130,13,666
"Tower Hamlets","13:00:00","2018-10-17",409,7,13,102,5,536
"Barking and Dagenham","14:00:00","2018-10-17",6,0,1,2,0,9
"Barnet","14:00:00","2018-10-17",231,3,0,31,0,265
"Bromley","14:00:00","2018-10-17",35,0,0,4,0,39
"City of London","14:00:00","2018-10-17",860,92,37,472,160,1621
"Croydon","14:00:00","2018-10-17",306,6,12,70,2,396
"Hillingdon","14:00:00","2018-10-17",74,0,0,13,5,92
"Islington","14:00:00","2018-10-17",518,61,67,252,47,945
"Lambeth","14:00:00","2018-10-17",1062,88,34,312,64,1560
"Lewisham","14:00:00","2018-10-17",93,3,0,23,3,122
"Merton","14:00:00","2018-10-17",685,14,31,117,18,865
"Tower Hamlets","14:00:00","2018-10-17",498,19,27,98,3,645
"Barking and Dagenham","15:00:00","2018-10-17",9,0,2,4,0,15
"Barnet","15:00:00","2018-10-17",307,4,1,19,0,331
"Bromley","15:00:00","2018-10-17",82,1,0,18,0,101
"City of London","15:00:00","2018-10-17",868,72,38,447,149,1574
"Croydon","15:00:00","2018-10-17",375,7,11,80,2,475
"Hillingdon","15:00:00","2018-10-17",89,0,0,17,3,109
"Islington","15:00:00","2018-10-17",593,49,56,244,36,978
"Lambeth","15:00:00","2018-10-17",1068,108,39,314,66,1595
"Lewisham","15:00:00","2018-10-17",196,3,5,51,1,256
"Merton","15:00:00","2018-10-17",835,13,37,113,6,1004
"Tower Hamlets","15:00:00","2018-10-17",777,31,26,92,8,934
"Barking and Dagenham","16:00:00","2018-10-17",12,0,0,0,0,12
"Barnet","16:00:00","2018-10-17",276,7,2,26,1,312
"Bromley","16:00:00","2018-10-17",47,1,0,14,0,62
"City of London","16:00:00","2018-10-17",914,160,59,286,122,1541
"Croydon","16:00:00","2018-10-17",354,15,15,72,6,462
"Hillingdon","16:00:00","2018-10-17",96,1,0,15,0,112
"Islington","16:00:00","2018-10-17",677,91,73,286,35,1162
"Lambeth","16:00:00","2018-10-17",1167,135,39,327,57,1725
"Lewisham","16:00:00","2018-10-17",205,7,3,62,1,278
"Merton","16:00:00","2018-10-17",781,18,44,122,2,967
"Tower Hamlets","16:00:00","2018-10-17",599,19,30,100,1,749
"Barking and Dagenham","17:00:00","2018-10-17",15,1,0,3,0,19
"Barnet","17:00:00","2018-10-17",319,9,0,23,1,352
"Bromley","17:00:00","2018-10-17",81,0,0,17,0,98
"City of London","17:00:00","2018-10-17",856,234,70,277,97,1534
"Croydon","17:00:00","2018-10-17",368,9,12,65,1,455
"Hillingdon","17:00:00","2018-10-17",108,1,0,13,1,123
"Islington","17:00:00","2018-10-17",806,169,61,258,22,1316
"Lambeth","17:00:00","2018-10-17",1414,200,34,269,50,1967
"Lewisham","17:00:00","2018-10-17",234,6,0,32,2,274
"Merton","17:00:00","2018-10-17",722,21,40,116,4,903
"Tower Hamlets","17:00:00","2018-10-17",637,29,22,82,6,776
"Barking and Dagenham","18:00:00","2018-10-17",9,0,0,0,0,9
"Barnet","18:00:00","2018-10-17",304,11,0,15,0,330
"Bromley","18:00:00","2018-10-17",66,0,0,6,0,72
"City of London","18:00:00","2018-10-17",852,234,66,284,97,1533
"Croydon","18:00:00","2018-10-17",380,9,14,60,0,463
"Hillingdon","18:00:00","2018-10-17",78,2,0,8,0,88
"Islington","18:00:00","2018-10-17",884,138,65,168,13,1268
"Lambeth","18:00:00","2018-10-17",1413,241,28,229,29,1940
"Lewisham","18:00:00","2018-10-17",148,7,0,32,0,187
"Merton","18:00:00","2018-10-17",651,28,39,99,0,817
"Tower Hamlets","18:00:00","2018-10-17",590,18,19,66,8,701
"Barnet","07:00:00","2018-10-18",462,10,3,109,10,594
"Bromley","07:00:00","2018-10-18",729,10,11,182,19,951
"Ealing","07:00:00","2018-10-18",954,4,8,217,13,1196
"Enfield","07:00:00","2018-10-18",318,6,18,76,10,428
"Hillingdon","07:00:00","2018-10-18",877,8,14,162,24,1085
"Hounslow","07:00:00","2018-10-18",739,15,6,133,13,906
"Islington","07:00:00","2018-10-18",120,6,2,47,8,183
"Merton","07:00:00","2018-10-18",270,2,12,48,15,347
"Wandsworth","07:00:00","2018-10-18",116,5,0,10,0,131
"Barnet","08:00:00","2018-10-18",695,4,4,71,11,785
"Bromley","08:00:00","2018-10-18",963,10,18,144,17,1152
"Ealing","08:00:00","2018-10-18",978,13,11,190,16,1208
"Enfield","08:00:00","2018-10-18",397,6,20,74,20,517
"Hillingdon","08:00:00","2018-10-18",1058,11,14,127,35,1245
"Hounslow","08:00:00","2018-10-18",913,10,4,122,19,1068
"Islington","08:00:00","2018-10-18",133,9,2,55,2,201
"Merton","08:00:00","2018-10-18",278,6,9,71,14,378
"Wandsworth","08:00:00","2018-10-18",125,2,0,18,1,146
"Barnet","09:00:00","2018-10-18",532,6,5,74,20,637
"Bromley","09:00:00","2018-10-18",688,10,10,130,15,853
"Ealing","09:00:00","2018-10-18",628,5,14,183,34,864
"Enfield","09:00:00","2018-10-18",246,9,18,78,18,369
"Hillingdon","09:00:00","2018-10-18",880,9,14,154,32,1089
"Hounslow","09:00:00","2018-10-18",889,12,9,148,17,1075
"Islington","09:00:00","2018-10-18",148,7,0,68,5,228
"Merton","09:00:00","2018-10-18",169,5,14,75,18,281
"Wandsworth","09:00:00","2018-10-18",80,0,0,18,2,100
"Barnet","10:00:00","2018-10-18",473,7,1,81,10,572
"Bromley","10:00:00","2018-10-18",569,6,11,105,21,712
"Ealing","10:00:00","2018-10-18",548,7,8,174,30,767
"Enfield","10:00:00","2018-10-18",204,5,13,63,20,305
"Hillingdon","10:00:00","2018-10-18",854,10,9,187,25,1085
"Hounslow","10:00:00","2018-10-18",702,6,8,116,19,851
"Islington","10:00:00","2018-10-18",109,8,0,71,8,196
"Merton","10:00:00","2018-10-18",182,0,8,60,16,266
"Wandsworth","10:00:00","2018-10-18",59,2,0,16,3,80
"Barnet","11:00:00","2018-10-18",485,6,3,86,17,597
"Bromley","11:00:00","2018-10-18",675,11,10,149,22,867
"Ealing","11:00:00","2018-10-18",566,3,9,170,20,768
"Enfield","11:00:00","2018-10-18",214,3,16,68,25,326
"Hillingdon","11:00:00","2018-10-18",929,7,13,171,48,1168
"Hounslow","11:00:00","2018-10-18",637,13,6,113,25,794
"Islington","11:00:00","2018-10-18",130,14,0,74,3,221
"Merton","11:00:00","2018-10-18",215,4,6,60,16,301
"Wandsworth","11:00:00","2018-10-18",61,0,0,6,1,68
"Barnet","12:00:00","2018-10-18",495,6,4,99,12,616
"Bromley","12:00:00","2018-10-18",638,9,12,156,10,825
"Ealing","12:00:00","2018-10-18",603,9,8,156,34,810
"Enfield","12:00:00","2018-10-18",235,6,17,68,23,349
"Hillingdon","12:00:00","2018-10-18",983,13,12,162,31,1201
"Hounslow","12:00:00","2018-10-18",689,17,1,108,20,835
"Islington","12:00:00","2018-10-18",147,16,0,78,4,245
"Merton","12:00:00","2018-10-18",206,7,8,62,18,301
"Wandsworth","12:00:00","2018-10-18",66,3,0,11,0,80
"Barnet","13:00:00","2018-10-18",539,12,3,78,14,646
"Bromley","13:00:00","2018-10-18",613,8,12,138,20,791
"Ealing","13:00:00","2018-10-18",662,7,8,131,30,838
"Enfield","13:00:00","2018-10-18",258,6,11,74,19,368
"Hillingdon","13:00:00","2018-10-18",889,9,14,183,23,1118
"Hounslow","13:00:00","2018-10-18",772,22,4,99,12,909
"Islington","13:00:00","2018-10-18",137,17,0,61,6,221
"Merton","13:00:00","2018-10-18",228,20,3,75,29,355
"Wandsworth","13:00:00","2018-10-18",58,2,0,15,0,75
"Barnet","14:00:00","2018-10-18",553,6,3,86,21,669
"Bromley","14:00:00","2018-10-18",649,6,9,146,14,824
"Ealing","14:00:00","2018-10-18",697,12,7,148,27,891
"Enfield","14:00:00","2018-10-18",274,5,14,68,33,394
"Hillingdon","14:00:00","2018-10-18",914,7,9,183,37,1150
"Hounslow","14:00:00","2018-10-18",744,13,4,97,17,875
"Islington","14:00:00","2018-10-18",165,20,1,69,2,257
"Merton","14:00:00","2018-10-18",237,4,8,54,20,323
"Wandsworth","14:00:00","2018-10-18",58,2,0,16,1,77
"Barnet","15:00:00","2018-10-18",596,5,6,88,16,711
"Bromley","15:00:00","2018-10-18",898,8,8,154,16,1084
"Ealing","15:00:00","2018-10-18",802,8,10,158,28,1006
"Enfield","15:00:00","2018-10-18",365,11,14,65,13,468
"Hillingdon","15:00:00","2018-10-18",1103,10,19,156,25,1313
"Hounslow","15:00:00","2018-10-18",726,19,5,100,10,860
"Islington","15:00:00","2018-10-18",199,10,5,64,3,281
"Merton","15:00:00","2018-10-18",235,9,11,65,23,343
"Wandsworth","15:00:00","2018-10-18",76,2,0,16,0,94
"Barnet","16:00:00","2018-10-18",793,8,8,87,1,897
"Bromley","16:00:00","2018-10-18",897,15,16,167,19,1114
"Ealing","16:00:00","2018-10-18",924,14,9,180,16,1143
"Enfield","16:00:00","2018-10-18",390,6,20,68,24,508
"Hillingdon","16:00:00","2018-10-18",911,10,11,179,11,1122
"Hounslow","16:00:00","2018-10-18",972,13,5,98,10,1098
"Islington","16:00:00","2018-10-18",236,15,0,93,0,344
"Merton","16:00:00","2018-10-18",253,5,8,38,9,313
"Wandsworth","16:00:00","2018-10-18",84,3,0,13,0,100
"Barnet","17:00:00","2018-10-18",799,12,7,94,1,913
"Bromley","17:00:00","2018-10-18",932,13,12,157,10,1124
"Ealing","17:00:00","2018-10-18",1130,12,6,166,16,1330
"Enfield","17:00:00","2018-10-18",448,5,13,77,9,552
"Hillingdon","17:00:00","2018-10-18",978,7,12,122,12,1131
"Hounslow","17:00:00","2018-10-18",1050,17,6,92,9,1174
"Islington","17:00:00","2018-10-18",246,24,2,75,3,350
"Merton","17:00:00","2018-10-18",254,5,10,38,7,314
"Wandsworth","17:00:00","2018-10-18",88,9,0,8,0,105
"Barnet","18:00:00","2018-10-18",744,10,2,60,3,819
"Bromley","18:00:00","2018-10-18",983,9,11,126,6,1135
"Ealing","18:00:00","2018-10-18",1028,11,7,173,13,1232
"Enfield","18:00:00","2018-10-18",478,9,9,78,5,579
"Hillingdon","18:00:00","2018-10-18",1012,7,14,133,9,1175
"Hounslow","18:00:00","2018-10-18",990,20,6,83,3,1102
"Islington","18:00:00","2018-10-18",260,40,1,56,1,358
"Merton","18:00:00","2018-10-18",206,1,7,24,1,239
"Wandsworth","18:00:00","2018-10-18",102,5,0,4,0,111
"Barking and Dagenham","07:00:00","2018-10-19",28,1,0,11,0,40
"Bromley","07:00:00","2018-10-19",45,1,0,11,0,57
"Croydon","07:00:00","2018-10-19",1082,18,15,208,17,1340
"Ealing","07:00:00","2018-10-19",144,0,2,33,1,180
"Enfield","07:00:00","2018-10-19",3279,87,56,1143,251,4816
"Richmond upon Thames","07:00:00","2018-10-19",2507,73,72,597,60,3309
"Sutton","07:00:00","2018-10-19",1090,12,29,168,16,1315
"Tower Hamlets","07:00:00","2018-10-19",89,0,1,22,0,112
"Westminster","07:00:00","2018-10-19",560,79,94,420,81,1234
"Barking and Dagenham","08:00:00","2018-10-19",28,1,0,4,0,33
"Bromley","08:00:00","2018-10-19",77,0,0,8,0,85
"Croydon","08:00:00","2018-10-19",1148,31,16,202,21,1418
"Ealing","08:00:00","2018-10-19",260,7,0,32,3,302
"Enfield","08:00:00","2018-10-19",3550,83,51,1119,294,5097
"Richmond upon Thames","08:00:00","2018-10-19",2383,68,66,413,62,2992
"Sutton","08:00:00","2018-10-19",1190,12,31,186,21,1440
"Tower Hamlets","08:00:00","2018-10-19",142,1,4,32,2,181
"Westminster","08:00:00","2018-10-19",545,39,77,212,85,958
"Barking and Dagenham","09:00:00","2018-10-19",27,0,0,5,3,35
"Bromley","09:00:00","2018-10-19",42,0,0,4,0,46
"Croydon","09:00:00","2018-10-19",836,16,20,185,17,1074
"Ealing","09:00:00","2018-10-19",152,1,1,28,2,184
"Enfield","09:00:00","2018-10-19",3315,48,51,958,345,4717
"Richmond upon Thames","09:00:00","2018-10-19",1976,37,54,512,88,2667
"Sutton","09:00:00","2018-10-19",1079,14,33,195,25,1346
"Tower Hamlets","09:00:00","2018-10-19",120,3,0,38,0,161
"Westminster","09:00:00","2018-10-19",583,37,84,283,70,1057
"Barking and Dagenham","10:00:00","2018-10-19",24,0,0,9,1,34
"Bromley","10:00:00","2018-10-19",42,0,0,8,0,50
"Croydon","10:00:00","2018-10-19",779,15,26,185,27,1032
"Ealing","10:00:00","2018-10-19",113,1,0,26,4,144
"Enfield","10:00:00","2018-10-19",2791,37,49,1146,387,4410
"Richmond upon Thames","10:00:00","2018-10-19",1994,26,46,468,70,2604
"Sutton","10:00:00","2018-10-19",1008,11,27,215,31,1292
"Tower Hamlets","10:00:00","2018-10-19",108,1,0,42,9,160
"Westminster","10:00:00","2018-10-19",627,48,79,297,70,1121
"Barking and Dagenham","11:00:00","2018-10-19",21,0,0,9,0,30
"Bromley","11:00:00","2018-10-19",55,0,0,9,0,64
"Croydon","11:00:00","2018-10-19",821,20,21,184,28,1074
"Ealing","11:00:00","2018-10-19",80,2,0,20,2,104
"Enfield","11:00:00","2018-10-19",2690,50,42,1031,388,4201
"Richmond upon Thames","11:00:00","2018-10-19",1909,33,35,498,80,2555
"Sutton","11:00:00","2018-10-19",1185,17,32,230,26,1490
"Tower Hamlets","11:00:00","2018-10-19",112,2,0,49,2,165
"Westminster","11:00:00","2018-10-19",614,38,64,302,74,1092
"Barking and Dagenham","12:00:00","2018-10-19",25,1,0,4,1,31
"Bromley","12:00:00","2018-10-19",52,0,0,8,0,60
"Croydon","12:00:00","2018-10-19",849,23,19,182,15,1088
"Ealing","12:00:00","2018-10-19",89,0,0,24,2,115
"Enfield","12:00:00","2018-10-19",2548,49,51,982,347,3977
"Richmond upon Thames","12:00:00","2018-10-19",2245,41,37,543,82,2948
"Sutton","12:00:00","2018-10-19",1263,14,29,251,22,1579
"Tower Hamlets","12:00:00","2018-10-19",119,5,0,46,0,170
"Westminster","12:00:00","2018-10-19",801,76,81,274,51,1283
"Barking and Dagenham","13:00:00","2018-10-19",22,2,0,5,0,29
"Bromley","13:00:00","2018-10-19",66,5,1,10,0,82
"Croydon","13:00:00","2018-10-19",831,32,26,206,22,1117
"Ealing","13:00:00","2018-10-19",107,3,0,22,1,133
"Enfield","13:00:00","2018-10-19",2776,49,43,973,358,4199
"Richmond upon Thames","13:00:00","2018-10-19",2248,51,42,549,77,2967
"Sutton","13:00:00","2018-10-19",1099,13,29,226,24,1391
"Tower Hamlets","13:00:00","2018-10-19",155,6,0,38,1,200
"Westminster","13:00:00","2018-10-19",828,65,76,258,58,1285
"Barking and Dagenham","14:00:00","2018-10-19",25,0,0,2,1,28
"Bromley","14:00:00","2018-10-19",68,2,4,8,2,84
"Croydon","14:00:00","2018-10-19",870,19,19,219,12,1139
"Ealing","14:00:00","2018-10-19",117,4,0,20,7,148
"Enfield","14:00:00","2018-10-19",2937,64,62,1049,291,4403
"Richmond upon Thames","14:00:00","2018-10-19",2295,40,55,548,86,3024
"Sutton","14:00:00","2018-10-19",1107,5,28,194,22,1356
"Tower Hamlets","14:00:00","2018-10-19",183,4,0,48,0,235
"Westminster","14:00:00","2018-10-19",699,58,68,245,37,1107
"Barking and Dagenham","15:00:00","2018-10-19",25,0,0,4,0,29
"Bromley","15:00:00","2018-10-19",57,0,0,5,0,62
"Croydon","15:00:00","2018-10-19",878,14,16,201,16,1125
"Ealing","15:00:00","2018-10-19",171,5,0,30,2,208
"Enfield","15:00:00","2018-10-19",3224,51,49,995,337,4656
"Richmond upon Thames","15:00:00","2018-10-19",2535,64,56,517,48,3220
"Sutton","15:00:00","2018-10-19",1188,15,30,220,20,1473
"Tower Hamlets","15:00:00","2018-10-19",197,5,2,46,1,251
"Westminster","15:00:00","2018-10-19",865,86,87,281,37,1356
"Barking and Dagenham","16:00:00","2018-10-19",37,0,0,2,2,41
"Bromley","16:00:00","2018-10-19",87,2,0,13,0,102
"Croydon","16:00:00","2018-10-19",1244,33,26,201,12,1516
"Ealing","16:00:00","2018-10-19",238,4,0,54,2,298
"Enfield","16:00:00","2018-10-19",3214,81,51,897,254,4497
"Sutton","16:00:00","2018-10-19",1120,9,38,231,24,1422
"Tower Hamlets","16:00:00","2018-10-19",185,9,2,36,3,235
"Westminster","16:00:00","2018-10-19",881,101,75,216,32,1305
"Barking and Dagenham","17:00:00","2018-10-19",42,2,0,1,0,45
"Bromley","17:00:00","2018-10-19",63,0,0,7,0,70
"Croydon","17:00:00","2018-10-19",1047,47,13,144,3,1254
"Ealing","17:00:00","2018-10-19",266,2,0,53,3,324
"Enfield","17:00:00","2018-10-19",2660,115,46,702,179,3702
"Sutton","17:00:00","2018-10-19",1312,20,36,191,8,1567
"Tower Hamlets","17:00:00","2018-10-19",215,4,2,37,0,258
"Westminster","17:00:00","2018-10-19",918,117,83,149,14,1281
"Barking and Dagenham","18:00:00","2018-10-19",32,3,0,4,0,39
"Bromley","18:00:00","2018-10-19",63,0,0,4,0,67
"Croydon","18:00:00","2018-10-19",1304,46,25,126,1,1502
"Ealing","18:00:00","2018-10-19",232,4,0,28,2,266
"Enfield","18:00:00","2018-10-19",2466,75,41,597,126,3305
"Sutton","18:00:00","2018-10-19",1110,11,32,138,2,1293
"Tower Hamlets","18:00:00","2018-10-19",207,13,0,22,0,242
"Westminster","18:00:00","2018-10-19",949,124,91,106,12,1282
"Barking and Dagenham","07:00:00","2018-10-29",179,2,8,46,12,247
"Bromley","07:00:00","2018-10-29",881,8,18,174,10,1091
"Ealing","07:00:00","2018-10-29",664,40,10,313,48,1075
"Lambeth","07:00:00","2018-10-29",1132,292,313,674,111,2522
"Westminster","07:00:00","2018-10-29",70,5,1,25,3,104
"Barking and Dagenham","08:00:00","2018-10-29",241,2,9,46,6,304
"Bromley","08:00:00","2018-10-29",772,7,16,133,15,943
"Ealing","08:00:00","2018-10-29",838,48,11,309,43,1249
"Lambeth","08:00:00","2018-10-29",1145,364,291,501,96,2397
"Westminster","08:00:00","2018-10-29",92,10,0,21,4,127
"Barking and Dagenham","09:00:00","2018-10-29",242,2,7,60,12,323
"Bexley","09:00:00","2018-10-29",3836,64,32,1035,436,5403
"Bromley","09:00:00","2018-10-29",776,0,19,119,14,928
"Ealing","09:00:00","2018-10-29",849,54,14,316,58,1291
"Lambeth","09:00:00","2018-10-29",1192,209,350,505,118,2374
"Westminster","09:00:00","2018-10-29",98,5,0,21,6,130
"Barking and Dagenham","10:00:00","2018-10-29",206,1,6,55,9,277
"Bexley","10:00:00","2018-10-29",4009,39,26,1155,519,5748
"Bromley","10:00:00","2018-10-29",731,4,23,98,14,870
"Ealing","10:00:00","2018-10-29",589,32,15,190,48,874
"Lambeth","10:00:00","2018-10-29",1261,106,325,534,90,2316
"Westminster","10:00:00","2018-10-29",99,2,0,24,3,128
"Barking and Dagenham","11:00:00","2018-10-29",229,2,8,64,15,318
"Bexley","11:00:00","2018-10-29",3869,35,15,1046,487,5452
"Bromley","11:00:00","2018-10-29",632,8,18,100,12,770
"Ealing","11:00:00","2018-10-29",694,43,20,244,60,1061
"Lambeth","11:00:00","2018-10-29",1156,89,306,489,68,2108
"Westminster","11:00:00","2018-10-29",87,6,0,22,2,117
"Barking and Dagenham","12:00:00","2018-10-29",252,4,5,57,24,342
"Bexley","12:00:00","2018-10-29",4099,40,12,1187,491,5829
"Bromley","12:00:00","2018-10-29",621,7,13,98,13,752
"Ealing","12:00:00","2018-10-29",562,37,16,269,77,961
"Lambeth","12:00:00","2018-10-29",1202,136,329,525,67,2259
"Westminster","12:00:00","2018-10-29",96,4,0,21,4,125
"Barking and Dagenham","13:00:00","2018-10-29",271,2,7,70,17,367
"Bexley","13:00:00","2018-10-29",4134,55,13,1261,479,5942
"Bromley","13:00:00","2018-10-29",609,5,10,92,16,732
"Ealing","13:00:00","2018-10-29",685,40,16,270,80,1091
"Lambeth","13:00:00","2018-10-29",1252,142,309,514,78,2295
"Westminster","13:00:00","2018-10-29",100,4,0,30,4,138
"Barking and Dagenham","14:00:00","2018-10-29",288,2,7,62,23,382
"Bromley","14:00:00","2018-10-29",636,6,18,127,15,802
"Ealing","14:00:00","2018-10-29",615,39,21,242,66,983
"Lambeth","14:00:00","2018-10-29",1196,134,328,495,59,2212
"Westminster","14:00:00","2018-10-29",114,3,0,24,2,143
"Barking and Dagenham","15:00:00","2018-10-29",271,3,10,58,12,354
"Bromley","15:00:00","2018-10-29",756,3,17,116,7,899
"Ealing","15:00:00","2018-10-29",775,46,21,311,66,1219
"Lambeth","15:00:00","2018-10-29",1343,149,336,545,69,2442
"Westminster","15:00:00","2018-10-29",127,5,0,24,1,157
"Barking and Dagenham","16:00:00","2018-10-29",313,2,7,54,7,383
"Bromley","16:00:00","2018-10-29",890,7,16,158,1,1072
"Ealing","16:00:00","2018-10-29",821,49,23,260,36,1189
"Lambeth","16:00:00","2018-10-29",1477,217,337,459,42,2532
"Westminster","16:00:00","2018-10-29",149,8,2,24,2,185
"Barking and Dagenham","17:00:00","2018-10-29",356,1,6,52,7,422
"Bromley","17:00:00","2018-10-29",1013,11,15,109,2,1150
"Ealing","17:00:00","2018-10-29",849,55,12,183,22,1121
"Lambeth","17:00:00","2018-10-29",1477,289,372,406,43,2587
"Westminster","17:00:00","2018-10-29",145,7,0,19,2,173
"Barking and Dagenham","18:00:00","2018-10-29",304,4,9,51,0,368
"Bromley","18:00:00","2018-10-29",876,6,16,48,0,946
"Ealing","18:00:00","2018-10-29",914,48,13,126,19,1120
"Westminster","18:00:00","2018-10-29",133,4,1,11,3,152
"Hounslow","07:00:00","2018-10-30",252,5,0,40,0,297
"Islington","07:00:00","2018-10-30",1045,180,116,493,93,1927
"Lambeth","07:00:00","2018-10-30",93,5,0,21,2,121
"Tower Hamlets","07:00:00","2018-10-30",1007,294,36,529,322,2188
"Hounslow","08:00:00","2018-10-30",339,11,0,33,0,383
"Islington","08:00:00","2018-10-30",1021,262,126,452,99,1960
"Lambeth","08:00:00","2018-10-30",141,6,0,12,0,159
"Tower Hamlets","08:00:00","2018-10-30",1178,288,54,572,294,2386
"Hounslow","09:00:00","2018-10-30",228,3,0,21,0,252
"Islington","09:00:00","2018-10-30",1138,177,128,477,99,2019
"Lambeth","09:00:00","2018-10-30",133,2,0,17,0,152
"Tower Hamlets","09:00:00","2018-10-30",1017,142,85,533,320,2097
"Hounslow","10:00:00","2018-10-30",154,3,0,33,0,190
"Islington","10:00:00","2018-10-30",952,125,137,510,108,1832
"Lambeth","10:00:00","2018-10-30",115,0,0,13,4,132
"Tower Hamlets","10:00:00","2018-10-30",982,79,104,677,301,2143
"Hounslow","11:00:00","2018-10-30",126,0,0,27,0,153
"Islington","11:00:00","2018-10-30",947,119,129,516,89,1800
"Lambeth","11:00:00","2018-10-30",110,4,0,22,3,139
"Tower Hamlets","11:00:00","2018-10-30",985,82,94,526,295,1982
"Hounslow","12:00:00","2018-10-30",109,0,0,19,0,128
"Islington","12:00:00","2018-10-30",899,152,124,484,104,1763
"Lambeth","12:00:00","2018-10-30",97,3,0,16,1,117
"Tower Hamlets","12:00:00","2018-10-30",1082,85,93,495,249,2004
"Hounslow","13:00:00","2018-10-30",125,1,0,23,0,149
"Islington","13:00:00","2018-10-30",873,128,131,470,75,1677
"Lambeth","13:00:00","2018-10-30",105,4,0,23,3,135
"Tower Hamlets","13:00:00","2018-10-30",1116,77,85,487,268,2033
"Hounslow","14:00:00","2018-10-30",141,2,0,20,0,163
"Islington","14:00:00","2018-10-30",896,149,134,470,78,1727
"Lambeth","14:00:00","2018-10-30",156,1,0,27,0,184
"Tower Hamlets","14:00:00","2018-10-30",992,85,71,471,279,1898
"Hounslow","15:00:00","2018-10-30",227,4,0,21,0,252
"Islington","15:00:00","2018-10-30",976,168,126,451,53,1774
"Lambeth","15:00:00","2018-10-30",179,9,0,28,0,216
"Tower Hamlets","15:00:00","2018-10-30",997,114,74,495,219,1899
"Hounslow","16:00:00","2018-10-30",271,7,0,33,0,311
"Islington","16:00:00","2018-10-30",1010,183,128,390,34,1745
"Lambeth","16:00:00","2018-10-30",206,8,0,30,0,244
"Tower Hamlets","16:00:00","2018-10-30",1132,117,78,425,178,1930
"Hounslow","17:00:00","2018-10-30",311,5,0,15,0,331
"Islington","17:00:00","2018-10-30",1213,329,116,321,25,2004
"Lambeth","17:00:00","2018-10-30",236,9,0,36,0,281
"Tower Hamlets","17:00:00","2018-10-30",1241,337,90,320,117,2105
"Hounslow","18:00:00","2018-10-30",224,1,0,11,2,238
"Islington","18:00:00","2018-10-30",1152,242,124,243,11,1772
"Lambeth","18:00:00","2018-10-30",253,8,0,28,1,290
"Tower Hamlets","18:00:00","2018-10-30",1495,410,122,331,76,2434
"Redbridge","07:00:00","2018-10-31",855,23,20,241,20,1159
"Southwark","07:00:00","2018-10-31",986,119,119,448,74,1746
"Redbridge","08:00:00","2018-10-31",1129,18,30,231,16,1424
"Southwark","08:00:00","2018-10-31",1084,140,118,448,65,1855
"Redbridge","09:00:00","2018-10-31",997,18,30,191,16,1252
"Southwark","09:00:00","2018-10-31",914,72,122,371,70,1549
"Redbridge","10:00:00","2018-10-31",937,10,28,186,10,1171
"Southwark","10:00:00","2018-10-31",945,35,124,399,69,1572
"Redbridge","11:00:00","2018-10-31",1040,11,25,178,19,1273
"Southwark","11:00:00","2018-10-31",987,44,128,375,91,1625
"Redbridge","12:00:00","2018-10-31",1013,13,25,197,10,1258
"Southwark","12:00:00","2018-10-31",918,34,100,368,79,1499
"Redbridge","13:00:00","2018-10-31",1015,11,35,193,17,1271
"Southwark","13:00:00","2018-10-31",982,46,112,359,65,1564
"Redbridge","14:00:00","2018-10-31",1069,16,37,205,17,1344
"Southwark","14:00:00","2018-10-31",959,69,108,366,59,1561
"Redbridge","15:00:00","2018-10-31",1257,29,35,257,7,1585
"Southwark","15:00:00","2018-10-31",998,70,110,312,38,1528
"Redbridge","16:00:00","2018-10-31",1103,26,32,230,1,1392
"Southwark","16:00:00","2018-10-31",1156,89,117,308,35,1705
"Redbridge","17:00:00","2018-10-31",1421,22,40,269,11,1763
"Southwark","17:00:00","2018-10-31",1218,109,104,208,18,1657
"Redbridge","18:00:00","2018-10-31",1018,15,38,133,3,1207
"Southwark","18:00:00","2018-10-31",1425,123,118,190,7,1863
"Haringey","07:00:00","2018-11-01",688,18,26,206,13,951
"Southwark","07:00:00","2018-11-01",445,163,134,250,53,1045
"Haringey","08:00:00","2018-11-01",763,10,27,158,12,970
"Southwark","08:00:00","2018-11-01",593,147,139,327,31,1237
"Haringey","09:00:00","2018-11-01",801,9,26,151,12,999
"Southwark","09:00:00","2018-11-01",530,128,137,263,34,1092
"Haringey","10:00:00","2018-11-01",701,6,22,171,17,917
"Southwark","10:00:00","2018-11-01",627,84,127,286,40,1164
"Haringey","11:00:00","2018-11-01",570,9,24,146,16,765
"Southwark","11:00:00","2018-11-01",583,65,129,313,25,1115
"Haringey","12:00:00","2018-11-01",595,10,25,175,13,818
"Southwark","12:00:00","2018-11-01",705,105,126,289,45,1270
"Haringey","13:00:00","2018-11-01",709,11,21,183,19,943
"Southwark","13:00:00","2018-11-01",622,107,114,247,35,1125
"Haringey","14:00:00","2018-11-01",769,13,22,174,19,997
"Southwark","14:00:00","2018-11-01",605,96,136,282,30,1149
"Haringey","15:00:00","2018-11-01",786,9,24,190,18,1027
"Southwark","15:00:00","2018-11-01",668,103,123,212,28,1134
"Haringey","16:00:00","2018-11-01",850,11,26,190,9,1086
"Southwark","16:00:00","2018-11-01",681,144,123,273,18,1239
"Haringey","17:00:00","2018-11-01",894,12,24,158,3,1091
"Southwark","17:00:00","2018-11-01",765,244,132,211,20,1372
"Haringey","18:00:00","2018-11-01",883,18,24,115,3,1043
"Southwark","18:00:00","2018-11-01",1193,292,134,150,10,1779
"Kensington and Chelsea","07:00:00","2018-11-02",15,1,1,7,0,24
"Southwark","07:00:00","2018-11-02",372,162,222,260,33,1049
"Wandsworth","07:00:00","2018-11-02",716,41,27,306,69,1159
"Westminster","07:00:00","2018-11-02",539,65,65,253,56,978
"Kensington and Chelsea","08:00:00","2018-11-02",31,3,0,6,0,40
"Southwark","08:00:00","2018-11-02",376,165,212,161,26,940
"Wandsworth","08:00:00","2018-11-02",992,38,37,421,97,1585
"Westminster","08:00:00","2018-11-02",623,65,53,248,66,1055
"Kensington and Chelsea","09:00:00","2018-11-02",26,1,0,19,0,46
"Southwark","09:00:00","2018-11-02",376,98,231,194,29,928
"Wandsworth","09:00:00","2018-11-02",842,35,24,339,88,1328
"Westminster","09:00:00","2018-11-02",605,45,52,198,50,950
"Kensington and Chelsea","10:00:00","2018-11-02",24,5,0,16,0,45
"Southwark","10:00:00","2018-11-02",433,68,208,244,33,986
"Wandsworth","10:00:00","2018-11-02",746,45,23,386,131,1331
"Westminster","10:00:00","2018-11-02",596,34,51,215,48,944
"Kensington and Chelsea","11:00:00","2018-11-02",35,5,0,14,2,56
"Southwark","11:00:00","2018-11-02",414,74,195,255,33,971
"Wandsworth","11:00:00","2018-11-02",713,40,29,384,130,1296
"Westminster","11:00:00","2018-11-02",620,44,52,204,39,959
"Kensington and Chelsea","12:00:00","2018-11-02",28,6,0,11,1,46
"Southwark","12:00:00","2018-11-02",422,77,197,246,30,972
"Wandsworth","12:00:00","2018-11-02",811,48,25,359,74,1317
"Westminster","12:00:00","2018-11-02",615,60,50,188,44,957
"Kensington and Chelsea","13:00:00","2018-11-02",28,6,0,11,0,45
"Southwark","13:00:00","2018-11-02",492,73,196,259,23,1043
"Wandsworth","13:00:00","2018-11-02",842,45,39,335,60,1321
"Westminster","13:00:00","2018-11-02",606,55,54,190,42,947
"Kensington and Chelsea","14:00:00","2018-11-02",30,6,0,9,0,45
"Southwark","14:00:00","2018-11-02",498,61,206,242,20,1027
"Wandsworth","14:00:00","2018-11-02",852,67,35,325,97,1376
"Westminster","14:00:00","2018-11-02",718,49,59,203,22,1051
"Kensington and Chelsea","15:00:00","2018-11-02",28,6,0,8,1,43
"Southwark","15:00:00","2018-11-02",501,91,198,205,14,1009
"Wandsworth","15:00:00","2018-11-02",962,95,21,376,90,1544
"Westminster","15:00:00","2018-11-02",741,54,55,208,23,1081
"Kensington and Chelsea","16:00:00","2018-11-02",48,7,0,5,0,60
"Southwark","16:00:00","2018-11-02",528,142,228,173,25,1096
"Wandsworth","16:00:00","2018-11-02",962,79,24,328,40,1433
"Westminster","16:00:00","2018-11-02",793,71,47,181,18,1110
"Kensington and Chelsea","17:00:00","2018-11-02",28,2,0,5,0,35
"Southwark","17:00:00","2018-11-02",563,190,237,140,13,1143
"Wandsworth","17:00:00","2018-11-02",1089,152,22,332,30,1625
"Westminster","17:00:00","2018-11-02",911,77,49,157,15,1209
"Kensington and Chelsea","18:00:00","2018-11-02",24,5,0,3,0,32
"Southwark","18:00:00","2018-11-02",759,126,231,90,9,1215
"Wandsworth","18:00:00","2018-11-02",906,196,25,302,34,1463
"Westminster","18:00:00","2018-11-02",806,77,48,81,4,1016
"Bexley","07:00:00","2019-03-15",3047,86,25,1070,194,4422
"Brent","07:00:00","2019-03-15",219,11,29,56,28,343
"Croydon","07:00:00","2019-03-15",53,1,0,13,2,69
"Ealing","07:00:00","2019-03-15",681,10,46,153,17,907
"Hackney","07:00:00","2019-03-15",240,44,42,138,37,501
"Havering","07:00:00","2019-03-15",936,11,17,232,27,1223
"Hillingdon","07:00:00","2019-03-15",23,0,0,7,0,30
"Islington","07:00:00","2019-03-15",233,4,29,68,8,342
"Bexley","08:00:00","2019-03-15",3082,75,15,685,176,4033
"Brent","08:00:00","2019-03-15",266,10,33,64,44,417
"Croydon","08:00:00","2019-03-15",72,1,0,8,0,81
"Ealing","08:00:00","2019-03-15",730,14,30,106,14,894
"Hackney","08:00:00","2019-03-15",246,38,34,120,22,460
"Havering","08:00:00","2019-03-15",1147,9,12,163,26,1357
"Hillingdon","08:00:00","2019-03-15",52,0,1,10,0,63
"Islington","08:00:00","2019-03-15",269,2,31,77,31,410
"Bexley","09:00:00","2019-03-15",3042,43,10,759,182,4036
"Brent","09:00:00","2019-03-15",376,15,31,67,24,513
"Croydon","09:00:00","2019-03-15",55,1,0,11,1,68
"Ealing","09:00:00","2019-03-15",564,3,38,115,11,731
"Hackney","09:00:00","2019-03-15",223,29,30,100,22,404
"Havering","09:00:00","2019-03-15",918,6,5,168,27,1124
"Hillingdon","09:00:00","2019-03-15",26,0,0,6,0,32
"Islington","09:00:00","2019-03-15",300,4,42,81,16,443
"Bexley","10:00:00","2019-03-15",2985,26,16,706,181,3914
"Brent","10:00:00","2019-03-15",350,24,35,92,42,543
"Croydon","10:00:00","2019-03-15",42,3,0,14,1,60
"Ealing","10:00:00","2019-03-15",558,10,35,175,18,796
"Hackney","10:00:00","2019-03-15",327,21,33,123,17,521
"Havering","10:00:00","2019-03-15",940,4,13,182,28,1167
"Hillingdon","10:00:00","2019-03-15",17,0,0,5,0,22
"Islington","10:00:00","2019-03-15",255,3,38,73,13,382
"Bexley","11:00:00","2019-03-15",2867,30,8,705,146,3756
"Brent","11:00:00","2019-03-15",363,24,29,108,37,561
"Croydon","11:00:00","2019-03-15",41,0,0,16,1,58
"Ealing","11:00:00","2019-03-15",579,9,34,126,15,763
"Hackney","11:00:00","2019-03-15",330,20,29,99,16,494
"Havering","11:00:00","2019-03-15",970,6,16,184,31,1207
"Hillingdon","11:00:00","2019-03-15",21,0,0,3,0,24
"Islington","11:00:00","2019-03-15",252,9,33,112,15,421
"Bexley","12:00:00","2019-03-15",2953,27,2,709,157,3848
"Brent","12:00:00","2019-03-15",416,48,33,96,44,637
"Croydon","12:00:00","2019-03-15",49,0,0,12,0,61
"Ealing","12:00:00","2019-03-15",604,16,37,136,12,805
"Hackney","12:00:00","2019-03-15",399,10,29,102,18,558
"Havering","12:00:00","2019-03-15",954,3,4,202,36,1199
"Hillingdon","12:00:00","2019-03-15",37,0,0,10,0,47
"Islington","12:00:00","2019-03-15",272,17,29,99,18,435
"Bexley","13:00:00","2019-03-15",3084,33,9,740,139,4005
"Brent","13:00:00","2019-03-15",441,57,29,86,42,655
"Croydon","13:00:00","2019-03-15",48,7,0,9,2,66
"Ealing","13:00:00","2019-03-15",603,17,41,132,13,806
"Hackney","13:00:00","2019-03-15",387,10,38,99,7,541
"Havering","13:00:00","2019-03-15",891,8,8,184,30,1121
"Hillingdon","13:00:00","2019-03-15",26,0,0,12,0,38
"Islington","13:00:00","2019-03-15",302,22,28,82,4,438
"Bexley","14:00:00","2019-03-15",3300,32,14,755,134,4235
"Brent","14:00:00","2019-03-15",373,59,28,88,28,576
"Croydon","14:00:00","2019-03-15",61,1,0,10,0,72
"Ealing","14:00:00","2019-03-15",699,23,38,115,11,886
"Hackney","14:00:00","2019-03-15",375,10,33,59,10,487
"Havering","14:00:00","2019-03-15",1174,9,15,208,24,1430
"Hillingdon","14:00:00","2019-03-15",29,0,0,5,0,34
"Islington","14:00:00","2019-03-15",291,20,25,77,5,418
"Bexley","15:00:00","2019-03-15",3533,51,18,927,119,4648
"Brent","15:00:00","2019-03-15",494,39,34,82,24,673
"Croydon","15:00:00","2019-03-15",79,0,0,6,0,85
"Ealing","15:00:00","2019-03-15",702,18,36,122,16,894
"Hackney","15:00:00","2019-03-15",398,8,41,59,7,513
"Havering","15:00:00","2019-03-15",1380,5,5,258,25,1673
"Hillingdon","15:00:00","2019-03-15",46,0,0,3,0,49
"Islington","15:00:00","2019-03-15",310,17,26,98,9,460
"Bexley","16:00:00","2019-03-15",4170,69,12,918,67,5236
"Brent","16:00:00","2019-03-15",531,62,30,90,15,728
"Croydon","16:00:00","2019-03-15",66,0,0,10,0,76
"Ealing","16:00:00","2019-03-15",745,23,38,100,5,911
"Hackney","16:00:00","2019-03-15",431,10,43,63,4,551
"Havering","16:00:00","2019-03-15",1432,7,8,191,14,1652
"Hillingdon","16:00:00","2019-03-15",43,0,1,6,0,50
"Islington","16:00:00","2019-03-15",331,32,33,75,2,473
"Bexley","17:00:00","2019-03-15",4247,86,18,713,66,5130
"Brent","17:00:00","2019-03-15",533,81,35,83,14,746
"Croydon","17:00:00","2019-03-15",80,1,0,6,0,87
"Ealing","17:00:00","2019-03-15",711,19,43,81,2,856
"Hackney","17:00:00","2019-03-15",431,14,36,34,4,519
"Havering","17:00:00","2019-03-15",1635,15,5,208,12,1875
"Hillingdon","17:00:00","2019-03-15",40,1,0,3,0,44
"Islington","17:00:00","2019-03-15",429,45,30,76,3,583
"Bexley","18:00:00","2019-03-15",3713,85,18,441,45,4302
"Brent","18:00:00","2019-03-15",485,79,27,61,10,662
"Croydon","18:00:00","2019-03-15",79,2,0,8,0,89
"Ealing","18:00:00","2019-03-15",753,49,41,73,2,918
"Hackney","18:00:00","2019-03-15",391,16,36,32,1,476
"Havering","18:00:00","2019-03-15",1322,5,5,140,1,1473
"Hillingdon","18:00:00","2019-03-15",47,0,0,3,0,50
"Islington","18:00:00","2019-03-15",451,44,32,39,1,567
"Bexley","07:00:00","2019-03-18",327,3,25,56,3,414
"Harrow","07:00:00","2019-03-18",46,0,0,8,0,54
"Kingston upon Thames","07:00:00","2019-03-18",960,36,36,230,21,1283
"Merton","07:00:00","2019-03-18",178,1,6,42,2,229
"Waltham Forest","07:00:00","2019-03-18",381,6,11,96,5,499
"Bexley","08:00:00","2019-03-18",345,6,23,44,1,419
"Harrow","08:00:00","2019-03-18",156,1,0,8,0,165
"Kingston upon Thames","08:00:00","2019-03-18",935,45,44,169,28,1221
"Merton","08:00:00","2019-03-18",291,7,6,63,4,371
"Waltham Forest","08:00:00","2019-03-18",465,7,11,87,7,577
"Bexley","09:00:00","2019-03-18",297,2,23,46,9,377
"Harrow","09:00:00","2019-03-18",64,5,0,7,0,76
"Kingston upon Thames","09:00:00","2019-03-18",712,37,39,174,23,985
"Merton","09:00:00","2019-03-18",257,9,6,67,11,350
"Waltham Forest","09:00:00","2019-03-18",410,5,13,71,12,511
"Bexley","10:00:00","2019-03-18",287,4,23,65,4,383
"Harrow","10:00:00","2019-03-18",50,2,0,12,1,65
"Kingston upon Thames","10:00:00","2019-03-18",683,11,40,150,32,916
"Merton","10:00:00","2019-03-18",254,3,5,43,4,309
"Waltham Forest","10:00:00","2019-03-18",361,0,19,98,7,485
"Bexley","11:00:00","2019-03-18",263,6,19,51,5,344
"Harrow","11:00:00","2019-03-18",58,2,0,10,0,70
"Kingston upon Thames","11:00:00","2019-03-18",637,12,32,147,32,860
"Merton","11:00:00","2019-03-18",255,5,6,51,4,321
"Waltham Forest","11:00:00","2019-03-18",372,2,15,81,18,488
"Bexley","12:00:00","2019-03-18",305,9,22,51,7,394
"Harrow","12:00:00","2019-03-18",52,3,0,3,0,58
"Kingston upon Thames","12:00:00","2019-03-18",689,26,37,163,20,935
"Merton","12:00:00","2019-03-18",247,5,6,49,3,310
"Waltham Forest","12:00:00","2019-03-18",326,1,19,55,6,407
"Bexley","13:00:00","2019-03-18",321,6,19,55,4,405
"Harrow","13:00:00","2019-03-18",49,4,0,7,1,61
"Kingston upon Thames","13:00:00","2019-03-18",746,29,33,156,25,989
"Merton","13:00:00","2019-03-18",218,10,5,40,5,278
"Waltham Forest","13:00:00","2019-03-18",360,5,14,80,8,467
"Bexley","14:00:00","2019-03-18",370,11,17,50,5,453
"Harrow","14:00:00","2019-03-18",74,1,0,8,0,83
"Kingston upon Thames","14:00:00","2019-03-18",795,19,46,135,21,1016
"Merton","14:00:00","2019-03-18",313,5,5,60,6,389
"Waltham Forest","14:00:00","2019-03-18",411,6,12,56,6,491
"Bexley","15:00:00","2019-03-18",433,3,18,52,2,508
"Harrow","15:00:00","2019-03-18",123,2,0,9,0,134
"Kingston upon Thames","15:00:00","2019-03-18",769,30,39,126,14,978
"Merton","15:00:00","2019-03-18",366,8,5,75,2,456
"Waltham Forest","15:00:00","2019-03-18",370,9,10,50,3,442
"Bexley","16:00:00","2019-03-18",404,9,28,65,4,510
"Harrow","16:00:00","2019-03-18",118,3,0,12,0,133
"Kingston upon Thames","16:00:00","2019-03-18",908,34,41,163,11,1157
"Merton","16:00:00","2019-03-18",348,10,5,62,0,425
"Waltham Forest","16:00:00","2019-03-18",381,10,14,65,9,479
"Bexley","17:00:00","2019-03-18",438,7,22,62,3,532
"Harrow","17:00:00","2019-03-18",102,3,0,15,0,120
"Kingston upon Thames","17:00:00","2019-03-18",1079,57,28,97,5,1266
"Merton","17:00:00","2019-03-18",388,11,7,48,1,455
"Waltham Forest","17:00:00","2019-03-18",430,6,12,70,3,521
"Bexley","18:00:00","2019-03-18",440,3,22,43,2,510
"Harrow","18:00:00","2019-03-18",102,0,0,7,0,109
"Kingston upon Thames","18:00:00","2019-03-18",1008,51,36,67,4,1166
"Merton","18:00:00","2019-03-18",341,8,4,27,1,381
"Waltham Forest","18:00:00","2019-03-18",438,16,12,68,2,536
"Hackney","07:00:00","2019-03-19",352,55,8,246,37,698
"Hillingdon","07:00:00","2019-03-19",47,0,0,7,0,54
"Hounslow","07:00:00","2019-03-19",3165,94,36,747,225,4267
"Lambeth","07:00:00","2019-03-19",306,47,98,170,26,647
"Newham","07:00:00","2019-03-19",4940,313,33,1963,619,7868
"Richmond upon Thames","07:00:00","2019-03-19",659,12,12,148,21,852
"Hackney","08:00:00","2019-03-19",411,64,8,207,30,720
"Hillingdon","08:00:00","2019-03-19",117,0,1,6,0,124
"Hounslow","08:00:00","2019-03-19",3751,89,37,538,202,4617
"Lambeth","08:00:00","2019-03-19",359,68,87,116,28,658
"Newham","08:00:00","2019-03-19",5744,184,28,1621,638,8215
"Richmond upon Thames","08:00:00","2019-03-19",940,17,28,133,11,1129
"Hackney","09:00:00","2019-03-19",351,27,7,170,49,604
"Hillingdon","09:00:00","2019-03-19",39,0,1,4,0,44
"Hounslow","09:00:00","2019-03-19",2832,51,42,566,231,3722
"Lambeth","09:00:00","2019-03-19",293,42,124,133,16,608
"Newham","09:00:00","2019-03-19",5092,132,49,1739,783,7795
"Richmond upon Thames","09:00:00","2019-03-19",619,6,32,122,20,799
"Hackney","10:00:00","2019-03-19",329,17,6,222,31,605
"Hillingdon","10:00:00","2019-03-19",38,0,0,8,1,47
"Hounslow","10:00:00","2019-03-19",2119,37,33,589,250,3028
"Lambeth","10:00:00","2019-03-19",258,21,102,109,13,503
"Newham","10:00:00","2019-03-19",4467,71,27,1568,829,6962
"Richmond upon Thames","10:00:00","2019-03-19",522,7,13,141,23,706
"Hackney","11:00:00","2019-03-19",316,13,9,134,28,500
"Hillingdon","11:00:00","2019-03-19",36,0,0,8,1,45
"Hounslow","11:00:00","2019-03-19",2112,42,24,537,228,2943
"Lambeth","11:00:00","2019-03-19",284,35,105,117,17,558
"Newham","11:00:00","2019-03-19",4293,63,22,1479,835,6692
"Richmond upon Thames","11:00:00","2019-03-19",513,10,10,153,18,704
"Hackney","12:00:00","2019-03-19",336,16,8,114,15,489
"Hillingdon","12:00:00","2019-03-19",34,0,0,7,0,41
"Hounslow","12:00:00","2019-03-19",2219,44,18,521,226,3028
"Lambeth","12:00:00","2019-03-19",275,36,109,100,20,540
"Newham","12:00:00","2019-03-19",4679,65,16,1575,774,7109
"Richmond upon Thames","12:00:00","2019-03-19",602,10,14,153,19,798
"Hackney","13:00:00","2019-03-19",365,14,6,104,20,509
"Hillingdon","13:00:00","2019-03-19",30,0,0,9,0,39
"Hounslow","13:00:00","2019-03-19",2277,62,15,551,247,3152
"Lambeth","13:00:00","2019-03-19",223,39,98,81,6,447
"Newham","13:00:00","2019-03-19",4942,86,23,1618,771,7440
"Richmond upon Thames","13:00:00","2019-03-19",588,9,16,132,13,758
"Hackney","14:00:00","2019-03-19",334,8,8,85,23,458
"Hillingdon","14:00:00","2019-03-19",34,0,0,9,0,43
"Hounslow","14:00:00","2019-03-19",2512,54,17,631,221,3435
"Lambeth","14:00:00","2019-03-19",316,33,108,99,9,565
"Newham","14:00:00","2019-03-19",5257,90,32,1786,795,7960
"Richmond upon Thames","14:00:00","2019-03-19",683,6,19,107,14,829
"Hackney","15:00:00","2019-03-19",312,9,8,73,16,418
"Hillingdon","15:00:00","2019-03-19",97,0,3,4,0,104
"Hounslow","15:00:00","2019-03-19",2878,67,23,572,161,3701
"Lambeth","15:00:00","2019-03-19",340,22,118,79,3,562
"Newham","15:00:00","2019-03-19",5216,129,27,1739,605,7716
"Richmond upon Thames","15:00:00","2019-03-19",618,13,17,115,12,775
"Hackney","16:00:00","2019-03-19",324,10,7,64,5,410
"Hillingdon","16:00:00","2019-03-19",49,0,0,9,0,58
"Hounslow","16:00:00","2019-03-19",3448,97,33,565,95,4238
"Lambeth","16:00:00","2019-03-19",325,30,83,63,5,506
"Newham","16:00:00","2019-03-19",6070,226,24,1647,412,8379
"Richmond upon Thames","16:00:00","2019-03-19",841,6,17,124,4,992
"Hackney","17:00:00","2019-03-19",331,14,7,58,2,412
"Hillingdon","17:00:00","2019-03-19",51,0,0,10,1,62
"Hounslow","17:00:00","2019-03-19",3976,151,34,426,65,4652
"Lambeth","17:00:00","2019-03-19",310,44,102,55,1,512
"Newham","17:00:00","2019-03-19",6577,316,16,1392,271,8572
"Richmond upon Thames","17:00:00","2019-03-19",902,19,18,102,9,1050
"Hackney","18:00:00","2019-03-19",349,15,8,43,1,416
"Hillingdon","18:00:00","2019-03-19",61,0,1,5,0,67
"Hounslow","18:00:00","2019-03-19",3480,101,34,280,47,3942
"Lambeth","18:00:00","2019-03-19",405,39,105,49,2,600
"Newham","18:00:00","2019-03-19",6959,238,37,1138,235,8607
"Richmond upon Thames","18:00:00","2019-03-19",764,16,17,60,5,862
"Barnet","07:00:00","2019-03-20",3275,124,20,1281,400,5100
"Croydon","07:00:00","2019-03-20",2046,52,22,458,50,2628
"Hammersmith and Fulham","07:00:00","2019-03-20",40,2,0,3,1,46
"Havering","07:00:00","2019-03-20",1108,11,7,290,123,1539
"Lambeth","07:00:00","2019-03-20",1211,349,137,624,71,2392
"Lewisham","07:00:00","2019-03-20",248,14,0,72,2,336
"Sutton","07:00:00","2019-03-20",706,29,52,168,9,964
"Barnet","08:00:00","2019-03-20",3902,112,27,967,386,5394
"Hammersmith and Fulham","08:00:00","2019-03-20",107,2,0,11,2,122
"Havering","08:00:00","2019-03-20",1013,11,9,183,127,1343
"Lambeth","08:00:00","2019-03-20",1254,415,148,567,66,2450
"Lewisham","08:00:00","2019-03-20",345,7,1,60,3,416
"Sutton","08:00:00","2019-03-20",816,19,54,100,11,1000
"Barnet","09:00:00","2019-03-20",3544,71,30,1101,442,5188
"Croydon","09:00:00","2019-03-20",1887,44,28,460,76,2495
"Hammersmith and Fulham","09:00:00","2019-03-20",44,0,1,7,0,52
"Havering","09:00:00","2019-03-20",843,4,3,197,118,1165
"Lambeth","09:00:00","2019-03-20",1154,235,160,550,97,2196
"Lewisham","09:00:00","2019-03-20",300,6,1,63,4,374
"Sutton","09:00:00","2019-03-20",510,17,50,78,10,665
"Barnet","10:00:00","2019-03-20",3337,69,29,1127,477,5039
"Croydon","10:00:00","2019-03-20",1698,30,23,406,68,2225
"Hammersmith and Fulham","10:00:00","2019-03-20",30,1,0,4,0,35
"Havering","10:00:00","2019-03-20",713,7,4,196,126,1046
"Lambeth","10:00:00","2019-03-20",1061,110,140,598,79,1988
"Lewisham","10:00:00","2019-03-20",208,1,0,39,4,252
"Sutton","10:00:00","2019-03-20",535,8,50,69,15,677
"Barnet","11:00:00","2019-03-20",3622,67,19,1202,588,5498
"Croydon","11:00:00","2019-03-20",1596,30,24,386,57,2093
"Hammersmith and Fulham","11:00:00","2019-03-20",34,2,0,7,1,44
"Havering","11:00:00","2019-03-20",818,9,2,191,128,1148
"Lambeth","11:00:00","2019-03-20",1114,113,120,628,87,2062
"Lewisham","11:00:00","2019-03-20",235,7,0,67,2,311
"Sutton","11:00:00","2019-03-20",527,14,49,84,7,681
"Barnet","12:00:00","2019-03-20",3282,37,33,1077,426,4855
"Croydon","12:00:00","2019-03-20",1720,29,22,355,89,2215
"Hammersmith and Fulham","12:00:00","2019-03-20",23,0,0,3,0,26
"Havering","12:00:00","2019-03-20",827,9,2,174,119,1131
"Lambeth","12:00:00","2019-03-20",1146,128,127,622,79,2102
"Lewisham","12:00:00","2019-03-20",293,5,0,67,1,366
"Sutton","12:00:00","2019-03-20",514,13,51,80,10,668
"Barnet","13:00:00","2019-03-20",3441,64,31,1046,407,4989
"Croydon","13:00:00","2019-03-20",1815,42,22,437,75,2391
"Hammersmith and Fulham","13:00:00","2019-03-20",35,3,0,7,0,45
"Havering","13:00:00","2019-03-20",814,6,3,221,92,1136
"Lambeth","13:00:00","2019-03-20",1115,128,121,624,86,2074
"Lewisham","13:00:00","2019-03-20",234,5,0,63,1,303
"Sutton","13:00:00","2019-03-20",592,7,48,64,1,712
"Barnet","14:00:00","2019-03-20",3890,75,30,1132,410,5537
"Croydon","14:00:00","2019-03-20",1767,34,20,434,76,2331
"Hammersmith and Fulham","14:00:00","2019-03-20",23,2,0,5,1,31
"Havering","14:00:00","2019-03-20",876,6,3,220,123,1228
"Lambeth","14:00:00","2019-03-20",1395,133,132,673,85,2418
"Lewisham","14:00:00","2019-03-20",268,8,0,64,3,343
"Sutton","14:00:00","2019-03-20",547,13,50,106,2,718
"Barnet","15:00:00","2019-03-20",3806,84,29,1152,303,5374
"Hammersmith and Fulham","15:00:00","2019-03-20",64,3,0,14,0,81
"Havering","15:00:00","2019-03-20",985,6,4,216,126,1337
"Lambeth","15:00:00","2019-03-20",1446,151,138,638,52,2425
"Lewisham","15:00:00","2019-03-20",312,12,2,59,0,385
"Sutton","15:00:00","2019-03-20",637,26,47,86,4,800
"Barnet","16:00:00","2019-03-20",4299,135,26,1182,235,5877
"Hammersmith and Fulham","16:00:00","2019-03-20",43,5,1,6,1,56
"Havering","16:00:00","2019-03-20",1019,16,3,206,38,1282
"Lambeth","16:00:00","2019-03-20",1332,261,148,601,34,2376
"Lewisham","16:00:00","2019-03-20",346,14,0,77,0,437
"Sutton","16:00:00","2019-03-20",782,35,50,110,4,981
"Barnet","17:00:00","2019-03-20",4328,166,31,974,132,5631
"Croydon","17:00:00","2019-03-20",2194,65,20,389,28,2696
"Hammersmith and Fulham","17:00:00","2019-03-20",38,9,0,6,0,53
"Havering","17:00:00","2019-03-20",1183,10,3,211,42,1449
"Lambeth","17:00:00","2019-03-20",1439,414,135,425,17,2430
"Lewisham","17:00:00","2019-03-20",396,12,0,60,0,468
"Sutton","17:00:00","2019-03-20",903,33,52,96,2,1086
"Barnet","18:00:00","2019-03-20",4424,104,29,660,99,5316
"Croydon","18:00:00","2019-03-20",2159,53,20,292,16,2540
"Hammersmith and Fulham","18:00:00","2019-03-20",35,0,0,4,0,39
"Havering","18:00:00","2019-03-20",1192,9,0,179,20,1400
"Lambeth","18:00:00","2019-03-20",1630,408,124,282,13,2457
"Lewisham","18:00:00","2019-03-20",382,10,0,43,0,435
"Sutton","18:00:00","2019-03-20",849,44,53,71,2,1019
"Barnet","07:00:00","2019-03-21",1113,8,31,231,19,1402
"Camden","07:00:00","2019-03-21",204,41,131,131,43,550
"Hackney","07:00:00","2019-03-21",409,15,119,183,18,744
"Islington","07:00:00","2019-03-21",150,9,3,81,1,244
"Sutton","07:00:00","2019-03-21",317,2,13,45,1,378
"Barnet","08:00:00","2019-03-21",998,3,26,186,17,1230
"Camden","08:00:00","2019-03-21",215,66,130,133,41,585
"Hackney","08:00:00","2019-03-21",422,21,126,142,17,728
"Islington","08:00:00","2019-03-21",196,10,6,86,2,300
"Sutton","08:00:00","2019-03-21",382,7,7,45,2,443
"Barnet","09:00:00","2019-03-21",956,0,25,148,20,1149
"Camden","09:00:00","2019-03-21",164,68,135,127,42,536
"Hackney","09:00:00","2019-03-21",402,21,120,138,25,706
"Islington","09:00:00","2019-03-21",156,10,2,92,3,263
"Sutton","09:00:00","2019-03-21",256,1,8,45,3,313
"Barnet","10:00:00","2019-03-21",763,5,24,129,17,938
"Camden","10:00:00","2019-03-21",240,72,123,152,54,641
"Hackney","10:00:00","2019-03-21",349,20,111,156,27,663
"Islington","10:00:00","2019-03-21",140,1,1,58,3,203
"Sutton","10:00:00","2019-03-21",248,3,9,37,4,301
"Barnet","11:00:00","2019-03-21",682,3,25,145,18,873
"Camden","11:00:00","2019-03-21",278,72,125,135,41,651
"Hackney","11:00:00","2019-03-21",348,19,126,143,20,656
"Islington","11:00:00","2019-03-21",127,7,4,65,5,208
"Sutton","11:00:00","2019-03-21",227,3,8,36,2,276
"Barnet","12:00:00","2019-03-21",716,10,26,132,10,894
"Camden","12:00:00","2019-03-21",291,81,113,131,40,656
"Hackney","12:00:00","2019-03-21",378,27,109,151,17,682
"Islington","12:00:00","2019-03-21",133,15,0,72,4,224
"Sutton","12:00:00","2019-03-21",280,4,8,39,2,333
"Barnet","13:00:00","2019-03-21",834,6,23,155,17,1035
"Camden","13:00:00","2019-03-21",373,74,134,157,29,767
"Hackney","13:00:00","2019-03-21",401,21,110,136,16,684
"Islington","13:00:00","2019-03-21",136,23,1,60,6,226
"Sutton","13:00:00","2019-03-21",267,6,8,31,2,314
"Barnet","14:00:00","2019-03-21",813,2,19,157,9,1000
"Camden","14:00:00","2019-03-21",363,96,123,130,24,736
"Hackney","14:00:00","2019-03-21",375,20,112,144,13,664
"Islington","14:00:00","2019-03-21",125,20,4,72,2,223
"Sutton","14:00:00","2019-03-21",277,6,8,42,2,335
"Barnet","15:00:00","2019-03-21",938,7,20,168,15,1148
"Camden","15:00:00","2019-03-21",369,70,111,100,25,675
"Hackney","15:00:00","2019-03-21",461,21,111,125,13,731
"Islington","15:00:00","2019-03-21",191,14,2,78,4,289
"Sutton","15:00:00","2019-03-21",329,7,11,57,1,405
"Barnet","16:00:00","2019-03-21",1088,4,20,162,7,1281
"Camden","16:00:00","2019-03-21",436,72,125,73,18,724
"Hackney","16:00:00","2019-03-21",443,30,111,123,5,712
"Islington","16:00:00","2019-03-21",145,17,3,69,2,236
"Sutton","16:00:00","2019-03-21",359,6,9,31,2,407
"Barnet","17:00:00","2019-03-21",1077,6,20,184,4,1291
"Camden","17:00:00","2019-03-21",442,74,124,69,7,716
"Hackney","17:00:00","2019-03-21",507,50,110,89,4,760
"Islington","17:00:00","2019-03-21",178,32,3,43,0,256
"Sutton","17:00:00","2019-03-21",391,5,8,38,0,442
"Barnet","18:00:00","2019-03-21",1079,7,19,97,0,1202
"Camden","18:00:00","2019-03-21",479,124,128,52,7,790
"Hackney","18:00:00","2019-03-21",509,47,109,69,4,738
"Islington","18:00:00","2019-03-21",211,46,0,41,1,299
"Sutton","18:00:00","2019-03-21",358,7,10,25,0,400
"Bexley","07:00:00","2019-03-22",499,4,7,103,17,630
"Brent","07:00:00","2019-03-22",570,16,18,104,11,719
"Croydon","07:00:00","2019-03-22",165,1,0,24,0,190
"Ealing","07:00:00","2019-03-22",2980,230,71,1275,414,4970
"Enfield","07:00:00","2019-03-22",1644,24,59,370,75,2172
"Greenwich","07:00:00","2019-03-22",13,1,0,0,0,14
"Hillingdon","07:00:00","2019-03-22",26,1,0,2,0,29
"Newham","07:00:00","2019-03-22",908,19,67,167,23,1184
"Redbridge","07:00:00","2019-03-22",2313,24,98,534,84,3053
"Bexley","08:00:00","2019-03-22",812,3,9,125,12,961
"Brent","08:00:00","2019-03-22",777,6,17,91,3,894
"Croydon","08:00:00","2019-03-22",177,6,0,21,0,204
"Ealing","08:00:00","2019-03-22",3281,209,56,1005,465,5016
"Enfield","08:00:00","2019-03-22",1377,32,42,278,84,1813
"Greenwich","08:00:00","2019-03-22",43,0,0,3,0,46
"Hillingdon","08:00:00","2019-03-22",32,3,0,3,0,38
"Newham","08:00:00","2019-03-22",914,9,60,170,37,1190
"Redbridge","08:00:00","2019-03-22",2522,26,84,463,64,3159
"Bexley","09:00:00","2019-03-22",713,9,7,109,16,854
"Brent","09:00:00","2019-03-22",567,4,18,95,13,697
"Croydon","09:00:00","2019-03-22",95,1,0,24,0,120
"Ealing","09:00:00","2019-03-22",3136,130,76,1082,561,4985
"Enfield","09:00:00","2019-03-22",1190,24,48,282,55,1599
"Greenwich","09:00:00","2019-03-22",23,1,0,1,0,25
"Hillingdon","09:00:00","2019-03-22",15,0,0,4,0,19
"Newham","09:00:00","2019-03-22",774,14,61,130,32,1011
"Redbridge","09:00:00","2019-03-22",2247,23,95,363,68,2796
"Bexley","10:00:00","2019-03-22",537,2,6,85,16,646
"Brent","10:00:00","2019-03-22",509,6,23,104,17,659
"Croydon","10:00:00","2019-03-22",71,1,0,19,0,91
"Ealing","10:00:00","2019-03-22",3040,94,75,1160,546,4915
"Enfield","10:00:00","2019-03-22",1293,26,48,280,69,1716
"Greenwich","10:00:00","2019-03-22",9,0,0,4,0,13
"Hillingdon","10:00:00","2019-03-22",10,0,0,0,0,10
"Newham","10:00:00","2019-03-22",808,13,54,149,32,1056
"Redbridge","10:00:00","2019-03-22",2054,29,82,374,66,2605
"Bexley","11:00:00","2019-03-22",628,4,7,96,16,751
"Brent","11:00:00","2019-03-22",513,5,18,110,16,662
"Croydon","11:00:00","2019-03-22",90,1,0,14,1,106
"Ealing","11:00:00","2019-03-22",3216,115,61,1109,538,5039
"Enfield","11:00:00","2019-03-22",1300,37,45,269,72,1723
"Greenwich","11:00:00","2019-03-22",9,0,0,3,0,12
"Hillingdon","11:00:00","2019-03-22",14,0,0,2,0,16
"Newham","11:00:00","2019-03-22",766,12,65,190,29,1062
"Redbridge","11:00:00","2019-03-22",2034,30,77,381,53,2575
"Bexley","12:00:00","2019-03-22",672,3,7,96,9,787
"Brent","12:00:00","2019-03-22",534,10,18,99,13,674
"Croydon","12:00:00","2019-03-22",84,0,0,17,0,101
"Ealing","12:00:00","2019-03-22",3132,90,64,1167,491,4944
"Enfield","12:00:00","2019-03-22",1478,24,51,308,64,1925
"Greenwich","12:00:00","2019-03-22",15,1,0,9,0,25
"Hillingdon","12:00:00","2019-03-22",33,0,0,0,0,33
"Newham","12:00:00","2019-03-22",816,24,50,171,25,1086
"Redbridge","12:00:00","2019-03-22",2082,30,79,326,53,2570
"Bexley","13:00:00","2019-03-22",609,7,5,89,9,719
"Brent","13:00:00","2019-03-22",593,9,19,93,5,719
"Croydon","13:00:00","2019-03-22",83,2,0,8,1,94
"Ealing","13:00:00","2019-03-22",3273,105,49,1133,487,5047
"Enfield","13:00:00","2019-03-22",1586,34,50,302,65,2037
"Greenwich","13:00:00","2019-03-22",30,1,0,3,0,34
"Hillingdon","13:00:00","2019-03-22",16,0,0,4,0,20
"Newham","13:00:00","2019-03-22",720,25,60,156,24,985
"Redbridge","13:00:00","2019-03-22",2101,33,81,364,51,2630
"Bexley","14:00:00","2019-03-22",629,8,6,103,5,751
"Brent","14:00:00","2019-03-22",644,5,17,97,11,774
"Croydon","14:00:00","2019-03-22",68,4,0,19,0,91
"Ealing","14:00:00","2019-03-22",3839,103,61,1146,460,5609
"Enfield","14:00:00","2019-03-22",1520,32,42,271,53,1918
"Greenwich","14:00:00","2019-03-22",13,1,0,4,0,18
"Hillingdon","14:00:00","2019-03-22",33,0,0,2,0,35
"Newham","14:00:00","2019-03-22",874,20,57,138,13,1102
"Redbridge","14:00:00","2019-03-22",2219,36,85,364,59,2763
"Bexley","15:00:00","2019-03-22",814,7,6,117,5,949
"Brent","15:00:00","2019-03-22",671,18,21,86,5,801
"Croydon","15:00:00","2019-03-22",93,4,0,13,0,110
"Ealing","15:00:00","2019-03-22",3755,136,64,1092,317,5364
"Enfield","15:00:00","2019-03-22",1503,29,29,253,56,1870
"Greenwich","15:00:00","2019-03-22",11,4,0,1,0,16
"Hillingdon","15:00:00","2019-03-22",39,0,0,1,0,40
"Newham","15:00:00","2019-03-22",749,22,56,86,8,921
"Redbridge","15:00:00","2019-03-22",2212,38,75,404,36,2765
"Bexley","16:00:00","2019-03-22",705,8,7,92,1,813
"Brent","16:00:00","2019-03-22",750,13,34,105,6,908
"Croydon","16:00:00","2019-03-22",121,1,0,17,0,139
"Ealing","16:00:00","2019-03-22",3805,203,59,955,239,5261
"Enfield","16:00:00","2019-03-22",1683,41,28,284,28,2064
"Greenwich","16:00:00","2019-03-22",23,0,0,1,0,24
"Hillingdon","16:00:00","2019-03-22",17,0,0,0,0,17
"Newham","16:00:00","2019-03-22",747,19,59,97,4,926
"Redbridge","16:00:00","2019-03-22",2616,62,91,312,28,3109
"Bexley","17:00:00","2019-03-22",823,9,8,96,3,939
"Brent","17:00:00","2019-03-22",956,25,16,104,7,1108
"Croydon","17:00:00","2019-03-22",123,4,0,20,0,147
"Ealing","17:00:00","2019-03-22",3579,232,61,697,135,4704
"Enfield","17:00:00","2019-03-22",1856,24,34,249,26,2189
"Greenwich","17:00:00","2019-03-22",28,0,0,3,0,31
"Hillingdon","17:00:00","2019-03-22",38,0,0,2,0,40
"Newham","17:00:00","2019-03-22",733,18,57,86,5,899
"Redbridge","17:00:00","2019-03-22",2510,56,78,402,26,3072
"Bexley","18:00:00","2019-03-22",605,3,6,41,1,656
"Brent","18:00:00","2019-03-22",859,22,10,80,1,972
"Croydon","18:00:00","2019-03-22",105,2,0,13,0,120
"Ealing","18:00:00","2019-03-22",4343,208,75,519,131,5276
"Enfield","18:00:00","2019-03-22",1572,26,36,156,15,1805
"Greenwich","18:00:00","2019-03-22",7,0,0,0,0,7
"Hillingdon","18:00:00","2019-03-22",23,1,0,0,0,24
"Newham","18:00:00","2019-03-22",898,11,57,84,0,1050
"Redbridge","18:00:00","2019-03-22",2801,42,86,366,20,3315
"Bromley","07:00:00","2019-03-25",60,0,7,8,0,75
"Camden","07:00:00","2019-03-25",265,51,63,238,34,651
"Enfield","07:00:00","2019-03-25",731,1,2,131,8,873
"Southwark","07:00:00","2019-03-25",257,44,13,255,43,612
"Bromley","08:00:00","2019-03-25",89,1,6,11,0,107
"Camden","08:00:00","2019-03-25",284,92,56,207,30,669
"Enfield","08:00:00","2019-03-25",1179,4,5,117,7,1312
"Southwark","08:00:00","2019-03-25",294,80,14,178,21,587
"Bromley","09:00:00","2019-03-25",57,1,6,7,0,71
"Camden","09:00:00","2019-03-25",265,83,51,183,23,605
"Enfield","09:00:00","2019-03-25",708,0,7,87,9,811
"Southwark","09:00:00","2019-03-25",474,75,14,305,51,919
"Bromley","10:00:00","2019-03-25",42,1,7,13,0,63
"Camden","10:00:00","2019-03-25",278,65,54,240,37,674
"Enfield","10:00:00","2019-03-25",462,3,1,95,5,566
"Southwark","10:00:00","2019-03-25",380,44,14,285,43,766
"Bromley","11:00:00","2019-03-25",57,0,5,11,0,73
"Camden","11:00:00","2019-03-25",340,71,63,201,28,703
"Enfield","11:00:00","2019-03-25",443,5,1,66,13,528
"Southwark","11:00:00","2019-03-25",349,54,14,249,31,697
"Bromley","12:00:00","2019-03-25",56,2,8,5,0,71
"Camden","12:00:00","2019-03-25",347,81,52,220,15,715
"Enfield","12:00:00","2019-03-25",474,0,1,69,4,548
"Southwark","12:00:00","2019-03-25",375,73,12,223,29,712
"Bromley","13:00:00","2019-03-25",60,4,5,10,1,80
"Camden","13:00:00","2019-03-25",334,79,46,160,28,647
"Enfield","13:00:00","2019-03-25",486,4,3,85,8,586
"Southwark","13:00:00","2019-03-25",365,74,14,264,26,743
"Bromley","14:00:00","2019-03-25",70,3,6,11,2,92
"Camden","14:00:00","2019-03-25",331,99,55,170,17,672
"Enfield","14:00:00","2019-03-25",463,1,4,77,3,548
"Southwark","14:00:00","2019-03-25",446,50,15,242,21,774
"Bromley","15:00:00","2019-03-25",81,0,6,25,1,113
"Camden","15:00:00","2019-03-25",369,65,48,152,8,642
"Enfield","15:00:00","2019-03-25",792,2,5,96,4,899
"Southwark","15:00:00","2019-03-25",390,57,15,279,18,759
"Bromley","16:00:00","2019-03-25",88,5,6,32,0,131
"Camden","16:00:00","2019-03-25",384,80,46,140,8,658
"Enfield","16:00:00","2019-03-25",797,4,3,132,1,937
"Southwark","16:00:00","2019-03-25",372,85,16,232,10,715
"Bromley","17:00:00","2019-03-25",83,4,6,20,0,113
"Camden","17:00:00","2019-03-25",348,99,54,69,3,573
"Enfield","17:00:00","2019-03-25",815,3,3,117,6,944
"Southwark","17:00:00","2019-03-25",435,92,15,148,8,698
"Bromley","18:00:00","2019-03-25",68,3,7,7,0,85
"Camden","18:00:00","2019-03-25",456,77,52,59,3,647
"Enfield","18:00:00","2019-03-25",800,5,1,65,1,872
"Southwark","18:00:00","2019-03-25",539,118,14,88,5,764
"Barking and Dagenham","07:00:00","2019-03-26",1367,26,28,350,55,1826
"Barnet","07:00:00","2019-03-26",418,34,112,138,12,714
"Bexley","07:00:00","2019-03-26",456,13,91,66,12,638
"Ealing","07:00:00","2019-03-26",5617,240,48,1685,581,8171
"Hammersmith and Fulham","07:00:00","2019-03-26",189,29,23,59,4,304
"Lewisham","07:00:00","2019-03-26",946,145,73,356,156,1676
"Barking and Dagenham","08:00:00","2019-03-26",1539,15,27,353,67,2001
"Barnet","08:00:00","2019-03-26",558,25,91,151,22,847
"Bexley","08:00:00","2019-03-26",596,5,89,82,9,781
"Ealing","08:00:00","2019-03-26",5656,199,42,1310,581,7788
"Hammersmith and Fulham","08:00:00","2019-03-26",237,23,28,68,11,367
"Lewisham","08:00:00","2019-03-26",1016,92,75,332,127,1642
"Barking and Dagenham","09:00:00","2019-03-26",1371,11,32,327,56,1797
"Barnet","09:00:00","2019-03-26",448,18,105,114,19,704
"Bexley","09:00:00","2019-03-26",648,1,98,71,14,832
"Ealing","09:00:00","2019-03-26",5410,122,57,1412,792,7793
"Hammersmith and Fulham","09:00:00","2019-03-26",171,12,25,62,5,275
"Lewisham","09:00:00","2019-03-26",1106,53,92,256,150,1657
"Barking and Dagenham","10:00:00","2019-03-26",1326,10,21,344,60,1761
"Barnet","10:00:00","2019-03-26",391,12,101,89,14,607
"Bexley","10:00:00","2019-03-26",633,2,102,84,9,830
"Ealing","10:00:00","2019-03-26",4872,78,60,1542,835,7387
"Hammersmith and Fulham","10:00:00","2019-03-26",153,21,30,77,5,286
"Lewisham","10:00:00","2019-03-26",933,27,70,320,177,1527
"Barking and Dagenham","11:00:00","2019-03-26",1198,10,28,323,55,1614
"Barnet","11:00:00","2019-03-26",406,15,103,109,12,645
"Bexley","11:00:00","2019-03-26",699,6,94,62,6,867
"Ealing","11:00:00","2019-03-26",4812,88,44,1524,838,7306
"Hammersmith and Fulham","11:00:00","2019-03-26",162,30,27,80,7,306
"Lewisham","11:00:00","2019-03-26",1006,40,73,437,145,1701
"Barking and Dagenham","12:00:00","2019-03-26",1245,22,24,343,57,1691
"Barnet","12:00:00","2019-03-26",409,21,101,96,10,637
"Bexley","12:00:00","2019-03-26",751,9,99,57,6,922
"Ealing","12:00:00","2019-03-26",5012,103,42,1537,822,7516
"Hammersmith and Fulham","12:00:00","2019-03-26",142,26,29,77,9,283
"Lewisham","12:00:00","2019-03-26",1004,50,58,333,143,1588
"Barking and Dagenham","13:00:00","2019-03-26",1249,14,22,335,52,1672
"Barnet","13:00:00","2019-03-26",355,27,99,79,8,568
"Bexley","13:00:00","2019-03-26",684,8,87,63,7,849
"Ealing","13:00:00","2019-03-26",5225,102,43,1502,798,7670
"Hammersmith and Fulham","13:00:00","2019-03-26",156,30,29,51,4,270
"Lewisham","13:00:00","2019-03-26",955,47,59,351,125,1537
"Barking and Dagenham","14:00:00","2019-03-26",1426,11,26,319,65,1847
"Barnet","14:00:00","2019-03-26",451,22,87,87,10,657
"Bexley","14:00:00","2019-03-26",720,12,101,73,6,912
"Ealing","14:00:00","2019-03-26",5252,129,41,1487,720,7629
"Hammersmith and Fulham","14:00:00","2019-03-26",145,24,27,55,6,257
"Lewisham","14:00:00","2019-03-26",928,52,67,422,130,1599
"Barking and Dagenham","15:00:00","2019-03-26",1476,12,27,323,33,1871
"Barnet","15:00:00","2019-03-26",515,22,98,81,7,723
"Bexley","15:00:00","2019-03-26",645,15,91,81,4,836
"Ealing","15:00:00","2019-03-26",5895,128,49,1599,660,8331
"Hammersmith and Fulham","15:00:00","2019-03-26",180,23,26,50,2,281
"Lewisham","15:00:00","2019-03-26",860,96,66,332,100,1454
"Barking and Dagenham","16:00:00","2019-03-26",1868,21,37,294,39,2259
"Barnet","16:00:00","2019-03-26",425,25,94,58,2,604
"Bexley","16:00:00","2019-03-26",672,10,94,79,2,857
"Hammersmith and Fulham","16:00:00","2019-03-26",189,22,30,54,2,297
"Lewisham","16:00:00","2019-03-26",1133,157,74,327,79,1770
"Barking and Dagenham","17:00:00","2019-03-26",1766,22,18,276,23,2105
"Barnet","17:00:00","2019-03-26",516,23,96,77,3,715
"Bexley","17:00:00","2019-03-26",716,20,92,50,3,881
"Hammersmith and Fulham","17:00:00","2019-03-26",214,42,28,44,0,328
"Lewisham","17:00:00","2019-03-26",1169,164,72,306,82,1793
"Barking and Dagenham","18:00:00","2019-03-26",1688,17,16,176,25,1922
"Barnet","18:00:00","2019-03-26",465,37,93,34,2,631
"Bexley","18:00:00","2019-03-26",724,17,104,47,2,894
"Hammersmith and Fulham","18:00:00","2019-03-26",277,54,25,66,1,423
"Lewisham","18:00:00","2019-03-26",1283,149,83,219,48,1782
"Bromley","07:00:00","2019-03-27",1201,13,20,318,24,1576
"Camden","07:00:00","2019-03-27",404,28,107,233,56,828
"Hackney","07:00:00","2019-03-27",18,0,0,2,1,21
"Lewisham","07:00:00","2019-03-27",402,8,14,157,10,591
"Waltham Forest","07:00:00","2019-03-27",1732,28,16,501,41,2318
"Bromley","08:00:00","2019-03-27",1317,17,29,258,16,1637
"Camden","08:00:00","2019-03-27",468,70,89,205,37,869
"Hackney","08:00:00","2019-03-27",20,1,1,10,1,33
"Lewisham","08:00:00","2019-03-27",494,11,13,141,7,666
"Waltham Forest","08:00:00","2019-03-27",1586,16,15,362,71,2050
"Bromley","09:00:00","2019-03-27",945,7,25,200,14,1191
"Camden","09:00:00","2019-03-27",486,50,102,204,53,895
"Hackney","09:00:00","2019-03-27",25,1,0,6,1,33
"Lewisham","09:00:00","2019-03-27",388,9,11,143,14,565
"Waltham Forest","09:00:00","2019-03-27",1426,16,17,362,87,1908
"Bromley","10:00:00","2019-03-27",774,4,21,129,21,949
"Camden","10:00:00","2019-03-27",391,57,115,225,43,831
"Hackney","10:00:00","2019-03-27",17,1,0,14,1,33
"Lewisham","10:00:00","2019-03-27",406,11,13,140,11,581
"Waltham Forest","10:00:00","2019-03-27",1515,9,14,400,62,2000
"Bromley","11:00:00","2019-03-27",727,9,21,189,14,960
"Camden","11:00:00","2019-03-27",451,65,104,247,40,907
"Hackney","11:00:00","2019-03-27",14,1,0,10,1,26
"Lewisham","11:00:00","2019-03-27",401,11,11,136,16,575
"Waltham Forest","11:00:00","2019-03-27",1246,12,17,328,65,1668
"Bromley","12:00:00","2019-03-27",808,10,22,168,10,1018
"Camden","12:00:00","2019-03-27",451,85,106,259,28,929
"Hackney","12:00:00","2019-03-27",26,0,0,10,0,36
"Lewisham","12:00:00","2019-03-27",406,12,11,133,13,575
"Waltham Forest","12:00:00","2019-03-27",1283,22,13,363,64,1745
"Bromley","13:00:00","2019-03-27",860,5,20,171,14,1070
"Camden","13:00:00","2019-03-27",360,79,100,213,32,784
"Hackney","13:00:00","2019-03-27",20,0,0,11,1,32
"Lewisham","13:00:00","2019-03-27",424,14,10,145,14,607
"Waltham Forest","13:00:00","2019-03-27",1279,17,24,348,65,1733
"Bromley","14:00:00","2019-03-27",877,12,22,193,18,1122
"Camden","14:00:00","2019-03-27",533,97,109,256,16,1011
"Hackney","14:00:00","2019-03-27",25,1,0,9,1,36
"Lewisham","14:00:00","2019-03-27",484,10,14,143,12,663
"Waltham Forest","14:00:00","2019-03-27",1444,24,20,324,70,1882
"Bromley","15:00:00","2019-03-27",1000,13,28,233,17,1291
"Camden","15:00:00","2019-03-27",555,94,111,225,19,1004
"Hackney","15:00:00","2019-03-27",34,2,1,14,1,52
"Lewisham","15:00:00","2019-03-27",520,8,13,139,4,684
"Waltham Forest","15:00:00","2019-03-27",1531,16,13,360,68,1988
"Bromley","16:00:00","2019-03-27",1109,13,26,277,7,1432
"Camden","16:00:00","2019-03-27",578,110,107,186,22,1003
"Hackney","16:00:00","2019-03-27",31,2,0,16,1,50
"Lewisham","16:00:00","2019-03-27",522,9,17,126,1,675
"Waltham Forest","16:00:00","2019-03-27",1673,19,11,316,18,2037
"Bromley","17:00:00","2019-03-27",1199,18,17,194,4,1432
"Camden","17:00:00","2019-03-27",678,135,113,152,7,1085
"Hackney","17:00:00","2019-03-27",25,1,0,6,0,32
"Lewisham","17:00:00","2019-03-27",536,11,14,112,0,673
"Waltham Forest","17:00:00","2019-03-27",1760,25,14,304,29,2132
"Bromley","18:00:00","2019-03-27",772,10,15,120,2,919
"Camden","18:00:00","2019-03-27",774,131,106,79,6,1096
"Hackney","18:00:00","2019-03-27",28,0,0,1,0,29
"Lewisham","18:00:00","2019-03-27",680,18,14,94,2,808
"Waltham Forest","18:00:00","2019-03-27",1934,23,10,241,17,2225
"Barnet","07:00:00","2019-03-28",3009,110,14,1203,377,4713
"Brent","07:00:00","2019-03-28",3634,121,13,1362,483,5613
"Camden","07:00:00","2019-03-28",192,13,15,66,21,307
"Harrow","07:00:00","2019-03-28",1029,8,17,172,15,1241
"Kensington and Chelsea","07:00:00","2019-03-28",670,80,77,231,49,1107
"Sutton","07:00:00","2019-03-28",977,19,19,327,66,1408
"Barnet","08:00:00","2019-03-28",3585,100,22,1032,397,5136
"Brent","08:00:00","2019-03-28",3537,98,11,1028,449,5123
"Camden","08:00:00","2019-03-28",198,10,14,73,19,314
"Harrow","08:00:00","2019-03-28",807,5,6,123,24,965
"Kensington and Chelsea","08:00:00","2019-03-28",1065,77,76,231,51,1500
"Sutton","08:00:00","2019-03-28",1010,18,20,343,70,1461
"Barnet","09:00:00","2019-03-28",3377,67,15,1013,492,4964
"Brent","09:00:00","2019-03-28",3645,78,12,1094,559,5388
"Camden","09:00:00","2019-03-28",212,13,10,96,15,346
"Harrow","09:00:00","2019-03-28",735,3,5,125,20,888
"Kensington and Chelsea","09:00:00","2019-03-28",931,68,96,303,37,1435
"Sutton","09:00:00","2019-03-28",1014,11,25,319,76,1445
"Barnet","10:00:00","2019-03-28",3281,67,13,1117,525,5003
"Brent","10:00:00","2019-03-28",3540,70,6,1282,629,5527
"Camden","10:00:00","2019-03-28",210,3,13,91,25,342
"Harrow","10:00:00","2019-03-28",555,5,2,107,33,702
"Kensington and Chelsea","10:00:00","2019-03-28",906,85,75,291,61,1418
"Sutton","10:00:00","2019-03-28",857,16,25,256,85,1239
"Barnet","11:00:00","2019-03-28",3393,43,13,1127,516,5092
"Brent","11:00:00","2019-03-28",3455,52,5,1277,607,5396
"Camden","11:00:00","2019-03-28",201,5,11,131,22,370
"Harrow","11:00:00","2019-03-28",658,4,2,138,31,833
"Kensington and Chelsea","11:00:00","2019-03-28",963,70,80,326,48,1487
"Sutton","11:00:00","2019-03-28",904,10,21,261,75,1271
"Barnet","12:00:00","2019-03-28",3255,64,13,992,515,4839
"Brent","12:00:00","2019-03-28",3264,73,11,1088,583,5019
"Camden","12:00:00","2019-03-28",225,6,14,125,19,389
"Harrow","12:00:00","2019-03-28",587,4,1,110,12,714
"Kensington and Chelsea","12:00:00","2019-03-28",999,88,75,273,32,1467
"Sutton","12:00:00","2019-03-28",1003,20,19,236,92,1370
"Barnet","13:00:00","2019-03-28",3663,62,12,1091,443,5271
"Brent","13:00:00","2019-03-28",3546,77,3,1192,547,5365
"Camden","13:00:00","2019-03-28",248,13,18,128,22,429
"Harrow","13:00:00","2019-03-28",607,7,2,115,25,756
"Kensington and Chelsea","13:00:00","2019-03-28",813,87,74,219,32,1225
"Sutton","13:00:00","2019-03-28",1040,10,17,236,85,1388
"Barnet","14:00:00","2019-03-28",3760,70,22,1100,383,5335
"Brent","14:00:00","2019-03-28",3632,71,11,1189,429,5332
"Camden","14:00:00","2019-03-28",241,15,12,152,16,436
"Harrow","14:00:00","2019-03-28",688,7,3,128,26,852
"Kensington and Chelsea","14:00:00","2019-03-28",1008,102,83,248,37,1478
"Sutton","14:00:00","2019-03-28",1004,23,23,212,72,1334
"Barnet","15:00:00","2019-03-28",3845,79,20,1137,326,5407
"Brent","15:00:00","2019-03-28",3813,89,6,1201,412,5521
"Camden","15:00:00","2019-03-28",315,35,14,139,14,517
"Harrow","15:00:00","2019-03-28",805,9,6,161,21,1002
"Kensington and Chelsea","15:00:00","2019-03-28",1101,83,86,228,30,1528
"Sutton","15:00:00","2019-03-28",1055,15,20,239,57,1386
"Barnet","16:00:00","2019-03-28",4175,144,17,1112,243,5691
"Brent","16:00:00","2019-03-28",4240,136,6,1163,270,5815
"Camden","16:00:00","2019-03-28",338,21,19,137,25,540
"Harrow","16:00:00","2019-03-28",993,5,12,159,18,1187
"Kensington and Chelsea","16:00:00","2019-03-28",1068,95,77,200,20,1460
"Sutton","16:00:00","2019-03-28",1036,21,21,277,40,1395
"Barnet","17:00:00","2019-03-28",4360,156,19,897,135,5567
"Brent","17:00:00","2019-03-28",4555,156,12,919,176,5818
"Camden","17:00:00","2019-03-28",382,48,19,86,15,550
"Harrow","17:00:00","2019-03-28",1143,5,18,144,9,1319
"Kensington and Chelsea","17:00:00","2019-03-28",1123,121,76,133,13,1466
"Sutton","17:00:00","2019-03-28",1163,21,14,204,17,1419
"Barnet","18:00:00","2019-03-28",4317,130,18,666,125,5256
"Brent","18:00:00","2019-03-28",4540,135,4,701,155,5535
"Camden","18:00:00","2019-03-28",354,69,14,48,13,498
"Harrow","18:00:00","2019-03-28",1098,4,4,102,2,1210
"Kensington and Chelsea","18:00:00","2019-03-28",1180,194,89,112,11,1586
"Sutton","18:00:00","2019-03-28",1120,23,19,162,14,1338
"Ealing","07:00:00","2019-03-29",33,1,0,5,0,39
"Hackney","07:00:00","2019-03-29",254,18,148,114,22,556
"Haringey","07:00:00","2019-03-29",1193,83,134,414,125,1949
"Hillingdon","07:00:00","2019-03-29",48,0,1,8,2,59
"Lambeth","07:00:00","2019-03-29",29,0,0,9,1,39
"Southwark","07:00:00","2019-03-29",170,16,34,124,14,358
"Ealing","08:00:00","2019-03-29",69,0,0,5,0,74
"Hackney","08:00:00","2019-03-29",393,22,157,130,23,725
"Haringey","08:00:00","2019-03-29",1314,95,162,422,149,2142
"Hillingdon","08:00:00","2019-03-29",66,0,0,6,0,72
"Lambeth","08:00:00","2019-03-29",69,1,0,7,0,77
"Southwark","08:00:00","2019-03-29",180,21,39,124,26,390
"Ealing","09:00:00","2019-03-29",53,1,0,9,0,63
"Hackney","09:00:00","2019-03-29",383,40,135,117,23,698
"Haringey","09:00:00","2019-03-29",1353,38,169,513,145,2218
"Hillingdon","09:00:00","2019-03-29",47,0,0,3,0,50
"Lambeth","09:00:00","2019-03-29",34,1,0,4,2,41
"Southwark","09:00:00","2019-03-29",177,13,30,129,24,373
"Ealing","10:00:00","2019-03-29",44,0,0,13,1,58
"Hackney","10:00:00","2019-03-29",304,22,154,107,29,616
"Haringey","10:00:00","2019-03-29",1207,53,137,391,125,1913
"Hillingdon","10:00:00","2019-03-29",29,1,0,7,1,38
"Lambeth","10:00:00","2019-03-29",27,1,0,3,0,31
"Southwark","10:00:00","2019-03-29",169,14,32,141,31,387
"Ealing","11:00:00","2019-03-29",54,0,0,15,0,69
"Hackney","11:00:00","2019-03-29",366,25,141,117,21,670
"Haringey","11:00:00","2019-03-29",1279,68,127,495,139,2108
"Hillingdon","11:00:00","2019-03-29",48,0,0,5,2,55
"Lambeth","11:00:00","2019-03-29",30,2,0,5,0,37
"Southwark","11:00:00","2019-03-29",146,25,32,121,17,341
"Ealing","12:00:00","2019-03-29",99,1,0,29,3,132
"Hackney","12:00:00","2019-03-29",338,49,124,109,14,634
"Haringey","12:00:00","2019-03-29",1327,89,122,474,118,2130
"Hillingdon","12:00:00","2019-03-29",40,1,0,5,0,46
"Lambeth","12:00:00","2019-03-29",22,6,0,10,0,38
"Southwark","12:00:00","2019-03-29",154,43,30,120,11,358
"Ealing","13:00:00","2019-03-29",78,2,0,19,0,99
"Hackney","13:00:00","2019-03-29",449,58,156,134,20,817
"Haringey","13:00:00","2019-03-29",1325,69,132,397,108,2031
"Hillingdon","13:00:00","2019-03-29",48,2,0,1,0,51
"Lambeth","13:00:00","2019-03-29",30,1,0,4,0,35
"Southwark","13:00:00","2019-03-29",155,40,27,94,11,327
"Ealing","14:00:00","2019-03-29",87,3,0,15,0,105
"Hackney","14:00:00","2019-03-29",480,39,148,116,23,806
"Haringey","14:00:00","2019-03-29",1399,104,133,455,100,2191
"Hillingdon","14:00:00","2019-03-29",53,0,0,6,3,62
"Lambeth","14:00:00","2019-03-29",34,2,0,7,0,43
"Southwark","14:00:00","2019-03-29",185,25,29,97,27,363
"Ealing","15:00:00","2019-03-29",123,0,0,13,1,137
"Hackney","15:00:00","2019-03-29",346,31,139,86,8,610
"Haringey","15:00:00","2019-03-29",1466,90,155,449,84,2244
"Hillingdon","15:00:00","2019-03-29",87,1,0,4,2,94
"Lambeth","15:00:00","2019-03-29",35,3,0,1,0,39
"Southwark","15:00:00","2019-03-29",163,30,30,105,5,333
"Ealing","16:00:00","2019-03-29",124,4,0,15,0,143
"Hackney","16:00:00","2019-03-29",403,46,146,89,7,691
"Hillingdon","16:00:00","2019-03-29",56,0,1,3,0,60
"Lambeth","16:00:00","2019-03-29",32,4,0,8,0,44
"Southwark","16:00:00","2019-03-29",197,44,33,110,7,391
"Ealing","17:00:00","2019-03-29",143,2,0,18,0,163
"Hackney","17:00:00","2019-03-29",477,57,138,72,6,750
"Hillingdon","17:00:00","2019-03-29",51,2,0,3,0,56
"Lambeth","17:00:00","2019-03-29",36,0,0,6,0,42
"Southwark","17:00:00","2019-03-29",188,55,29,73,2,347
"Ealing","18:00:00","2019-03-29",111,4,0,11,0,126
"Hackney","18:00:00","2019-03-29",479,64,139,65,4,751
"Hillingdon","18:00:00","2019-03-29",60,4,0,8,0,72
"Lambeth","18:00:00","2019-03-29",39,6,0,4,0,49
"Southwark","18:00:00","2019-03-29",241,58,28,55,3,385
"Croydon","07:00:00","2019-04-01",1100,44,6,275,27,1452
"Havering","07:00:00","2019-04-01",1070,4,83,205,42,1404
"Lewisham","07:00:00","2019-04-01",30,0,0,7,0,37
"Tower Hamlets","07:00:00","2019-04-01",1833,81,27,669,234,2844
"Westminster","07:00:00","2019-04-01",42,5,0,16,1,64
"Croydon","08:00:00","2019-04-01",1378,30,10,270,33,1721
"Havering","08:00:00","2019-04-01",1286,19,87,185,36,1613
"Lewisham","08:00:00","2019-04-01",67,0,3,11,0,81
"Tower Hamlets","08:00:00","2019-04-01",2106,76,34,650,233,3099
"Westminster","08:00:00","2019-04-01",80,11,0,23,0,114
"Croydon","09:00:00","2019-04-01",1083,25,13,281,39,1441
"Havering","09:00:00","2019-04-01",1039,17,89,199,38,1382
"Lewisham","09:00:00","2019-04-01",48,0,0,12,0,60
"Tower Hamlets","09:00:00","2019-04-01",1814,54,40,774,270,2952
"Westminster","09:00:00","2019-04-01",68,10,0,17,1,96
"Croydon","10:00:00","2019-04-01",1035,21,11,278,28,1373
"Havering","10:00:00","2019-04-01",979,15,83,218,54,1349
"Lewisham","10:00:00","2019-04-01",31,0,0,16,2,49
"Tower Hamlets","10:00:00","2019-04-01",1622,33,31,750,309,2745
"Westminster","10:00:00","2019-04-01",75,8,0,24,0,107
"Croydon","11:00:00","2019-04-01",1033,26,14,265,30,1368
"Havering","11:00:00","2019-04-01",1105,22,77,176,52,1432
"Lewisham","11:00:00","2019-04-01",57,0,0,10,0,67
"Tower Hamlets","11:00:00","2019-04-01",1601,29,40,689,334,2693
"Westminster","11:00:00","2019-04-01",87,11,0,15,0,113
"Croydon","12:00:00","2019-04-01",1021,34,6,276,33,1370
"Havering","12:00:00","2019-04-01",1115,22,76,182,33,1428
"Lewisham","12:00:00","2019-04-01",43,0,0,6,2,51
"Tower Hamlets","12:00:00","2019-04-01",1634,41,35,722,310,2742
"Westminster","12:00:00","2019-04-01",69,19,0,17,1,106
"Croydon","13:00:00","2019-04-01",1117,27,5,239,24,1412
"Havering","13:00:00","2019-04-01",1255,28,75,170,42,1570
"Lewisham","13:00:00","2019-04-01",32,0,0,13,2,47
"Tower Hamlets","13:00:00","2019-04-01",1713,59,26,645,299,2742
"Westminster","13:00:00","2019-04-01",68,16,0,18,0,102
"Croydon","14:00:00","2019-04-01",1246,37,9,254,34,1580
"Havering","14:00:00","2019-04-01",1265,23,77,186,32,1583
"Lewisham","14:00:00","2019-04-01",45,1,0,13,0,59
"Tower Hamlets","14:00:00","2019-04-01",1770,47,34,626,297,2774
"Westminster","14:00:00","2019-04-01",57,12,0,17,1,87
"Croydon","15:00:00","2019-04-01",1232,41,11,232,22,1538
"Havering","15:00:00","2019-04-01",1318,14,76,213,21,1642
"Lewisham","15:00:00","2019-04-01",70,1,0,11,0,82
"Tower Hamlets","15:00:00","2019-04-01",1807,54,30,550,258,2699
"Westminster","15:00:00","2019-04-01",72,19,0,15,1,107
"Croydon","16:00:00","2019-04-01",1335,63,8,241,11,1658
"Havering","16:00:00","2019-04-01",1266,27,81,209,23,1606
"Lewisham","16:00:00","2019-04-01",71,2,3,10,0,86
"Tower Hamlets","16:00:00","2019-04-01",1880,99,35,523,120,2657
"Westminster","16:00:00","2019-04-01",75,18,0,9,0,102
"Croydon","17:00:00","2019-04-01",1444,37,2,178,9,1670
"Havering","17:00:00","2019-04-01",1487,27,75,163,13,1765
"Lewisham","17:00:00","2019-04-01",64,1,0,8,0,73
"Tower Hamlets","17:00:00","2019-04-01",2074,113,37,384,74,2682
"Westminster","17:00:00","2019-04-01",76,24,0,8,0,108
"Croydon","18:00:00","2019-04-01",1264,46,5,147,7,1469
"Havering","18:00:00","2019-04-01",1414,24,86,134,17,1675
"Lewisham","18:00:00","2019-04-01",60,6,0,9,0,75
"Tower Hamlets","18:00:00","2019-04-01",2056,85,31,322,39,2533
"Westminster","18:00:00","2019-04-01",71,14,0,3,0,88
"Barking and Dagenham","07:00:00","2019-04-02",1042,23,38,361,86,1550
"Hillingdon","07:00:00","2019-04-02",2330,28,45,476,112,2991
"Hounslow","07:00:00","2019-04-02",690,33,17,175,26,941
"Waltham Forest","07:00:00","2019-04-02",488,5,15,108,10,626
"Barking and Dagenham","08:00:00","2019-04-02",1321,28,41,301,102,1793
"Hillingdon","08:00:00","2019-04-02",2353,32,59,472,151,3067
"Hounslow","08:00:00","2019-04-02",702,46,13,153,12,926
"Waltham Forest","08:00:00","2019-04-02",697,8,11,114,17,847
"Barking and Dagenham","09:00:00","2019-04-02",1152,13,44,349,115,1673
"Hillingdon","09:00:00","2019-04-02",1714,23,45,507,175,2464
"Hounslow","09:00:00","2019-04-02",737,31,17,164,25,974
"Waltham Forest","09:00:00","2019-04-02",568,6,20,120,14,728
"Barking and Dagenham","10:00:00","2019-04-02",1028,7,26,258,112,1431
"Hillingdon","10:00:00","2019-04-02",1412,11,36,360,167,1986
"Hounslow","10:00:00","2019-04-02",578,16,17,173,28,812
"Waltham Forest","10:00:00","2019-04-02",513,8,16,135,21,693
"Barking and Dagenham","11:00:00","2019-04-02",1089,7,32,338,129,1595
"Hillingdon","11:00:00","2019-04-02",1417,23,32,397,140,2009
"Hounslow","11:00:00","2019-04-02",525,17,15,166,29,752
"Waltham Forest","11:00:00","2019-04-02",480,2,15,104,8,609
"Barking and Dagenham","12:00:00","2019-04-02",1270,9,23,342,138,1782
"Hillingdon","12:00:00","2019-04-02",1589,10,34,373,107,2113
"Hounslow","12:00:00","2019-04-02",547,19,14,152,23,755
"Waltham Forest","12:00:00","2019-04-02",448,5,16,111,8,588
"Barking and Dagenham","13:00:00","2019-04-02",1209,9,29,299,128,1674
"Hillingdon","13:00:00","2019-04-02",1722,20,35,369,135,2281
"Hounslow","13:00:00","2019-04-02",598,27,13,157,12,807
"Waltham Forest","13:00:00","2019-04-02",486,4,19,132,16,657
"Barking and Dagenham","14:00:00","2019-04-02",1301,14,20,304,120,1759
"Hillingdon","14:00:00","2019-04-02",1922,14,50,432,149,2567
"Hounslow","14:00:00","2019-04-02",578,21,16,148,16,779
"Waltham Forest","14:00:00","2019-04-02",509,7,17,112,11,656
"Barking and Dagenham","15:00:00","2019-04-02",1285,17,25,292,92,1711
"Hillingdon","15:00:00","2019-04-02",1983,15,54,429,131,2612
"Hounslow","15:00:00","2019-04-02",597,34,14,164,10,819
"Waltham Forest","15:00:00","2019-04-02",726,16,17,100,4,863
"Barking and Dagenham","16:00:00","2019-04-02",1364,23,21,277,62,1747
"Hillingdon","16:00:00","2019-04-02",2113,33,47,412,94,2699
"Hounslow","16:00:00","2019-04-02",693,44,13,139,5,894
"Waltham Forest","16:00:00","2019-04-02",731,11,16,114,4,876
"Barking and Dagenham","17:00:00","2019-04-02",1530,33,25,204,49,1841
"Hillingdon","17:00:00","2019-04-02",2341,45,35,331,30,2782
"Hounslow","17:00:00","2019-04-02",557,40,14,98,5,714
"Waltham Forest","17:00:00","2019-04-02",680,9,18,91,2,800
"Barking and Dagenham","18:00:00","2019-04-02",1463,31,24,199,58,1775
"Hillingdon","18:00:00","2019-04-02",2460,30,36,242,27,2795
"Hounslow","18:00:00","2019-04-02",573,66,12,43,4,698
"Waltham Forest","18:00:00","2019-04-02",615,10,15,67,4,711
"Bexley","07:00:00","2019-04-03",792,10,20,246,41,1109
"Camden","07:00:00","2019-04-03",377,22,70,108,19,596
"Enfield","07:00:00","2019-04-03",4768,117,52,1691,453,7081
"Lambeth","07:00:00","2019-04-03",185,34,46,101,35,401
"Lewisham","07:00:00","2019-04-03",281,11,15,58,9,374
"Newham","07:00:00","2019-04-03",4122,391,15,1744,541,6813
"Southwark","07:00:00","2019-04-03",204,77,11,318,59,669
"Bexley","08:00:00","2019-04-03",961,8,19,227,50,1265
"Camden","08:00:00","2019-04-03",467,16,73,141,23,720
"Enfield","08:00:00","2019-04-03",4593,85,55,1157,409,6299
"Lambeth","08:00:00","2019-04-03",196,37,44,95,34,406
"Lewisham","08:00:00","2019-04-03",380,18,26,86,15,525
"Newham","08:00:00","2019-04-03",4737,244,22,1406,580,6989
"Southwark","08:00:00","2019-04-03",209,64,6,179,25,483
"Bexley","09:00:00","2019-04-03",1070,6,28,227,50,1381
"Camden","09:00:00","2019-04-03",406,28,62,125,28,649
"Enfield","09:00:00","2019-04-03",4393,76,56,1333,480,6338
"Lambeth","09:00:00","2019-04-03",207,24,50,85,38,404
"Lewisham","09:00:00","2019-04-03",302,14,20,57,14,407
"Newham","09:00:00","2019-04-03",4167,126,29,1408,659,6389
"Southwark","09:00:00","2019-04-03",172,67,15,239,28,521
"Bexley","10:00:00","2019-04-03",922,7,28,205,44,1206
"Camden","10:00:00","2019-04-03",424,13,85,147,19,688
"Enfield","10:00:00","2019-04-03",4311,48,56,1444,602,6461
"Lambeth","10:00:00","2019-04-03",217,19,38,116,50,440
"Lewisham","10:00:00","2019-04-03",305,10,17,55,8,395
"Newham","10:00:00","2019-04-03",3452,75,29,1260,682,5498
"Southwark","10:00:00","2019-04-03",134,32,8,182,24,380
"Bexley","11:00:00","2019-04-03",952,10,29,179,37,1207
"Camden","11:00:00","2019-04-03",420,17,75,185,17,714
"Enfield","11:00:00","2019-04-03",4601,53,40,1396,572,6662
"Lambeth","11:00:00","2019-04-03",262,18,40,127,43,490
"Lewisham","11:00:00","2019-04-03",226,11,15,63,14,329
"Newham","11:00:00","2019-04-03",3395,88,21,1263,687,5454
"Southwark","11:00:00","2019-04-03",123,28,9,175,19,354
"Bexley","12:00:00","2019-04-03",796,6,19,128,35,984
"Camden","12:00:00","2019-04-03",396,35,75,146,18,670
"Enfield","12:00:00","2019-04-03",4716,52,47,1449,559,6823
"Lambeth","12:00:00","2019-04-03",313,27,40,123,25,528
"Lewisham","12:00:00","2019-04-03",247,19,15,63,8,352
"Newham","12:00:00","2019-04-03",3662,67,21,1339,714,5803
"Southwark","12:00:00","2019-04-03",144,19,9,170,19,361
"Bexley","13:00:00","2019-04-03",958,6,22,184,39,1209
"Camden","13:00:00","2019-04-03",429,23,68,118,13,651
"Enfield","13:00:00","2019-04-03",4851,61,44,1444,534,6934
"Lambeth","13:00:00","2019-04-03",323,27,42,139,32,563
"Lewisham","13:00:00","2019-04-03",242,16,16,67,10,351
"Newham","13:00:00","2019-04-03",3727,72,16,1371,672,5858
"Southwark","13:00:00","2019-04-03",123,35,10,140,25,333
"Bexley","14:00:00","2019-04-03",1071,7,23,237,40,1378
"Camden","14:00:00","2019-04-03",373,21,74,99,10,577
"Enfield","14:00:00","2019-04-03",5044,64,65,1401,486,7060
"Lambeth","14:00:00","2019-04-03",336,30,40,140,44,590
"Lewisham","14:00:00","2019-04-03",267,13,20,50,4,354
"Newham","14:00:00","2019-04-03",4131,84,27,1466,642,6350
"Southwark","14:00:00","2019-04-03",136,28,9,102,13,288
"Bexley","15:00:00","2019-04-03",1247,10,16,214,24,1511
"Camden","15:00:00","2019-04-03",425,29,66,130,14,664
"Enfield","15:00:00","2019-04-03",5352,78,63,1475,350,7318
"Lambeth","15:00:00","2019-04-03",290,17,34,121,30,492
"Lewisham","15:00:00","2019-04-03",314,15,14,60,4,407
"Newham","15:00:00","2019-04-03",4575,120,10,1559,488,6752
"Southwark","15:00:00","2019-04-03",138,16,12,99,11,276
"Bexley","16:00:00","2019-04-03",1134,16,14,216,21,1401
"Camden","16:00:00","2019-04-03",436,39,71,90,12,648
"Enfield","16:00:00","2019-04-03",5255,104,52,1261,243,6915
"Lambeth","16:00:00","2019-04-03",315,31,41,130,20,537
"Lewisham","16:00:00","2019-04-03",367,18,22,112,4,523
"Newham","16:00:00","2019-04-03",4807,276,21,1469,295,6868
"Southwark","16:00:00","2019-04-03",177,30,8,108,9,332
"Bexley","17:00:00","2019-04-03",1164,23,15,202,16,1420
"Camden","17:00:00","2019-04-03",439,39,76,94,14,662
"Enfield","17:00:00","2019-04-03",5532,144,58,1066,167,6967
"Lambeth","17:00:00","2019-04-03",352,45,42,71,6,516
"Lewisham","17:00:00","2019-04-03",383,28,20,64,3,498
"Newham","17:00:00","2019-04-03",5125,383,12,1093,173,6786
"Southwark","17:00:00","2019-04-03",167,34,8,74,5,288
"Bexley","18:00:00","2019-04-03",812,5,17,84,9,927
"Camden","18:00:00","2019-04-03",386,45,54,84,6,575
"Enfield","18:00:00","2019-04-03",5431,129,66,884,135,6645
"Lambeth","18:00:00","2019-04-03",373,64,37,52,9,535
"Lewisham","18:00:00","2019-04-03",375,27,19,41,2,464
"Newham","18:00:00","2019-04-03",5449,250,20,799,163,6681
"Southwark","18:00:00","2019-04-03",260,32,9,85,3,389
"Barnet","07:00:00","2019-04-04",2696,110,36,888,229,3959
"Camden","07:00:00","2019-04-04",190,18,43,85,23,359
"Hackney","07:00:00","2019-04-04",1055,83,135,539,65,1877
"Hammersmith and Fulham","07:00:00","2019-04-04",306,19,56,81,15,477
"Southwark","07:00:00","2019-04-04",250,34,14,145,25,468
"Wandsworth","07:00:00","2019-04-04",962,98,52,430,66,1608
"Barnet","08:00:00","2019-04-04",3062,63,45,586,202,3958
"Camden","08:00:00","2019-04-04",219,22,38,113,20,412
"Hackney","08:00:00","2019-04-04",1039,96,128,424,63,1750
"Hammersmith and Fulham","08:00:00","2019-04-04",417,26,41,61,11,556
"Southwark","08:00:00","2019-04-04",273,33,13,150,25,494
"Wandsworth","08:00:00","2019-04-04",948,111,42,396,65,1562
"Barnet","09:00:00","2019-04-04",2809,47,36,598,274,3764
"Camden","09:00:00","2019-04-04",217,21,39,107,19,403
"Hackney","09:00:00","2019-04-04",924,66,129,401,53,1573
"Hammersmith and Fulham","09:00:00","2019-04-04",439,21,48,102,22,632
"Southwark","09:00:00","2019-04-04",256,29,15,119,25,444
"Wandsworth","09:00:00","2019-04-04",1017,69,36,339,85,1546
"Barnet","10:00:00","2019-04-04",2413,33,38,612,253,3349
"Camden","10:00:00","2019-04-04",197,16,42,111,18,384
"Hackney","10:00:00","2019-04-04",959,33,132,430,75,1629
"Hammersmith and Fulham","10:00:00","2019-04-04",376,22,52,110,22,582
"Southwark","10:00:00","2019-04-04",277,29,12,126,18,462
"Wandsworth","10:00:00","2019-04-04",919,43,36,378,77,1453
"Barnet","11:00:00","2019-04-04",2403,25,33,635,300,3396
"Camden","11:00:00","2019-04-04",220,27,37,118,17,419
"Hackney","11:00:00","2019-04-04",936,41,120,399,65,1561
"Hammersmith and Fulham","11:00:00","2019-04-04",389,23,40,97,8,557
"Southwark","11:00:00","2019-04-04",267,32,14,141,16,470
"Wandsworth","11:00:00","2019-04-04",943,47,28,381,87,1486
"Barnet","12:00:00","2019-04-04",2256,27,36,591,261,3171
"Camden","12:00:00","2019-04-04",218,36,38,115,15,422
"Hackney","12:00:00","2019-04-04",930,41,121,354,70,1516
"Hammersmith and Fulham","12:00:00","2019-04-04",428,49,41,115,11,644
"Southwark","12:00:00","2019-04-04",264,43,15,131,20,473
"Wandsworth","12:00:00","2019-04-04",873,65,28,393,68,1427
"Barnet","13:00:00","2019-04-04",2670,23,41,643,267,3644
"Camden","13:00:00","2019-04-04",227,31,37,98,12,405
"Hackney","13:00:00","2019-04-04",1032,40,130,383,53,1638
"Hammersmith and Fulham","13:00:00","2019-04-04",376,44,52,117,13,602
"Southwark","13:00:00","2019-04-04",289,32,14,133,17,485
"Wandsworth","13:00:00","2019-04-04",1009,74,33,377,72,1565
"Barnet","14:00:00","2019-04-04",2781,18,36,807,254,3896
"Camden","14:00:00","2019-04-04",270,46,40,102,15,473
"Hackney","14:00:00","2019-04-04",1028,36,113,301,45,1523
"Hammersmith and Fulham","14:00:00","2019-04-04",414,50,41,111,13,629
"Southwark","14:00:00","2019-04-04",318,38,14,130,12,512
"Wandsworth","14:00:00","2019-04-04",949,57,25,349,51,1431
"Barnet","15:00:00","2019-04-04",3036,47,41,801,205,4130
"Camden","15:00:00","2019-04-04",290,37,37,113,7,484
"Hackney","15:00:00","2019-04-04",1048,39,126,267,29,1509
"Hammersmith and Fulham","15:00:00","2019-04-04",510,41,48,133,3,735
"Southwark","15:00:00","2019-04-04",329,33,12,130,14,518
"Wandsworth","15:00:00","2019-04-04",1003,67,31,351,49,1501
"Barnet","16:00:00","2019-04-04",3362,65,42,779,155,4403
"Camden","16:00:00","2019-04-04",288,25,41,111,8,473
"Hackney","16:00:00","2019-04-04",1107,50,133,292,22,1604
"Hammersmith and Fulham","16:00:00","2019-04-04",580,60,52,112,3,807
"Southwark","16:00:00","2019-04-04",323,35,14,143,4,519
"Wandsworth","16:00:00","2019-04-04",1106,93,36,310,39,1584
"Barnet","17:00:00","2019-04-04",3614,90,34,644,93,4475
"Camden","17:00:00","2019-04-04",286,46,41,110,4,487
"Hackney","17:00:00","2019-04-04",1146,61,103,228,13,1551
"Hammersmith and Fulham","17:00:00","2019-04-04",611,55,43,99,7,815
"Southwark","17:00:00","2019-04-04",386,54,13,116,4,573
"Wandsworth","17:00:00","2019-04-04",1136,142,31,286,20,1615
"Barnet","18:00:00","2019-04-04",3527,89,29,546,80,4271
"Camden","18:00:00","2019-04-04",277,45,36,96,7,461
"Hackney","18:00:00","2019-04-04",1244,79,139,221,7,1690
"Hammersmith and Fulham","18:00:00","2019-04-04",591,64,46,75,2,778
"Southwark","18:00:00","2019-04-04",479,60,17,66,2,624
"Wandsworth","18:00:00","2019-04-04",1208,138,34,160,19,1559
"Haringey","07:00:00","2019-04-05",727,35,63,267,39,1131
"Kingston upon Thames","07:00:00","2019-04-05",4828,109,90,1228,145,6400
"Redbridge","07:00:00","2019-04-05",540,9,27,143,5,724
"Westminster","07:00:00","2019-04-05",374,110,133,197,37,851
"Hammersmith and Fulham","08:00:00","2019-04-05",4329,272,74,1005,355,6035
"Haringey","08:00:00","2019-04-05",744,33,67,191,21,1056
"Kingston upon Thames","08:00:00","2019-04-05",4253,155,87,870,177,5542
"Redbridge","08:00:00","2019-04-05",638,6,29,139,10,822
"Westminster","08:00:00","2019-04-05",408,126,141,239,39,953
"Hammersmith and Fulham","09:00:00","2019-04-05",4732,161,90,988,369,6340
"Haringey","09:00:00","2019-04-05",698,23,61,200,24,1006
"Kingston upon Thames","09:00:00","2019-04-05",4150,72,109,905,160,5396
"Redbridge","09:00:00","2019-04-05",642,7,24,144,18,835
"Westminster","09:00:00","2019-04-05",496,72,167,180,24,939
"Hammersmith and Fulham","10:00:00","2019-04-05",4866,99,87,998,411,6461
"Haringey","10:00:00","2019-04-05",634,20,65,213,33,965
"Kingston upon Thames","10:00:00","2019-04-05",4179,63,105,1064,193,5604
"Redbridge","10:00:00","2019-04-05",527,9,27,140,21,724
"Westminster","10:00:00","2019-04-05",524,44,168,150,26,912
"Hammersmith and Fulham","11:00:00","2019-04-05",4926,113,59,1118,349,6565
"Haringey","11:00:00","2019-04-05",614,24,61,215,28,942
"Kingston upon Thames","11:00:00","2019-04-05",4089,65,98,1037,179,5468
"Redbridge","11:00:00","2019-04-05",603,6,25,135,16,785
"Westminster","11:00:00","2019-04-05",473,34,158,144,28,837
"Hammersmith and Fulham","12:00:00","2019-04-05",4917,99,51,1075,337,6479
"Haringey","12:00:00","2019-04-05",640,30,66,164,19,919
"Kingston upon Thames","12:00:00","2019-04-05",4090,70,107,870,149,5286
"Redbridge","12:00:00","2019-04-05",739,22,30,170,19,980
"Westminster","12:00:00","2019-04-05",595,41,145,176,20,977
"Hammersmith and Fulham","13:00:00","2019-04-05",4865,104,63,1031,311,6374
"Haringey","13:00:00","2019-04-05",633,39,61,149,20,902
"Kingston upon Thames","13:00:00","2019-04-05",4569,74,94,925,146,5808
"Redbridge","13:00:00","2019-04-05",669,18,22,181,6,896
"Westminster","13:00:00","2019-04-05",677,46,159,122,20,1024
"Hammersmith and Fulham","14:00:00","2019-04-05",4988,101,52,996,247,6384
"Haringey","14:00:00","2019-04-05",682,36,63,187,18,986
"Kingston upon Thames","14:00:00","2019-04-05",4495,87,103,969,126,5780
"Redbridge","14:00:00","2019-04-05",719,16,24,166,7,932
"Westminster","14:00:00","2019-04-05",539,33,161,119,17,869
"Hammersmith and Fulham","15:00:00","2019-04-05",5181,139,73,943,194,6530
"Haringey","15:00:00","2019-04-05",690,44,66,177,16,993
"Kingston upon Thames","15:00:00","2019-04-05",4685,93,87,965,83,5913
"Redbridge","15:00:00","2019-04-05",790,18,32,173,17,1030
"Westminster","15:00:00","2019-04-05",601,69,140,99,20,929
"Haringey","16:00:00","2019-04-05",767,53,55,192,19,1086
"Kingston upon Thames","16:00:00","2019-04-05",4989,138,114,848,52,6141
"Redbridge","16:00:00","2019-04-05",912,23,32,166,9,1142
"Westminster","16:00:00","2019-04-05",390,73,158,65,5,691
"Haringey","17:00:00","2019-04-05",822,58,60,174,10,1124
"Kingston upon Thames","17:00:00","2019-04-05",5333,153,79,660,34,6259
"Redbridge","17:00:00","2019-04-05",893,23,26,122,2,1066
"Westminster","17:00:00","2019-04-05",717,93,174,84,10,1078
"Haringey","18:00:00","2019-04-05",847,81,58,146,6,1138
"Kingston upon Thames","18:00:00","2019-04-05",5435,122,100,525,31,6213
"Redbridge","18:00:00","2019-04-05",1076,31,28,95,2,1232
"Westminster","18:00:00","2019-04-05",859,94,153,50,9,1165
"Bexley","07:00:00","2019-04-23",728,11,54,146,19,958
"Greenwich","07:00:00","2019-04-23",324,20,51,81,15,491
"Haringey","07:00:00","2019-04-23",29,1,0,9,4,43
"Hillingdon","07:00:00","2019-04-23",573,1,6,73,2,655
"Bexley","08:00:00","2019-04-23",892,17,55,128,27,1119
"Greenwich","08:00:00","2019-04-23",667,12,59,87,19,844
"Haringey","08:00:00","2019-04-23",64,3,6,14,1,88
"Hillingdon","08:00:00","2019-04-23",695,1,8,80,1,785
"Bexley","09:00:00","2019-04-23",930,14,60,170,45,1219
"Greenwich","09:00:00","2019-04-23",505,6,49,72,13,645
"Haringey","09:00:00","2019-04-23",55,1,1,9,5,71
"Hillingdon","09:00:00","2019-04-23",474,1,7,58,1,541
"Bexley","10:00:00","2019-04-23",914,12,48,120,21,1115
"Greenwich","10:00:00","2019-04-23",396,8,52,78,16,550
"Haringey","10:00:00","2019-04-23",47,5,0,14,1,67
"Hillingdon","10:00:00","2019-04-23",435,1,5,53,0,494
"Bexley","11:00:00","2019-04-23",975,14,52,153,29,1223
"Greenwich","11:00:00","2019-04-23",456,4,47,119,13,639
"Haringey","11:00:00","2019-04-23",48,2,1,15,1,67
"Hillingdon","11:00:00","2019-04-23",474,0,7,61,2,544
"Bexley","12:00:00","2019-04-23",1114,15,50,148,22,1349
"Greenwich","12:00:00","2019-04-23",496,5,43,167,9,720
"Haringey","12:00:00","2019-04-23",50,9,0,21,1,81
"Hillingdon","12:00:00","2019-04-23",525,2,7,54,4,592
"Bexley","13:00:00","2019-04-23",903,13,39,109,24,1088
"Greenwich","13:00:00","2019-04-23",538,11,47,139,4,739
"Haringey","13:00:00","2019-04-23",51,7,0,9,0,67
"Hillingdon","13:00:00","2019-04-23",499,4,5,65,1,574
"Bexley","14:00:00","2019-04-23",965,16,52,141,19,1193
"Greenwich","14:00:00","2019-04-23",576,14,51,152,9,802
"Haringey","14:00:00","2019-04-23",60,3,0,11,2,76
"Hillingdon","14:00:00","2019-04-23",572,3,6,69,1,651
"Bexley","15:00:00","2019-04-23",1254,22,55,157,21,1509
"Greenwich","15:00:00","2019-04-23",693,13,54,136,12,908
"Haringey","15:00:00","2019-04-23",87,5,3,13,0,108
"Hillingdon","15:00:00","2019-04-23",669,2,11,71,3,756
"Bexley","16:00:00","2019-04-23",1021,18,57,172,3,1271
"Greenwich","16:00:00","2019-04-23",724,12,48,108,8,900
"Haringey","16:00:00","2019-04-23",66,5,0,13,2,86
"Hillingdon","16:00:00","2019-04-23",640,5,6,71,0,722
"Bexley","17:00:00","2019-04-23",1089,18,53,107,6,1273
"Greenwich","17:00:00","2019-04-23",776,16,45,131,5,973
"Haringey","17:00:00","2019-04-23",87,12,0,14,0,113
"Hillingdon","17:00:00","2019-04-23",714,6,7,69,1,797
"Bexley","18:00:00","2019-04-23",767,11,44,61,1,884
"Greenwich","18:00:00","2019-04-23",685,19,49,89,1,843
"Haringey","18:00:00","2019-04-23",74,4,0,8,0,86
"Hillingdon","18:00:00","2019-04-23",671,3,7,40,0,721
"Barking and Dagenham","07:00:00","2019-04-24",278,5,2,104,27,416
"Barnet","07:00:00","2019-04-24",431,1,38,105,2,577
"Croydon","07:00:00","2019-04-24",154,2,3,22,0,181
"Hammersmith and Fulham","07:00:00","2019-04-24",443,31,37,134,15,660
"Hounslow","07:00:00","2019-04-24",122,3,1,31,1,158
"Tower Hamlets","07:00:00","2019-04-24",91,9,0,34,4,138
"Barking and Dagenham","08:00:00","2019-04-24",361,3,3,67,11,445
"Barnet","08:00:00","2019-04-24",620,2,33,80,6,741
"Croydon","08:00:00","2019-04-24",179,1,4,16,0,200
"Hammersmith and Fulham","08:00:00","2019-04-24",394,48,33,132,13,620
"Hounslow","08:00:00","2019-04-24",251,5,0,25,2,283
"Tower Hamlets","08:00:00","2019-04-24",181,10,0,28,2,221
"Barking and Dagenham","09:00:00","2019-04-24",295,7,0,97,23,422
"Barnet","09:00:00","2019-04-24",337,1,35,38,7,418
"Croydon","09:00:00","2019-04-24",108,1,4,9,3,125
"Hammersmith and Fulham","09:00:00","2019-04-24",360,26,34,118,13,551
"Hounslow","09:00:00","2019-04-24",127,1,0,26,3,157
"Tower Hamlets","09:00:00","2019-04-24",102,4,0,30,1,137
"Barking and Dagenham","10:00:00","2019-04-24",266,1,0,87,13,367
"Barnet","10:00:00","2019-04-24",331,3,39,39,5,417
"Croydon","10:00:00","2019-04-24",67,2,4,15,1,89
"Hammersmith and Fulham","10:00:00","2019-04-24",358,25,29,158,24,594
"Hounslow","10:00:00","2019-04-24",118,1,0,22,2,143
"Merton","10:00:00","2019-04-24",3577,60,17,814,333,4801
"Tower Hamlets","10:00:00","2019-04-24",129,2,0,24,2,157
"Barking and Dagenham","11:00:00","2019-04-24",292,6,0,78,24,400
"Barnet","11:00:00","2019-04-24",298,4,33,51,6,392
"Croydon","11:00:00","2019-04-24",63,1,4,14,2,84
"Hammersmith and Fulham","11:00:00","2019-04-24",295,24,30,154,22,525
"Hounslow","11:00:00","2019-04-24",105,1,1,26,1,134
"Merton","11:00:00","2019-04-24",3377,46,9,836,313,4581
"Tower Hamlets","11:00:00","2019-04-24",152,5,0,29,2,188
"Barking and Dagenham","12:00:00","2019-04-24",356,1,1,102,20,480
"Barnet","12:00:00","2019-04-24",312,3,35,58,6,414
"Croydon","12:00:00","2019-04-24",57,1,4,17,1,80
"Hammersmith and Fulham","12:00:00","2019-04-24",413,58,25,124,18,638
"Hounslow","12:00:00","2019-04-24",115,3,2,17,2,139
"Merton","12:00:00","2019-04-24",3510,66,14,918,289,4797
"Tower Hamlets","12:00:00","2019-04-24",157,8,0,24,3,192
"Barking and Dagenham","13:00:00","2019-04-24",356,2,0,103,27,488
"Barnet","13:00:00","2019-04-24",313,2,34,68,3,420
"Croydon","13:00:00","2019-04-24",51,0,4,16,2,73
"Hammersmith and Fulham","13:00:00","2019-04-24",412,50,26,157,22,667
"Hounslow","13:00:00","2019-04-24",135,2,0,35,0,172
"Merton","13:00:00","2019-04-24",3533,65,15,919,300,4832
"Tower Hamlets","13:00:00","2019-04-24",177,9,0,37,2,225
"Barking and Dagenham","14:00:00","2019-04-24",423,7,0,102,32,564
"Barnet","14:00:00","2019-04-24",374,4,33,84,2,497
"Croydon","14:00:00","2019-04-24",76,0,4,18,0,98
"Hammersmith and Fulham","14:00:00","2019-04-24",304,52,35,159,28,578
"Hounslow","14:00:00","2019-04-24",99,1,0,20,1,121
"Merton","14:00:00","2019-04-24",3808,58,16,1088,301,5271
"Tower Hamlets","14:00:00","2019-04-24",172,6,0,31,1,210
"Barking and Dagenham","15:00:00","2019-04-24",478,5,4,92,28,607
"Barnet","15:00:00","2019-04-24",490,3,38,62,2,595
"Croydon","15:00:00","2019-04-24",102,0,5,11,0,118
"Hammersmith and Fulham","15:00:00","2019-04-24",449,37,26,126,13,651
"Hounslow","15:00:00","2019-04-24",164,4,0,18,1,187
"Tower Hamlets","15:00:00","2019-04-24",187,4,0,30,0,221
"Barking and Dagenham","16:00:00","2019-04-24",540,6,0,98,11,655
"Barnet","16:00:00","2019-04-24",475,7,39,62,2,585
"Croydon","16:00:00","2019-04-24",78,0,6,13,0,97
"Hammersmith and Fulham","16:00:00","2019-04-24",558,47,27,145,12,789
"Hounslow","16:00:00","2019-04-24",199,4,0,24,0,227
"Tower Hamlets","16:00:00","2019-04-24",169,2,0,27,2,200
"Barking and Dagenham","17:00:00","2019-04-24",564,6,0,79,9,658
"Barnet","17:00:00","2019-04-24",560,11,32,69,1,673
"Croydon","17:00:00","2019-04-24",106,2,4,11,0,123
"Hammersmith and Fulham","17:00:00","2019-04-24",522,69,33,117,6,747
"Hounslow","17:00:00","2019-04-24",223,5,0,21,0,249
"Tower Hamlets","17:00:00","2019-04-24",164,3,0,21,1,189
"Barking and Dagenham","18:00:00","2019-04-24",430,9,0,61,4,504
"Barnet","18:00:00","2019-04-24",464,5,35,38,1,543
"Croydon","18:00:00","2019-04-24",103,4,4,12,0,123
"Hammersmith and Fulham","18:00:00","2019-04-24",560,88,33,77,4,762
"Hounslow","18:00:00","2019-04-24",232,8,0,15,1,256
"Tower Hamlets","18:00:00","2019-04-24",166,2,0,15,0,183
"Barking and Dagenham","07:00:00","2019-04-25",25,0,0,8,2,35
"Barnet","07:00:00","2019-04-25",689,4,26,106,4,829
"Enfield","07:00:00","2019-04-25",137,2,0,36,1,176
"Haringey","07:00:00","2019-04-25",256,8,1,84,5,354
"Harrow","07:00:00","2019-04-25",602,8,13,96,20,739
"Hillingdon","07:00:00","2019-04-25",888,4,5,143,16,1056
"Hounslow","07:00:00","2019-04-25",2267,21,17,466,164,2935
"Lewisham","07:00:00","2019-04-25",273,2,0,104,0,379
"Waltham Forest","07:00:00","2019-04-25",827,33,26,347,81,1314
"Barking and Dagenham","08:00:00","2019-04-25",58,0,0,7,0,65
"Barnet","08:00:00","2019-04-25",691,5,20,82,7,805
"Enfield","08:00:00","2019-04-25",293,1,0,30,2,326
"Haringey","08:00:00","2019-04-25",376,21,3,73,5,478
"Harrow","08:00:00","2019-04-25",764,5,14,95,26,904
"Hillingdon","08:00:00","2019-04-25",1317,6,8,116,17,1464
"Hounslow","08:00:00","2019-04-25",2209,23,17,544,203,2996
"Lewisham","08:00:00","2019-04-25",338,1,0,81,1,421
"Waltham Forest","08:00:00","2019-04-25",980,37,20,374,94,1505
"Barking and Dagenham","09:00:00","2019-04-25",32,0,0,8,3,43
"Barnet","09:00:00","2019-04-25",532,3,25,75,4,639
"Enfield","09:00:00","2019-04-25",136,0,0,20,1,157
"Haringey","09:00:00","2019-04-25",250,21,3,72,7,353
"Harrow","09:00:00","2019-04-25",658,8,21,99,18,804
"Hillingdon","09:00:00","2019-04-25",575,6,8,75,20,684
"Hounslow","09:00:00","2019-04-25",2168,19,17,516,240,2960
"Lewisham","09:00:00","2019-04-25",301,2,0,66,2,371
"Waltham Forest","09:00:00","2019-04-25",988,34,22,364,104,1512
"Barking and Dagenham","10:00:00","2019-04-25",27,0,0,6,2,35
"Barnet","10:00:00","2019-04-25",467,4,18,76,8,573
"Enfield","10:00:00","2019-04-25",118,3,0,20,1,142
"Haringey","10:00:00","2019-04-25",209,15,0,91,2,317
"Harrow","10:00:00","2019-04-25",642,4,16,89,19,770
"Hillingdon","10:00:00","2019-04-25",470,3,6,104,24,607
"Hounslow","10:00:00","2019-04-25",1845,20,18,576,283,2742
"Lewisham","10:00:00","2019-04-25",189,0,0,51,0,240
"Waltham Forest","10:00:00","2019-04-25",914,22,23,360,111,1430
"Barking and Dagenham","11:00:00","2019-04-25",25,0,0,4,1,30
"Barnet","11:00:00","2019-04-25",518,4,18,74,6,620
"Enfield","11:00:00","2019-04-25",112,1,0,16,0,129
"Haringey","11:00:00","2019-04-25",168,20,0,72,1,261
"Harrow","11:00:00","2019-04-25",666,6,17,87,15,791
"Hillingdon","11:00:00","2019-04-25",530,3,9,103,18,663
"Hounslow","11:00:00","2019-04-25",1801,16,14,495,303,2629
"Lewisham","11:00:00","2019-04-25",161,1,0,46,2,210
"Waltham Forest","11:00:00","2019-04-25",856,24,19,356,109,1364
"Barking and Dagenham","12:00:00","2019-04-25",21,0,0,7,0,28
"Barnet","12:00:00","2019-04-25",508,6,17,73,5,609
"Enfield","12:00:00","2019-04-25",121,4,0,15,0,140
"Haringey","12:00:00","2019-04-25",193,18,0,82,2,295
"Harrow","12:00:00","2019-04-25",660,14,15,79,21,789
"Hillingdon","12:00:00","2019-04-25",528,3,7,82,16,636
"Hounslow","12:00:00","2019-04-25",2052,17,16,668,259,3012
"Lewisham","12:00:00","2019-04-25",185,1,0,46,0,232
"Waltham Forest","12:00:00","2019-04-25",983,28,18,352,115,1496
"Barking and Dagenham","13:00:00","2019-04-25",30,0,0,10,1,41
"Barnet","13:00:00","2019-04-25",513,3,14,55,8,593
"Enfield","13:00:00","2019-04-25",132,13,0,37,0,182
"Haringey","13:00:00","2019-04-25",200,17,0,75,3,295
"Harrow","13:00:00","2019-04-25",708,12,14,71,12,817
"Hillingdon","13:00:00","2019-04-25",514,5,7,83,17,626
"Hounslow","13:00:00","2019-04-25",2099,22,19,610,232,2982
"Lewisham","13:00:00","2019-04-25",216,4,0,60,0,280
"Waltham Forest","13:00:00","2019-04-25",891,27,15,372,107,1412
"Barking and Dagenham","14:00:00","2019-04-25",23,0,0,6,2,31
"Barnet","14:00:00","2019-04-25",536,2,20,69,7,634
"Enfield","14:00:00","2019-04-25",173,2,0,31,0,206
"Haringey","14:00:00","2019-04-25",252,17,2,84,3,358
"Harrow","14:00:00","2019-04-25",776,16,17,74,18,901
"Hillingdon","14:00:00","2019-04-25",619,5,7,94,16,741
"Hounslow","14:00:00","2019-04-25",2299,18,19,562,270,3168
"Lewisham","14:00:00","2019-04-25",241,4,0,65,0,310
"Waltham Forest","14:00:00","2019-04-25",961,44,32,351,92,1480
"Barking and Dagenham","15:00:00","2019-04-25",55,0,0,6,1,62
"Barnet","15:00:00","2019-04-25",775,5,23,76,6,885
"Enfield","15:00:00","2019-04-25",287,3,0,40,0,330
"Haringey","15:00:00","2019-04-25",352,24,2,64,5,447
"Harrow","15:00:00","2019-04-25",779,16,16,82,12,905
"Hillingdon","15:00:00","2019-04-25",1006,0,6,114,17,1143
"Hounslow","15:00:00","2019-04-25",2466,21,19,611,215,3332
"Lewisham","15:00:00","2019-04-25",290,2,0,106,1,399
"Waltham Forest","15:00:00","2019-04-25",1071,34,18,307,72,1502
"Barking and Dagenham","16:00:00","2019-04-25",28,0,0,9,1,38
"Barnet","16:00:00","2019-04-25",715,5,22,73,3,818
"Enfield","16:00:00","2019-04-25",325,3,0,51,0,379
"Haringey","16:00:00","2019-04-25",295,17,1,89,1,403
"Harrow","16:00:00","2019-04-25",955,24,14,106,11,1110
"Hillingdon","16:00:00","2019-04-25",979,7,7,120,10,1123
"Hounslow","16:00:00","2019-04-25",2484,34,19,567,185,3289
"Lewisham","16:00:00","2019-04-25",441,8,0,128,0,577
"Waltham Forest","16:00:00","2019-04-25",1017,30,20,237,53,1357
"Barking and Dagenham","17:00:00","2019-04-25",32,0,0,4,0,36
"Barnet","17:00:00","2019-04-25",801,6,20,76,2,905
"Enfield","17:00:00","2019-04-25",287,1,0,35,1,324
"Haringey","17:00:00","2019-04-25",380,28,0,81,4,493
"Harrow","17:00:00","2019-04-25",888,19,9,94,7,1017
"Hillingdon","17:00:00","2019-04-25",971,13,8,103,11,1106
"Hounslow","17:00:00","2019-04-25",2743,37,16,519,186,3501
"Lewisham","17:00:00","2019-04-25",431,7,0,106,2,546
"Waltham Forest","17:00:00","2019-04-25",1075,36,22,191,26,1350
"Barking and Dagenham","18:00:00","2019-04-25",36,0,0,10,0,46
"Barnet","18:00:00","2019-04-25",754,3,17,41,4,819
"Enfield","18:00:00","2019-04-25",216,5,1,23,0,245
"Haringey","18:00:00","2019-04-25",388,16,0,58,1,463
"Harrow","18:00:00","2019-04-25",909,18,15,65,4,1011
"Hillingdon","18:00:00","2019-04-25",812,14,6,78,10,920
"Hounslow","18:00:00","2019-04-25",2774,35,14,539,175,3537
"Lewisham","18:00:00","2019-04-25",332,1,0,52,0,385
"Waltham Forest","18:00:00","2019-04-25",1239,39,25,127,19,1449
"Barnet","07:00:00","2019-04-26",617,6,47,125,11,806
"Bexley","07:00:00","2019-04-26",151,1,0,12,1,165
"Hammersmith and Fulham","07:00:00","2019-04-26",728,59,33,416,47,1283
"Haringey","07:00:00","2019-04-26",325,14,21,127,16,503
"Lambeth","07:00:00","2019-04-26",313,17,20,78,9,437
"Newham","07:00:00","2019-04-26",245,6,12,39,9,311
"Redbridge","07:00:00","2019-04-26",6314,151,31,2328,884,9708
"Waltham Forest","07:00:00","2019-04-26",40,0,0,6,0,46
"Westminster","07:00:00","2019-04-26",269,17,0,177,46,509
"Barnet","08:00:00","2019-04-26",613,3,32,75,13,736
"Bexley","08:00:00","2019-04-26",374,0,0,20,0,394
"Hammersmith and Fulham","08:00:00","2019-04-26",877,53,21,286,65,1302
"Haringey","08:00:00","2019-04-26",442,19,18,134,5,618
"Lambeth","08:00:00","2019-04-26",320,12,24,67,10,433
"Newham","08:00:00","2019-04-26",346,5,9,48,9,417
"Redbridge","08:00:00","2019-04-26",6049,123,48,1882,862,8964
"Waltham Forest","08:00:00","2019-04-26",79,1,0,6,0,86
"Westminster","08:00:00","2019-04-26",400,58,1,155,29,643
"Barnet","09:00:00","2019-04-26",610,8,25,72,7,722
"Bexley","09:00:00","2019-04-26",149,0,0,19,0,168
"Hammersmith and Fulham","09:00:00","2019-04-26",751,58,22,303,54,1188
"Haringey","09:00:00","2019-04-26",329,11,20,120,6,486
"Lambeth","09:00:00","2019-04-26",268,9,21,86,23,407
"Newham","09:00:00","2019-04-26",312,6,10,50,8,386
"Redbridge","09:00:00","2019-04-26",5610,55,49,1819,966,8499
"Waltham Forest","09:00:00","2019-04-26",43,0,0,9,1,53
"Westminster","09:00:00","2019-04-26",470,50,0,211,21,752
"Barnet","10:00:00","2019-04-26",690,8,27,66,15,806
"Bexley","10:00:00","2019-04-26",87,3,0,13,0,103
"Hammersmith and Fulham","10:00:00","2019-04-26",788,45,22,327,75,1257
"Haringey","10:00:00","2019-04-26",275,11,18,130,12,446
"Lambeth","10:00:00","2019-04-26",265,9,20,71,21,386
"Newham","10:00:00","2019-04-26",279,9,9,43,7,347
"Redbridge","10:00:00","2019-04-26",5497,43,39,1850,1039,8468
"Waltham Forest","10:00:00","2019-04-26",32,0,0,4,1,37
"Westminster","10:00:00","2019-04-26",562,47,1,222,26,858
"Barnet","11:00:00","2019-04-26",589,6,31,72,13,711
"Bexley","11:00:00","2019-04-26",87,0,0,10,1,98
"Hammersmith and Fulham","11:00:00","2019-04-26",798,60,20,312,91,1281
"Haringey","11:00:00","2019-04-26",290,19,20,125,5,459
"Lambeth","11:00:00","2019-04-26",271,13,18,80,21,403
"Newham","11:00:00","2019-04-26",327,7,9,72,1,416
"Redbridge","11:00:00","2019-04-26",5417,48,36,2024,973,8498
"Waltham Forest","11:00:00","2019-04-26",31,2,0,10,0,43
"Westminster","11:00:00","2019-04-26",515,62,0,203,16,796
"Barnet","12:00:00","2019-04-26",626,4,25,76,5,736
"Bexley","12:00:00","2019-04-26",106,1,0,20,3,130
"Hammersmith and Fulham","12:00:00","2019-04-26",836,54,20,329,66,1305
"Haringey","12:00:00","2019-04-26",296,30,17,93,2,438
"Lambeth","12:00:00","2019-04-26",347,11,18,111,23,510
"Newham","12:00:00","2019-04-26",340,13,8,57,1,419
"Redbridge","12:00:00","2019-04-26",5761,56,42,2053,950,8862
"Waltham Forest","12:00:00","2019-04-26",33,3,0,7,6,49
"Westminster","12:00:00","2019-04-26",631,52,1,188,20,892
"Barnet","13:00:00","2019-04-26",715,10,29,62,6,822
"Bexley","13:00:00","2019-04-26",88,0,0,18,0,106
"Hammersmith and Fulham","13:00:00","2019-04-26",862,51,20,346,46,1325
"Haringey","13:00:00","2019-04-26",295,18,16,92,3,424
"Lambeth","13:00:00","2019-04-26",321,11,20,110,14,476
"Newham","13:00:00","2019-04-26",339,6,8,50,2,405
"Redbridge","13:00:00","2019-04-26",6132,64,40,2084,948,9268
"Waltham Forest","13:00:00","2019-04-26",25,0,0,3,1,29
"Westminster","13:00:00","2019-04-26",641,66,2,148,23,880
"Barnet","14:00:00","2019-04-26",717,4,36,74,7,838
"Bexley","14:00:00","2019-04-26",104,0,0,17,0,121
"Hammersmith and Fulham","14:00:00","2019-04-26",992,75,23,340,57,1487
"Haringey","14:00:00","2019-04-26",382,18,17,95,9,521
"Lambeth","14:00:00","2019-04-26",335,22,31,72,12,472
"Newham","14:00:00","2019-04-26",455,9,10,73,4,551
"Redbridge","14:00:00","2019-04-26",6667,71,51,2117,814,9720
"Waltham Forest","14:00:00","2019-04-26",43,1,0,6,0,50
"Westminster","14:00:00","2019-04-26",549,73,0,120,13,755
"Barnet","15:00:00","2019-04-26",820,5,26,90,13,954
"Bexley","15:00:00","2019-04-26",269,3,0,22,0,294
"Hammersmith and Fulham","15:00:00","2019-04-26",983,55,21,316,39,1414
"Haringey","15:00:00","2019-04-26",405,24,21,108,7,565
"Lambeth","15:00:00","2019-04-26",349,21,17,106,13,506
"Newham","15:00:00","2019-04-26",496,9,11,73,4,593
"Waltham Forest","15:00:00","2019-04-26",83,1,0,5,0,89
"Westminster","15:00:00","2019-04-26",661,49,3,104,11,828
"Barnet","16:00:00","2019-04-26",747,13,27,81,3,871
"Bexley","16:00:00","2019-04-26",234,1,0,31,0,266
"Hammersmith and Fulham","16:00:00","2019-04-26",1281,70,21,349,30,1751
"Haringey","16:00:00","2019-04-26",449,40,22,136,2,649
"Lambeth","16:00:00","2019-04-26",453,43,23,90,5,614
"Newham","16:00:00","2019-04-26",506,7,12,57,4,586
"Waltham Forest","16:00:00","2019-04-26",56,2,0,11,1,70
"Westminster","16:00:00","2019-04-26",706,42,1,88,12,849
"Barnet","17:00:00","2019-04-26",870,13,30,86,5,1004
"Bexley","17:00:00","2019-04-26",250,2,0,21,1,274
"Hammersmith and Fulham","17:00:00","2019-04-26",1217,72,26,293,35,1643
"Haringey","17:00:00","2019-04-26",492,37,16,96,2,643
"Lambeth","17:00:00","2019-04-26",431,62,17,77,2,589
"Newham","17:00:00","2019-04-26",486,20,11,60,4,581
"Waltham Forest","17:00:00","2019-04-26",69,2,0,11,1,83
"Westminster","17:00:00","2019-04-26",762,57,0,55,5,879
"Barnet","18:00:00","2019-04-26",860,24,26,52,0,962
"Bexley","18:00:00","2019-04-26",174,0,0,9,0,183
"Hammersmith and Fulham","18:00:00","2019-04-26",1315,76,21,197,23,1632
"Haringey","18:00:00","2019-04-26",525,50,21,70,1,667
"Lambeth","18:00:00","2019-04-26",404,51,20,40,0,515
"Newham","18:00:00","2019-04-26",576,9,11,74,0,670
"Redbridge","18:00:00","2019-04-26",6857,106,35,1006,230,8234
"Waltham Forest","18:00:00","2019-04-26",56,1,0,14,0,71
"Westminster","18:00:00","2019-04-26",766,59,0,45,7,877
"Bromley","07:00:00","2019-04-29",1255,10,2,356,38,1661
"Ealing","07:00:00","2019-04-29",276,16,15,193,29,529
"Hillingdon","07:00:00","2019-04-29",51,0,1,10,1,63
"Tower Hamlets","07:00:00","2019-04-29",3264,389,15,1198,394,5260
"Westminster","07:00:00","2019-04-29",323,62,100,162,44,691
"Bromley","08:00:00","2019-04-29",1194,3,3,209,38,1447
"Ealing","08:00:00","2019-04-29",294,11,16,197,29,547
"Hillingdon","08:00:00","2019-04-29",141,0,0,2,0,143
"Tower Hamlets","08:00:00","2019-04-29",3695,312,24,1134,450,5615
"Westminster","08:00:00","2019-04-29",377,99,88,185,51,800
"Bromley","09:00:00","2019-04-29",994,9,1,199,41,1244
"Ealing","09:00:00","2019-04-29",246,16,21,175,22,480
"Hillingdon","09:00:00","2019-04-29",29,1,0,2,0,32
"Tower Hamlets","09:00:00","2019-04-29",3222,185,23,1090,542,5062
"Westminster","09:00:00","2019-04-29",338,70,104,156,35,703
"Bromley","10:00:00","2019-04-29",863,3,0,211,43,1120
"Ealing","10:00:00","2019-04-29",228,24,17,179,23,471
"Hillingdon","10:00:00","2019-04-29",22,0,0,4,1,27
"Tower Hamlets","10:00:00","2019-04-29",2625,99,14,1100,572,4410
"Westminster","10:00:00","2019-04-29",399,46,102,148,32,727
"Bromley","11:00:00","2019-04-29",905,5,3,185,30,1128
"Ealing","11:00:00","2019-04-29",216,19,16,182,18,451
"Hillingdon","11:00:00","2019-04-29",39,0,0,7,0,46
"Tower Hamlets","11:00:00","2019-04-29",2517,113,13,1037,553,4233
"Westminster","11:00:00","2019-04-29",444,62,110,199,39,854
"Bromley","12:00:00","2019-04-29",968,10,2,180,26,1186
"Ealing","12:00:00","2019-04-29",259,22,16,184,17,498
"Hillingdon","12:00:00","2019-04-29",36,1,0,5,1,43
"Tower Hamlets","12:00:00","2019-04-29",2521,155,6,1118,510,4310
"Westminster","12:00:00","2019-04-29",405,50,101,124,15,695
"Bromley","13:00:00","2019-04-29",904,3,1,213,24,1145
"Ealing","13:00:00","2019-04-29",246,31,18,139,32,466
"Hillingdon","13:00:00","2019-04-29",36,1,0,5,0,42
"Tower Hamlets","13:00:00","2019-04-29",3005,164,15,1172,516,4872
"Westminster","13:00:00","2019-04-29",507,55,100,124,18,804
"Bromley","14:00:00","2019-04-29",1038,2,1,203,19,1263
"Ealing","14:00:00","2019-04-29",293,26,17,151,28,515
"Hillingdon","14:00:00","2019-04-29",67,0,0,10,2,79
"Tower Hamlets","14:00:00","2019-04-29",2779,171,17,1019,413,4399
"Westminster","14:00:00","2019-04-29",549,55,98,134,17,853
"Bromley","15:00:00","2019-04-29",1212,14,2,222,16,1466
"Ealing","15:00:00","2019-04-29",334,34,15,160,16,559
"Hillingdon","15:00:00","2019-04-29",90,0,2,7,0,99
"Tower Hamlets","15:00:00","2019-04-29",3075,195,10,1025,294,4599
"Westminster","15:00:00","2019-04-29",564,54,106,85,15,824
"Bromley","16:00:00","2019-04-29",1248,9,8,260,14,1539
"Ealing","16:00:00","2019-04-29",387,30,18,136,13,584
"Hillingdon","16:00:00","2019-04-29",66,2,0,7,2,77
"Tower Hamlets","16:00:00","2019-04-29",3249,299,20,1042,293,4903
"Westminster","16:00:00","2019-04-29",628,59,99,73,9,868
"Bromley","17:00:00","2019-04-29",1712,15,1,210,9,1947
"Ealing","17:00:00","2019-04-29",447,40,18,113,5,623
"Hillingdon","17:00:00","2019-04-29",64,3,0,5,0,72
"Tower Hamlets","17:00:00","2019-04-29",3909,451,49,867,184,5460
"Westminster","17:00:00","2019-04-29",645,85,104,60,8,902
"Bromley","18:00:00","2019-04-29",1264,15,2,110,5,1396
"Ealing","18:00:00","2019-04-29",394,44,19,66,16,539
"Hillingdon","18:00:00","2019-04-29",33,3,0,2,0,38
"Tower Hamlets","18:00:00","2019-04-29",4093,423,26,629,139,5310
"Westminster","18:00:00","2019-04-29",642,53,98,26,8,827
"Barnet","07:00:00","2019-04-30",15,0,0,7,0,22
"Bromley","07:00:00","2019-04-30",16,0,0,0,0,16
"Croydon","07:00:00","2019-04-30",374,10,14,96,6,500
"Ealing","07:00:00","2019-04-30",733,41,32,242,46,1094
"Havering","07:00:00","2019-04-30",888,30,21,291,75,1305
"Lewisham","07:00:00","2019-04-30",16,2,0,9,0,27
"Tower Hamlets","07:00:00","2019-04-30",523,14,13,176,5,731
"Barnet","08:00:00","2019-04-30",31,0,0,3,0,34
"Bromley","08:00:00","2019-04-30",13,0,0,2,0,15
"Croydon","08:00:00","2019-04-30",516,6,17,77,9,625
"Ealing","08:00:00","2019-04-30",667,30,32,181,38,948
"Havering","08:00:00","2019-04-30",957,17,18,243,45,1280
"Lewisham","08:00:00","2019-04-30",18,0,0,2,1,21
"Tower Hamlets","08:00:00","2019-04-30",802,13,10,153,12,990
"Barnet","09:00:00","2019-04-30",23,0,0,4,0,27
"Bromley","09:00:00","2019-04-30",12,0,0,5,0,17
"Croydon","09:00:00","2019-04-30",337,4,16,58,9,424
"Ealing","09:00:00","2019-04-30",667,33,27,198,33,958
"Havering","09:00:00","2019-04-30",714,11,22,260,109,1116
"Lewisham","09:00:00","2019-04-30",10,0,0,4,0,14
"Tower Hamlets","09:00:00","2019-04-30",689,8,20,163,17,897
"Barnet","10:00:00","2019-04-30",18,0,0,12,0,30
"Bromley","10:00:00","2019-04-30",9,0,0,4,0,13
"Croydon","10:00:00","2019-04-30",250,2,15,47,4,318
"Ealing","10:00:00","2019-04-30",596,23,29,190,37,875
"Havering","10:00:00","2019-04-30",610,4,17,222,94,947
"Lewisham","10:00:00","2019-04-30",9,0,0,7,1,17
"Tower Hamlets","10:00:00","2019-04-30",636,15,17,167,8,843
"Barnet","11:00:00","2019-04-30",12,0,0,6,0,18
"Bromley","11:00:00","2019-04-30",10,0,0,7,0,17
"Croydon","11:00:00","2019-04-30",239,3,14,56,11,323
"Ealing","11:00:00","2019-04-30",557,24,27,170,29,807
"Havering","11:00:00","2019-04-30",658,11,17,248,62,996
"Lewisham","11:00:00","2019-04-30",16,0,0,3,0,19
"Tower Hamlets","11:00:00","2019-04-30",515,14,9,124,11,673
"Barnet","12:00:00","2019-04-30",12,0,0,5,0,17
"Bromley","12:00:00","2019-04-30",13,0,0,0,0,13
"Croydon","12:00:00","2019-04-30",305,9,15,58,7,394
"Ealing","12:00:00","2019-04-30",601,28,27,215,26,897
"Havering","12:00:00","2019-04-30",706,5,16,239,98,1064
"Lewisham","12:00:00","2019-04-30",11,1,0,3,0,15
"Tower Hamlets","12:00:00","2019-04-30",592,20,11,130,12,765
"Barnet","13:00:00","2019-04-30",19,0,0,6,0,25
"Bromley","13:00:00","2019-04-30",13,0,0,1,0,14
"Croydon","13:00:00","2019-04-30",240,11,16,60,15,342
"Ealing","13:00:00","2019-04-30",607,36,33,196,44,916
"Havering","13:00:00","2019-04-30",706,8,16,247,87,1064
"Lewisham","13:00:00","2019-04-30",10,2,0,9,0,21
"Tower Hamlets","13:00:00","2019-04-30",695,35,13,152,11,906
"Barnet","14:00:00","2019-04-30",13,2,0,2,0,17
"Bromley","14:00:00","2019-04-30",10,0,0,1,0,11
"Croydon","14:00:00","2019-04-30",315,4,15,66,8,408
"Ealing","14:00:00","2019-04-30",666,49,28,190,28,961
"Havering","14:00:00","2019-04-30",858,11,20,300,53,1242
"Lewisham","14:00:00","2019-04-30",13,0,0,4,0,17
"Tower Hamlets","14:00:00","2019-04-30",628,22,15,129,13,807
"Barnet","15:00:00","2019-04-30",19,0,0,5,0,24
"Bromley","15:00:00","2019-04-30",9,0,0,3,0,12
"Croydon","15:00:00","2019-04-30",399,6,15,68,9,497
"Ealing","15:00:00","2019-04-30",632,37,39,167,14,889
"Havering","15:00:00","2019-04-30",1013,13,17,326,79,1448
"Lewisham","15:00:00","2019-04-30",18,0,0,2,0,20
"Tower Hamlets","15:00:00","2019-04-30",921,21,19,126,10,1097
"Barnet","16:00:00","2019-04-30",16,0,0,2,0,18
"Bromley","16:00:00","2019-04-30",8,1,0,4,0,13
"Croydon","16:00:00","2019-04-30",434,15,16,88,4,557
"Ealing","16:00:00","2019-04-30",751,48,24,130,13,966
"Havering","16:00:00","2019-04-30",1277,20,14,352,33,1696
"Lewisham","16:00:00","2019-04-30",15,0,0,1,0,16
"Tower Hamlets","16:00:00","2019-04-30",891,35,14,122,5,1067
"Barnet","17:00:00","2019-04-30",10,0,0,5,0,15
"Bromley","17:00:00","2019-04-30",16,0,0,3,0,19
"Croydon","17:00:00","2019-04-30",482,12,15,71,5,585
"Ealing","17:00:00","2019-04-30",733,62,24,106,15,940
"Havering","17:00:00","2019-04-30",1530,37,15,266,20,1868
"Lewisham","17:00:00","2019-04-30",20,0,0,3,0,23
"Tower Hamlets","17:00:00","2019-04-30",779,21,12,80,1,893
"Barnet","18:00:00","2019-04-30",19,0,0,0,0,19
"Bromley","18:00:00","2019-04-30",10,1,0,1,0,12
"Croydon","18:00:00","2019-04-30",521,9,15,51,4,600
"Ealing","18:00:00","2019-04-30",744,55,29,112,31,971
"Havering","18:00:00","2019-04-30",1215,19,18,193,12,1457
"Lewisham","18:00:00","2019-04-30",18,2,0,5,0,25
"Tower Hamlets","18:00:00","2019-04-30",874,23,7,63,0,967
"Brent","07:00:00","2019-05-01",4963,187,29,1691,650,7520
"Hounslow","07:00:00","2019-05-01",2802,57,19,732,315,3925
"Wandsworth","07:00:00","2019-05-01",648,52,38,218,20,976
"Brent","08:00:00","2019-05-01",5007,143,24,1310,629,7113
"Hounslow","08:00:00","2019-05-01",2725,47,18,559,352,3701
"Waltham Forest","08:00:00","2019-05-01",5227,107,30,1438,567,7369
"Wandsworth","08:00:00","2019-05-01",642,31,27,191,26,917
"Brent","09:00:00","2019-05-01",4709,108,25,1426,799,7067
"Hounslow","09:00:00","2019-05-01",2637,32,18,668,366,3721
"Waltham Forest","09:00:00","2019-05-01",5082,77,42,1545,704,7450
"Wandsworth","09:00:00","2019-05-01",502,23,33,167,21,746
"Brent","10:00:00","2019-05-01",4653,86,24,1674,864,7301
"Hounslow","10:00:00","2019-05-01",2607,29,12,690,390,3728
"Waltham Forest","10:00:00","2019-05-01",4603,45,34,1539,675,6896
"Wandsworth","10:00:00","2019-05-01",468,36,38,191,31,764
"Brent","11:00:00","2019-05-01",4741,86,25,1713,826,7391
"Hounslow","11:00:00","2019-05-01",2514,25,15,658,386,3598
"Waltham Forest","11:00:00","2019-05-01",4767,56,25,1563,697,7108
"Wandsworth","11:00:00","2019-05-01",464,26,29,169,37,725
"Brent","12:00:00","2019-05-01",4796,93,19,1743,825,7476
"Hounslow","12:00:00","2019-05-01",2737,26,11,693,350,3817
"Waltham Forest","12:00:00","2019-05-01",5065,67,30,1618,778,7558
"Wandsworth","12:00:00","2019-05-01",456,24,33,170,11,694
"Brent","13:00:00","2019-05-01",4833,97,31,1717,786,7464
"Hounslow","13:00:00","2019-05-01",2823,25,9,645,376,3878
"Waltham Forest","13:00:00","2019-05-01",4500,54,25,1602,673,6854
"Wandsworth","13:00:00","2019-05-01",490,28,30,185,39,772
"Brent","14:00:00","2019-05-01",5254,119,29,1653,691,7746
"Hounslow","14:00:00","2019-05-01",3037,26,19,623,322,4027
"Wandsworth","14:00:00","2019-05-01",561,31,35,157,33,817
"Brent","15:00:00","2019-05-01",5343,131,26,1649,600,7749
"Hounslow","15:00:00","2019-05-01",3006,48,22,660,310,4046
"Wandsworth","15:00:00","2019-05-01",494,26,28,159,16,723
"Brent","16:00:00","2019-05-01",5837,191,24,1622,433,8107
"Hounslow","16:00:00","2019-05-01",3259,60,12,633,197,4161
"Wandsworth","16:00:00","2019-05-01",717,55,35,184,19,1010
"Brent","17:00:00","2019-05-01",6511,239,30,1364,286,8430
"Hounslow","17:00:00","2019-05-01",3381,67,7,493,150,4098
"Wandsworth","17:00:00","2019-05-01",699,51,34,144,10,938
"Brent","18:00:00","2019-05-01",6531,179,31,947,247,7935
"Hounslow","18:00:00","2019-05-01",3413,41,8,429,117,4008
"Wandsworth","18:00:00","2019-05-01",776,57,32,123,12,1000
"Barnet","07:00:00","2019-05-03",2869,83,26,892,201,4071
"Croydon","07:00:00","2019-05-03",111,1,0,23,1,136
"Greenwich","07:00:00","2019-05-03",416,9,34,73,20,552
"Hounslow","07:00:00","2019-05-03",1153,25,93,211,39,1521
"Kensington and Chelsea","07:00:00","2019-05-03",350,47,22,89,14,522
"Newham","07:00:00","2019-05-03",623,10,63,147,26,869
"Tower Hamlets","07:00:00","2019-05-03",3586,327,30,1447,460,5850
"Barnet","08:00:00","2019-05-03",3334,68,14,568,168,4152
"Croydon","08:00:00","2019-05-03",138,0,2,21,5,166
"Enfield","08:00:00","2019-05-03",6161,33,38,1946,1657,9835
"Greenwich","08:00:00","2019-05-03",798,7,34,118,21,978
"Hounslow","08:00:00","2019-05-03",1527,13,76,213,45,1874
"Kensington and Chelsea","08:00:00","2019-05-03",520,75,35,140,18,788
"Newham","08:00:00","2019-05-03",806,15,60,127,27,1035
"Tower Hamlets","08:00:00","2019-05-03",3884,240,22,1229,504,5879
"Barnet","09:00:00","2019-05-03",2644,30,11,616,193,3494
"Croydon","09:00:00","2019-05-03",88,0,0,24,3,115
"Enfield","09:00:00","2019-05-03",4968,29,35,1617,1610,8259
"Greenwich","09:00:00","2019-05-03",870,8,36,104,40,1058
"Hounslow","09:00:00","2019-05-03",1241,12,87,202,55,1597
"Kensington and Chelsea","09:00:00","2019-05-03",477,43,29,157,13,719
"Newham","09:00:00","2019-05-03",705,12,67,139,27,950
"Tower Hamlets","09:00:00","2019-05-03",3394,130,14,1139,568,5245
"Barnet","10:00:00","2019-05-03",2308,20,3,602,247,3180
"Croydon","10:00:00","2019-05-03",82,2,0,22,6,112
"Enfield","10:00:00","2019-05-03",5625,34,37,1633,1889,9218
"Greenwich","10:00:00","2019-05-03",666,10,36,108,36,856
"Hounslow","10:00:00","2019-05-03",1206,17,83,210,41,1557
"Kensington and Chelsea","10:00:00","2019-05-03",392,26,26,150,9,603
"Newham","10:00:00","2019-05-03",638,16,64,158,20,896
"Tower Hamlets","10:00:00","2019-05-03",2796,92,16,1116,546,4566
"Barnet","11:00:00","2019-05-03",2254,26,6,561,170,3017
"Croydon","11:00:00","2019-05-03",94,0,0,17,0,111
"Enfield","11:00:00","2019-05-03",5963,22,23,1743,1842,9593
"Greenwich","11:00:00","2019-05-03",741,17,38,117,27,940
"Hounslow","11:00:00","2019-05-03",1202,18,87,211,54,1572
"Kensington and Chelsea","11:00:00","2019-05-03",411,42,25,191,17,686
"Newham","11:00:00","2019-05-03",684,13,54,144,21,916
"Tower Hamlets","11:00:00","2019-05-03",2923,115,15,1124,563,4740
"Barnet","12:00:00","2019-05-03",2291,28,5,606,194,3124
"Croydon","12:00:00","2019-05-03",99,2,0,13,1,115
"Greenwich","12:00:00","2019-05-03",698,22,35,144,22,921
"Hounslow","12:00:00","2019-05-03",1274,23,77,196,49,1619
"Kensington and Chelsea","12:00:00","2019-05-03",447,51,24,173,16,711
"Newham","12:00:00","2019-05-03",864,32,60,129,18,1103
"Tower Hamlets","12:00:00","2019-05-03",3338,117,16,1204,503,5178
"Barnet","13:00:00","2019-05-03",2325,31,7,619,169,3151
"Croydon","13:00:00","2019-05-03",96,1,0,17,3,117
"Greenwich","13:00:00","2019-05-03",656,29,33,118,28,864
"Hounslow","13:00:00","2019-05-03",1334,28,79,192,34,1667
"Kensington and Chelsea","13:00:00","2019-05-03",423,51,29,151,14,668
"Newham","13:00:00","2019-05-03",717,25,58,111,14,925
"Tower Hamlets","13:00:00","2019-05-03",3218,129,9,1193,482,5031
"Barnet","14:00:00","2019-05-03",2421,33,4,613,138,3209
"Croydon","14:00:00","2019-05-03",93,0,0,17,9,119
"Greenwich","14:00:00","2019-05-03",770,25,44,109,22,970
"Hounslow","14:00:00","2019-05-03",1586,22,78,225,35,1946
"Kensington and Chelsea","14:00:00","2019-05-03",450,44,23,149,8,674
"Newham","14:00:00","2019-05-03",868,21,56,120,14,1079
"Tower Hamlets","14:00:00","2019-05-03",3525,154,20,1236,474,5409
"Barnet","15:00:00","2019-05-03",2809,28,35,619,92,3583
"Croydon","15:00:00","2019-05-03",139,1,1,18,2,161
"Greenwich","15:00:00","2019-05-03",747,21,37,122,22,949
"Hounslow","15:00:00","2019-05-03",1697,16,77,211,30,2031
"Kensington and Chelsea","15:00:00","2019-05-03",600,59,21,128,5,813
"Newham","15:00:00","2019-05-03",990,14,55,111,15,1185
"Tower Hamlets","15:00:00","2019-05-03",4198,192,11,1332,357,6090
"Barnet","16:00:00","2019-05-03",3357,58,23,670,91,4199
"Croydon","16:00:00","2019-05-03",127,1,0,25,0,153
"Greenwich","16:00:00","2019-05-03",824,22,41,132,21,1040
"Hounslow","16:00:00","2019-05-03",1932,41,92,221,27,2313
"Kensington and Chelsea","16:00:00","2019-05-03",548,75,24,114,8,769
"Newham","16:00:00","2019-05-03",705,17,55,93,14,884
"Tower Hamlets","16:00:00","2019-05-03",4993,323,14,1305,273,6908
"Barnet","17:00:00","2019-05-03",3619,60,12,557,64,4312
"Croydon","17:00:00","2019-05-03",148,0,0,19,3,170
"Greenwich","17:00:00","2019-05-03",1084,35,42,154,6,1321
"Hounslow","17:00:00","2019-05-03",1749,38,76,200,22,2085
"Kensington and Chelsea","17:00:00","2019-05-03",531,73,19,75,7,705
"Newham","17:00:00","2019-05-03",745,14,66,95,7,927
"Tower Hamlets","17:00:00","2019-05-03",4673,253,25,843,158,5952
"Barnet","18:00:00","2019-05-03",3449,83,9,406,50,3997
"Croydon","18:00:00","2019-05-03",98,0,0,17,0,115
"Greenwich","18:00:00","2019-05-03",892,33,31,85,3,1044
"Hounslow","18:00:00","2019-05-03",1646,47,74,151,17,1935
"Kensington and Chelsea","18:00:00","2019-05-03",582,100,27,58,4,771
"Newham","18:00:00","2019-05-03",658,22,60,58,2,800
"Tower Hamlets","18:00:00","2019-05-03",5584,286,24,704,160,6758
"Barnet","07:00:00","2019-05-07",260,6,20,34,11,331
"Bexley","07:00:00","2019-05-07",411,1,0,107,3,522
"Bromley","07:00:00","2019-05-07",639,8,2,113,5,767
"Croydon","07:00:00","2019-05-07",38,0,0,10,1,49
"Hillingdon","07:00:00","2019-05-07",124,0,0,21,1,146
"Hounslow","07:00:00","2019-05-07",855,8,33,144,3,1043
"Lewisham","07:00:00","2019-05-07",298,1,13,50,10,372
"Richmond upon Thames","07:00:00","2019-05-07",1056,10,41,119,8,1234
"Barnet","08:00:00","2019-05-07",394,4,29,71,10,508
"Bexley","08:00:00","2019-05-07",592,3,0,128,5,728
"Bromley","08:00:00","2019-05-07",765,10,0,85,1,861
"Croydon","08:00:00","2019-05-07",88,0,0,15,0,103
"Hillingdon","08:00:00","2019-05-07",144,1,0,12,0,157
"Hounslow","08:00:00","2019-05-07",970,8,36,118,5,1137
"Lewisham","08:00:00","2019-05-07",373,6,15,31,5,430
"Richmond upon Thames","08:00:00","2019-05-07",1015,10,34,111,20,1190
"Barnet","09:00:00","2019-05-07",469,8,30,59,17,583
"Bexley","09:00:00","2019-05-07",405,5,0,123,7,540
"Bromley","09:00:00","2019-05-07",348,2,0,75,4,429
"Croydon","09:00:00","2019-05-07",41,0,0,6,0,47
"Hillingdon","09:00:00","2019-05-07",85,0,0,12,0,97
"Hounslow","09:00:00","2019-05-07",645,4,26,89,10,774
"Lewisham","09:00:00","2019-05-07",288,3,15,44,6,356
"Richmond upon Thames","09:00:00","2019-05-07",640,11,43,113,17,824
"Barnet","10:00:00","2019-05-07",702,12,29,48,15,806
"Bexley","10:00:00","2019-05-07",306,5,0,74,3,388
"Bromley","10:00:00","2019-05-07",277,9,0,51,9,346
"Croydon","10:00:00","2019-05-07",31,0,0,10,2,43
"Hillingdon","10:00:00","2019-05-07",59,0,0,19,1,79
"Hounslow","10:00:00","2019-05-07",479,1,26,78,13,597
"Lewisham","10:00:00","2019-05-07",227,4,13,41,8,293
"Richmond upon Thames","10:00:00","2019-05-07",552,7,41,108,22,730
"Barnet","11:00:00","2019-05-07",739,13,29,38,19,838
"Bexley","11:00:00","2019-05-07",286,3,0,87,2,378
"Bromley","11:00:00","2019-05-07",309,5,0,64,8,386
"Croydon","11:00:00","2019-05-07",38,0,0,6,2,46
"Hillingdon","11:00:00","2019-05-07",69,0,0,17,4,90
"Hounslow","11:00:00","2019-05-07",545,8,26,67,6,652
"Lewisham","11:00:00","2019-05-07",235,2,11,32,8,288
"Richmond upon Thames","11:00:00","2019-05-07",564,6,43,106,18,737
"Barnet","12:00:00","2019-05-07",870,35,31,41,15,992
"Bexley","12:00:00","2019-05-07",332,4,0,115,15,466
"Bromley","12:00:00","2019-05-07",306,5,0,67,7,385
"Croydon","12:00:00","2019-05-07",40,0,0,4,0,44
"Hillingdon","12:00:00","2019-05-07",78,0,0,17,4,99
"Hounslow","12:00:00","2019-05-07",547,2,31,90,3,673
"Lewisham","12:00:00","2019-05-07",238,2,10,32,10,292
"Richmond upon Thames","12:00:00","2019-05-07",609,7,37,95,13,761
"Barnet","13:00:00","2019-05-07",802,25,25,32,7,891
"Bexley","13:00:00","2019-05-07",370,7,0,114,13,504
"Bromley","13:00:00","2019-05-07",314,9,0,68,5,396
"Croydon","13:00:00","2019-05-07",45,0,0,6,0,51
"Hillingdon","13:00:00","2019-05-07",68,0,0,13,4,85
"Hounslow","13:00:00","2019-05-07",571,7,38,100,5,721
"Lewisham","13:00:00","2019-05-07",233,2,12,45,5,297
"Richmond upon Thames","13:00:00","2019-05-07",601,9,40,109,12,771
"Barnet","14:00:00","2019-05-07",793,27,22,26,9,877
"Bexley","14:00:00","2019-05-07",394,5,0,125,5,529
"Bromley","14:00:00","2019-05-07",369,9,0,66,3,447
"Croydon","14:00:00","2019-05-07",60,0,0,7,2,69
"Hillingdon","14:00:00","2019-05-07",70,0,0,10,3,83
"Hounslow","14:00:00","2019-05-07",627,7,30,95,5,764
"Lewisham","14:00:00","2019-05-07",250,8,17,50,3,328
"Richmond upon Thames","14:00:00","2019-05-07",659,10,52,99,14,834
"Barnet","15:00:00","2019-05-07",840,30,31,39,10,950
"Bexley","15:00:00","2019-05-07",552,4,0,131,5,692
"Bromley","15:00:00","2019-05-07",424,4,0,89,3,520
"Croydon","15:00:00","2019-05-07",85,0,0,16,0,101
"Hillingdon","15:00:00","2019-05-07",98,0,0,21,1,120
"Hounslow","15:00:00","2019-05-07",770,11,36,109,4,930
"Lewisham","15:00:00","2019-05-07",355,6,15,43,4,423
"Richmond upon Thames","15:00:00","2019-05-07",776,14,40,87,7,924
"Barnet","16:00:00","2019-05-07",719,22,32,32,13,818
"Bexley","16:00:00","2019-05-07",511,7,0,137,9,664
"Bromley","16:00:00","2019-05-07",510,5,1,115,2,633
"Croydon","16:00:00","2019-05-07",50,1,2,10,0,63
"Hillingdon","16:00:00","2019-05-07",122,1,0,22,3,148
"Hounslow","16:00:00","2019-05-07",785,8,27,141,8,969
"Lewisham","16:00:00","2019-05-07",355,5,3,55,0,418
"Richmond upon Thames","16:00:00","2019-05-07",813,18,28,97,3,959
"Barnet","17:00:00","2019-05-07",633,22,27,23,1,706
"Bexley","17:00:00","2019-05-07",649,7,0,113,1,770
"Bromley","17:00:00","2019-05-07",722,18,0,85,0,825
"Croydon","17:00:00","2019-05-07",58,1,0,16,0,75
"Hillingdon","17:00:00","2019-05-07",127,0,0,21,4,152
"Hounslow","17:00:00","2019-05-07",900,12,38,155,5,1110
"Lewisham","17:00:00","2019-05-07",432,12,9,41,3,497
"Richmond upon Thames","17:00:00","2019-05-07",758,18,25,60,6,867
"Barnet","18:00:00","2019-05-07",621,30,28,33,5,717
"Bexley","18:00:00","2019-05-07",546,6,0,74,1,627
"Bromley","18:00:00","2019-05-07",582,21,0,52,0,655
"Croydon","18:00:00","2019-05-07",66,0,0,14,0,80
"Hillingdon","18:00:00","2019-05-07",104,0,0,10,3,117
"Hounslow","18:00:00","2019-05-07",795,11,23,124,6,959
"Lewisham","18:00:00","2019-05-07",355,3,13,33,0,404
"Richmond upon Thames","18:00:00","2019-05-07",840,19,28,68,0,955
"Bromley","07:00:00","2019-05-08",195,0,3,46,8,252
"City of London","07:00:00","2019-05-08",525,58,38,268,53,942
"Croydon","07:00:00","2019-05-08",1601,24,8,391,66,2090
"Greenwich","07:00:00","2019-05-08",8,0,0,2,0,10
"Hackney","07:00:00","2019-05-08",199,5,0,81,10,295
"Harrow","07:00:00","2019-05-08",367,0,1,24,0,392
"Hillingdon","07:00:00","2019-05-08",310,0,6,38,5,359
"Newham","07:00:00","2019-05-08",379,9,14,90,35,527
"Richmond upon Thames","07:00:00","2019-05-08",472,12,19,86,9,598
"Bromley","08:00:00","2019-05-08",275,0,4,41,11,331
"City of London","08:00:00","2019-05-08",591,113,33,258,62,1057
"Croydon","08:00:00","2019-05-08",1273,37,18,243,77,1648
"Greenwich","08:00:00","2019-05-08",21,0,0,1,0,22
"Hackney","08:00:00","2019-05-08",205,7,1,82,14,309
"Harrow","08:00:00","2019-05-08",518,1,0,25,0,544
"Hillingdon","08:00:00","2019-05-08",781,0,5,44,5,835
"Newham","08:00:00","2019-05-08",443,10,13,124,45,635
"Richmond upon Thames","08:00:00","2019-05-08",504,9,17,49,4,583
"Bromley","09:00:00","2019-05-08",140,0,4,35,12,191
"City of London","09:00:00","2019-05-08",559,86,45,252,33,975
"Croydon","09:00:00","2019-05-08",1135,28,14,275,93,1545
"Greenwich","09:00:00","2019-05-08",10,0,0,4,0,14
"Hackney","09:00:00","2019-05-08",263,9,0,115,14,401
"Harrow","09:00:00","2019-05-08",245,2,0,36,2,285
"Hillingdon","09:00:00","2019-05-08",242,1,2,52,6,303
"Newham","09:00:00","2019-05-08",386,8,11,96,46,547
"Richmond upon Thames","09:00:00","2019-05-08",576,3,21,88,7,695
"Bromley","10:00:00","2019-05-08",99,1,3,37,5,145
"City of London","10:00:00","2019-05-08",604,45,51,272,33,1005
"Croydon","10:00:00","2019-05-08",1030,28,12,280,101,1451
"Greenwich","10:00:00","2019-05-08",15,0,0,3,0,18
"Hackney","10:00:00","2019-05-08",251,10,0,111,6,378
"Harrow","10:00:00","2019-05-08",193,0,0,42,1,236
"Hillingdon","10:00:00","2019-05-08",151,0,0,46,14,211
"Newham","10:00:00","2019-05-08",346,5,15,84,42,492
"Richmond upon Thames","10:00:00","2019-05-08",482,4,19,87,13,605
"Bromley","11:00:00","2019-05-08",112,2,3,28,8,153
"City of London","11:00:00","2019-05-08",620,63,46,307,43,1079
"Croydon","11:00:00","2019-05-08",1028,22,11,269,76,1406
"Greenwich","11:00:00","2019-05-08",3,0,0,1,1,5
"Hackney","11:00:00","2019-05-08",228,16,0,108,12,364
"Harrow","11:00:00","2019-05-08",194,0,0,29,2,225
"Hillingdon","11:00:00","2019-05-08",173,2,0,61,7,243
"Newham","11:00:00","2019-05-08",327,6,13,97,59,502
"Richmond upon Thames","11:00:00","2019-05-08",439,6,19,54,14,532
"Bromley","12:00:00","2019-05-08",121,0,4,30,4,159
"City of London","12:00:00","2019-05-08",510,64,36,256,21,887
"Croydon","12:00:00","2019-05-08",1066,25,11,266,106,1474
"Greenwich","12:00:00","2019-05-08",10,0,0,2,0,12
"Hackney","12:00:00","2019-05-08",248,13,0,116,5,382
"Harrow","12:00:00","2019-05-08",194,0,0,28,0,222
"Hillingdon","12:00:00","2019-05-08",184,0,0,52,14,250
"Newham","12:00:00","2019-05-08",340,6,10,95,50,501
"Richmond upon Thames","12:00:00","2019-05-08",452,4,15,78,15,564
"Bromley","13:00:00","2019-05-08",113,0,4,33,3,153
"City of London","13:00:00","2019-05-08",603,65,43,309,30,1050
"Croydon","13:00:00","2019-05-08",1120,20,12,284,86,1522
"Greenwich","13:00:00","2019-05-08",7,0,0,2,0,9
"Hackney","13:00:00","2019-05-08",242,12,1,112,2,369
"Harrow","13:00:00","2019-05-08",212,0,0,26,1,239
"Hillingdon","13:00:00","2019-05-08",178,0,0,53,13,244
"Newham","13:00:00","2019-05-08",387,9,15,106,49,566
"Richmond upon Thames","13:00:00","2019-05-08",472,12,17,83,12,596
"Bromley","14:00:00","2019-05-08",114,1,2,33,9,159
"City of London","14:00:00","2019-05-08",644,79,49,279,17,1068
"Croydon","14:00:00","2019-05-08",1074,20,11,276,65,1446
"Greenwich","14:00:00","2019-05-08",6,0,0,3,0,9
"Hackney","14:00:00","2019-05-08",239,16,0,92,10,357
"Harrow","14:00:00","2019-05-08",266,1,0,32,2,301
"Hillingdon","14:00:00","2019-05-08",242,0,0,54,9,305
"Newham","14:00:00","2019-05-08",447,10,14,111,61,643
"Richmond upon Thames","14:00:00","2019-05-08",609,17,21,76,14,737
"Bromley","15:00:00","2019-05-08",183,1,4,34,9,231
"City of London","15:00:00","2019-05-08",651,84,39,290,16,1080
"Croydon","15:00:00","2019-05-08",1305,23,15,288,81,1712
"Greenwich","15:00:00","2019-05-08",7,0,0,6,0,13
"Hackney","15:00:00","2019-05-08",261,19,3,88,4,375
"Harrow","15:00:00","2019-05-08",421,0,0,27,1,449
"Hillingdon","15:00:00","2019-05-08",500,0,2,73,6,581
"Newham","15:00:00","2019-05-08",475,15,12,99,58,659
"Richmond upon Thames","15:00:00","2019-05-08",580,9,18,61,6,674
"Bromley","16:00:00","2019-05-08",216,2,3,48,6,275
"City of London","16:00:00","2019-05-08",705,93,43,286,15,1142
"Croydon","16:00:00","2019-05-08",1383,28,15,278,70,1774
"Greenwich","16:00:00","2019-05-08",16,1,0,2,0,19
"Hackney","16:00:00","2019-05-08",263,22,0,78,1,364
"Harrow","16:00:00","2019-05-08",450,1,0,38,2,491
"Hillingdon","16:00:00","2019-05-08",358,4,7,65,7,441
"Newham","16:00:00","2019-05-08",515,6,9,86,34,650
"Richmond upon Thames","16:00:00","2019-05-08",712,11,26,75,6,830
"Bromley","17:00:00","2019-05-08",220,0,4,33,4,261
"City of London","17:00:00","2019-05-08",680,127,41,207,7,1062
"Croydon","17:00:00","2019-05-08",1338,25,15,195,40,1613
"Greenwich","17:00:00","2019-05-08",16,1,0,3,1,21
"Hackney","17:00:00","2019-05-08",331,22,0,70,5,428
"Harrow","17:00:00","2019-05-08",402,1,0,40,0,443
"Hillingdon","17:00:00","2019-05-08",518,3,4,73,4,602
"Newham","17:00:00","2019-05-08",499,21,9,96,17,642
"Richmond upon Thames","17:00:00","2019-05-08",631,19,21,54,5,730
"Bromley","18:00:00","2019-05-08",152,1,4,24,0,181
"City of London","18:00:00","2019-05-08",849,124,40,101,8,1122
"Croydon","18:00:00","2019-05-08",1318,23,13,177,17,1548
"Greenwich","18:00:00","2019-05-08",12,0,0,2,0,14
"Hackney","18:00:00","2019-05-08",373,16,0,54,1,444
"Harrow","18:00:00","2019-05-08",279,1,0,22,0,302
"Hillingdon","18:00:00","2019-05-08",332,1,1,39,2,375
"Newham","18:00:00","2019-05-08",510,8,12,77,14,621
"Richmond upon Thames","18:00:00","2019-05-08",678,23,18,53,8,780
"Barnet","07:00:00","2019-05-09",39,1,0,8,1,49
"Bexley","07:00:00","2019-05-09",561,6,0,73,1,641
"Bromley","07:00:00","2019-05-09",1180,10,39,201,23,1453
"Havering","07:00:00","2019-05-09",539,7,35,56,14,651
"Kingston upon Thames","07:00:00","2019-05-09",611,7,12,75,5,710
"Sutton","07:00:00","2019-05-09",135,2,6,17,0,160
"Barnet","08:00:00","2019-05-09",83,1,0,10,1,95
"Bexley","08:00:00","2019-05-09",614,4,2,77,1,698
"Bromley","08:00:00","2019-05-09",1104,10,31,187,30,1362
"Havering","08:00:00","2019-05-09",606,6,33,60,12,717
"Kingston upon Thames","08:00:00","2019-05-09",1131,11,18,64,12,1236
"Sutton","08:00:00","2019-05-09",243,0,8,23,0,274
"Barnet","09:00:00","2019-05-09",37,0,0,3,2,42
"Bexley","09:00:00","2019-05-09",689,4,1,84,0,778
"Bromley","09:00:00","2019-05-09",1166,5,32,184,30,1417
"Havering","09:00:00","2019-05-09",418,5,31,75,4,533
"Kingston upon Thames","09:00:00","2019-05-09",597,9,15,66,14,701
"Sutton","09:00:00","2019-05-09",112,1,9,14,4,140
"Barnet","10:00:00","2019-05-09",29,0,0,5,2,36
"Bexley","10:00:00","2019-05-09",412,4,1,56,2,475
"Bromley","10:00:00","2019-05-09",994,5,38,173,26,1236
"Havering","10:00:00","2019-05-09",411,4,36,72,9,532
"Kingston upon Thames","10:00:00","2019-05-09",495,7,16,69,15,602
"Sutton","10:00:00","2019-05-09",59,1,9,19,3,91
"Barnet","11:00:00","2019-05-09",34,0,0,5,2,41
"Bexley","11:00:00","2019-05-09",436,3,0,68,3,510
"Bromley","11:00:00","2019-05-09",883,3,35,176,16,1113
"Havering","11:00:00","2019-05-09",366,1,33,61,12,473
"Kingston upon Thames","11:00:00","2019-05-09",457,11,16,63,11,558
"Sutton","11:00:00","2019-05-09",88,2,8,12,0,110
"Barnet","12:00:00","2019-05-09",28,0,0,6,1,35
"Bexley","12:00:00","2019-05-09",441,3,0,64,2,510
"Bromley","12:00:00","2019-05-09",1065,2,41,170,21,1299
"Havering","12:00:00","2019-05-09",440,2,24,69,8,543
"Kingston upon Thames","12:00:00","2019-05-09",482,15,11,76,8,592
"Sutton","12:00:00","2019-05-09",88,2,10,19,3,122
"Barnet","13:00:00","2019-05-09",27,0,0,3,0,30
"Bexley","13:00:00","2019-05-09",517,0,0,70,0,587
"Bromley","13:00:00","2019-05-09",1051,10,45,144,26,1276
"Havering","13:00:00","2019-05-09",412,0,27,83,10,532
"Kingston upon Thames","13:00:00","2019-05-09",457,15,14,79,19,584
"Sutton","13:00:00","2019-05-09",87,2,8,17,0,114
"Barnet","14:00:00","2019-05-09",31,1,0,6,2,40
"Bexley","14:00:00","2019-05-09",508,5,0,74,1,588
"Bromley","14:00:00","2019-05-09",948,5,32,131,14,1130
"Havering","14:00:00","2019-05-09",435,2,32,54,5,528
"Kingston upon Thames","14:00:00","2019-05-09",522,8,17,81,7,635
"Sutton","14:00:00","2019-05-09",112,0,7,18,0,137
"Barnet","15:00:00","2019-05-09",71,0,0,7,1,79
"Bexley","15:00:00","2019-05-09",594,2,0,66,1,663
"Bromley","15:00:00","2019-05-09",1197,5,30,184,16,1432
"Havering","15:00:00","2019-05-09",589,3,38,86,5,721
"Kingston upon Thames","15:00:00","2019-05-09",611,15,14,79,13,732
"Sutton","15:00:00","2019-05-09",147,0,8,19,0,174
"Barnet","16:00:00","2019-05-09",60,0,0,4,0,64
"Bexley","16:00:00","2019-05-09",682,6,0,90,0,778
"Bromley","16:00:00","2019-05-09",1176,7,37,176,4,1400
"Havering","16:00:00","2019-05-09",578,2,27,63,3,673
"Kingston upon Thames","16:00:00","2019-05-09",688,5,11,126,12,842
"Sutton","16:00:00","2019-05-09",127,2,8,19,2,158
"Barnet","17:00:00","2019-05-09",40,1,0,3,0,44
"Bexley","17:00:00","2019-05-09",666,8,0,77,0,751
"Bromley","17:00:00","2019-05-09",1033,7,38,105,7,1190
"Havering","17:00:00","2019-05-09",666,4,28,62,3,763
"Kingston upon Thames","17:00:00","2019-05-09",675,7,14,86,1,783
"Sutton","17:00:00","2019-05-09",195,4,5,31,0,235
"Barnet","18:00:00","2019-05-09",42,0,0,6,0,48
"Bexley","18:00:00","2019-05-09",501,2,0,60,1,564
"Bromley","18:00:00","2019-05-09",1025,9,38,90,1,1163
"Havering","18:00:00","2019-05-09",610,1,27,42,0,680
"Kingston upon Thames","18:00:00","2019-05-09",616,12,16,42,1,687
"Sutton","18:00:00","2019-05-09",117,2,7,6,0,132
"Bexley","07:00:00","2019-05-10",137,3,0,15,2,157
"City of London","07:00:00","2019-05-10",386,112,58,238,90,884
"Havering","07:00:00","2019-05-10",386,0,16,59,1,462
"Hillingdon","07:00:00","2019-05-10",1850,7,50,364,192,2463
"Hounslow","07:00:00","2019-05-10",422,14,18,80,11,545
"Bexley","08:00:00","2019-05-10",203,2,0,19,2,226
"City of London","08:00:00","2019-05-10",380,132,61,260,74,907
"Havering","08:00:00","2019-05-10",631,1,14,69,3,718
"Hillingdon","08:00:00","2019-05-10",1706,10,50,393,222,2381
"Hounslow","08:00:00","2019-05-10",455,19,16,78,12,580
"Bexley","09:00:00","2019-05-10",135,3,0,20,0,158
"City of London","09:00:00","2019-05-10",413,69,70,244,65,861
"Havering","09:00:00","2019-05-10",519,1,15,54,6,595
"Hillingdon","09:00:00","2019-05-10",1162,5,55,420,222,1864
"Hounslow","09:00:00","2019-05-10",362,14,19,70,13,478
"Bexley","10:00:00","2019-05-10",127,3,0,20,1,151
"City of London","10:00:00","2019-05-10",498,85,76,276,64,999
"Havering","10:00:00","2019-05-10",471,1,14,51,6,543
"Hillingdon","10:00:00","2019-05-10",878,1,51,373,200,1503
"Hounslow","10:00:00","2019-05-10",334,8,16,113,17,488
"Bexley","11:00:00","2019-05-10",130,1,0,22,1,154
"City of London","11:00:00","2019-05-10",411,92,64,237,51,855
"Havering","11:00:00","2019-05-10",510,2,14,71,7,604
"Hillingdon","11:00:00","2019-05-10",904,2,56,341,195,1498
"Hounslow","11:00:00","2019-05-10",350,5,23,92,11,481
"Bexley","12:00:00","2019-05-10",152,6,0,12,4,174
"City of London","12:00:00","2019-05-10",391,86,74,223,42,816
"Havering","12:00:00","2019-05-10",417,3,15,53,4,492
"Hillingdon","12:00:00","2019-05-10",1278,12,44,403,196,1933
"Hounslow","12:00:00","2019-05-10",416,11,18,108,14,567
"Bexley","13:00:00","2019-05-10",157,2,0,20,0,179
"City of London","13:00:00","2019-05-10",409,84,53,206,47,799
"Havering","13:00:00","2019-05-10",515,3,14,68,3,603
"Hillingdon","13:00:00","2019-05-10",1300,5,41,321,141,1808
"Hounslow","13:00:00","2019-05-10",393,14,15,93,14,529
"Bexley","14:00:00","2019-05-10",168,3,0,21,0,192
"City of London","14:00:00","2019-05-10",454,104,62,234,51,905
"Havering","14:00:00","2019-05-10",513,6,15,70,4,608
"Hillingdon","14:00:00","2019-05-10",1540,7,36,354,155,2092
"Hounslow","14:00:00","2019-05-10",458,14,20,110,18,620
"Bexley","15:00:00","2019-05-10",253,4,0,23,0,280
"City of London","15:00:00","2019-05-10",514,86,71,193,32,896
"Havering","15:00:00","2019-05-10",591,0,10,61,4,666
"Hillingdon","15:00:00","2019-05-10",1546,12,44,387,209,2198
"Hounslow","15:00:00","2019-05-10",500,10,12,97,6,625
"Bexley","16:00:00","2019-05-10",202,1,0,21,0,224
"City of London","16:00:00","2019-05-10",634,124,54,151,12,975
"Havering","16:00:00","2019-05-10",520,3,18,64,0,605
"Hillingdon","16:00:00","2019-05-10",1768,4,47,371,189,2379
"Hounslow","16:00:00","2019-05-10",611,20,21,118,9,779
"Bexley","17:00:00","2019-05-10",218,6,0,20,0,244
"City of London","17:00:00","2019-05-10",693,171,79,132,11,1086
"Havering","17:00:00","2019-05-10",594,2,14,81,0,691
"Hillingdon","17:00:00","2019-05-10",1757,4,46,260,102,2169
"Hounslow","17:00:00","2019-05-10",810,22,21,111,3,967
"Bexley","18:00:00","2019-05-10",161,2,0,12,0,175
"City of London","18:00:00","2019-05-10",852,146,61,65,13,1137
"Havering","18:00:00","2019-05-10",507,3,11,43,0,564
"Hillingdon","18:00:00","2019-05-10",1883,5,50,189,120,2247
"Hounslow","18:00:00","2019-05-10",624,14,21,68,4,731
"Bromley","07:00:00","2019-05-13",171,0,0,16,4,191
"Camden","07:00:00","2019-05-13",818,45,16,230,14,1123
"Croydon","07:00:00","2019-05-13",774,31,15,193,10,1023
"Haringey","07:00:00","2019-05-13",21,0,0,7,0,28
"Hillingdon","07:00:00","2019-05-13",102,0,0,16,2,120
"Hounslow","07:00:00","2019-05-13",22,0,0,2,0,24
"Kensington and Chelsea","07:00:00","2019-05-13",234,13,0,31,5,283
"Kingston upon Thames","07:00:00","2019-05-13",932,36,21,215,25,1229
"Redbridge","07:00:00","2019-05-13",1651,24,6,558,159,2398
"Bromley","08:00:00","2019-05-13",334,2,0,19,1,356
"Camden","08:00:00","2019-05-13",931,47,25,169,10,1182
"Croydon","08:00:00","2019-05-13",758,65,25,142,8,998
"Haringey","08:00:00","2019-05-13",35,0,0,5,0,40
"Hillingdon","08:00:00","2019-05-13",138,1,0,22,1,162
"Hounslow","08:00:00","2019-05-13",28,0,1,1,0,30
"Kensington and Chelsea","08:00:00","2019-05-13",447,17,3,49,3,519
"Kingston upon Thames","08:00:00","2019-05-13",1045,40,25,220,26,1356
"Redbridge","08:00:00","2019-05-13",1664,25,6,459,189,2343
"Bromley","09:00:00","2019-05-13",129,2,0,9,1,141
"Camden","09:00:00","2019-05-13",906,39,15,173,21,1154
"Croydon","09:00:00","2019-05-13",795,12,13,177,23,1020
"Haringey","09:00:00","2019-05-13",27,0,0,7,0,34
"Hillingdon","09:00:00","2019-05-13",74,2,2,20,0,98
"Hounslow","09:00:00","2019-05-13",19,1,0,4,0,24
"Kensington and Chelsea","09:00:00","2019-05-13",244,15,1,46,2,308
"Kingston upon Thames","09:00:00","2019-05-13",1313,24,21,287,14,1659
"Redbridge","09:00:00","2019-05-13",1544,13,15,447,221,2240
"Bromley","10:00:00","2019-05-13",90,0,2,16,4,112
"Camden","10:00:00","2019-05-13",778,29,16,185,19,1027
"Croydon","10:00:00","2019-05-13",683,18,12,145,32,890
"Haringey","10:00:00","2019-05-13",26,1,0,13,0,40
"Hillingdon","10:00:00","2019-05-13",34,0,0,16,0,50
"Hounslow","10:00:00","2019-05-13",25,0,0,4,0,29
"Kensington and Chelsea","10:00:00","2019-05-13",237,8,1,56,5,307
"Kingston upon Thames","10:00:00","2019-05-13",1014,18,23,213,38,1306
"Redbridge","10:00:00","2019-05-13",1399,9,17,406,238,2069
"Bromley","11:00:00","2019-05-13",82,0,1,17,3,103
"Camden","11:00:00","2019-05-13",850,25,14,227,18,1134
"Croydon","11:00:00","2019-05-13",548,13,12,139,29,741
"Haringey","11:00:00","2019-05-13",20,0,0,10,0,30
"Hillingdon","11:00:00","2019-05-13",57,0,0,17,0,74
"Hounslow","11:00:00","2019-05-13",24,0,0,2,0,26
"Kensington and Chelsea","11:00:00","2019-05-13",276,13,0,54,3,346
"Kingston upon Thames","11:00:00","2019-05-13",1038,25,22,250,20,1355
"Redbridge","11:00:00","2019-05-13",1332,4,6,364,225,1931
"Bromley","12:00:00","2019-05-13",140,0,0,14,1,155
"Camden","12:00:00","2019-05-13",886,26,14,243,15,1184
"Croydon","12:00:00","2019-05-13",718,17,14,184,37,970
"Haringey","12:00:00","2019-05-13",27,1,0,6,0,34
"Hillingdon","12:00:00","2019-05-13",73,1,0,22,0,96
"Hounslow","12:00:00","2019-05-13",19,0,0,2,0,21
"Kensington and Chelsea","12:00:00","2019-05-13",261,24,5,47,2,339
"Kingston upon Thames","12:00:00","2019-05-13",1064,20,20,229,27,1360
"Redbridge","12:00:00","2019-05-13",1278,5,6,407,208,1904
"Bromley","13:00:00","2019-05-13",100,1,0,17,5,123
"Camden","13:00:00","2019-05-13",967,24,19,224,11,1245
"Croydon","13:00:00","2019-05-13",626,10,16,166,16,834
"Haringey","13:00:00","2019-05-13",21,0,0,8,1,30
"Hillingdon","13:00:00","2019-05-13",78,1,0,20,0,99
"Hounslow","13:00:00","2019-05-13",18,0,0,2,2,22
"Kensington and Chelsea","13:00:00","2019-05-13",288,33,2,60,6,389
"Kingston upon Thames","13:00:00","2019-05-13",1136,29,19,252,19,1455
"Redbridge","13:00:00","2019-05-13",1228,10,10,433,198,1879
"Bromley","14:00:00","2019-05-13",92,1,0,8,3,104
"Camden","14:00:00","2019-05-13",931,27,16,210,10,1194
"Croydon","14:00:00","2019-05-13",674,14,20,150,11,869
"Haringey","14:00:00","2019-05-13",33,1,0,9,2,45
"Hillingdon","14:00:00","2019-05-13",103,1,0,19,0,123
"Hounslow","14:00:00","2019-05-13",27,0,0,2,0,29
"Kensington and Chelsea","14:00:00","2019-05-13",283,27,2,42,4,358
"Kingston upon Thames","14:00:00","2019-05-13",1180,26,18,230,21,1475
"Redbridge","14:00:00","2019-05-13",1400,5,3,474,208,2090
"Bromley","15:00:00","2019-05-13",179,1,0,11,1,192
"Camden","15:00:00","2019-05-13",1156,37,17,213,8,1431
"Croydon","15:00:00","2019-05-13",934,15,16,183,15,1163
"Haringey","15:00:00","2019-05-13",40,0,0,9,0,49
"Hillingdon","15:00:00","2019-05-13",126,5,1,17,0,149
"Hounslow","15:00:00","2019-05-13",30,1,1,4,0,36
"Kensington and Chelsea","15:00:00","2019-05-13",379,17,2,58,3,459
"Kingston upon Thames","15:00:00","2019-05-13",1139,29,22,242,23,1455
"Redbridge","15:00:00","2019-05-13",1594,11,8,580,155,2348
"Bromley","16:00:00","2019-05-13",218,0,0,19,1,238
"Camden","16:00:00","2019-05-13",1087,36,20,202,3,1348
"Croydon","16:00:00","2019-05-13",787,24,17,187,18,1033
"Haringey","16:00:00","2019-05-13",32,0,0,5,0,37
"Hillingdon","16:00:00","2019-05-13",112,2,0,15,0,129
"Hounslow","16:00:00","2019-05-13",29,1,0,1,3,34
"Kensington and Chelsea","16:00:00","2019-05-13",392,30,1,50,2,475
"Kingston upon Thames","16:00:00","2019-05-13",1235,43,17,229,17,1541
"Redbridge","16:00:00","2019-05-13",2072,20,11,613,103,2819
"Bromley","17:00:00","2019-05-13",242,1,0,18,1,262
"Camden","17:00:00","2019-05-13",1130,56,21,185,1,1393
"Croydon","17:00:00","2019-05-13",939,25,12,136,1,1113
"Haringey","17:00:00","2019-05-13",36,0,0,7,0,43
"Hillingdon","17:00:00","2019-05-13",117,0,0,17,0,134
"Hounslow","17:00:00","2019-05-13",30,3,0,2,0,35
"Kensington and Chelsea","17:00:00","2019-05-13",359,37,3,31,1,431
"Kingston upon Thames","17:00:00","2019-05-13",1287,51,23,188,8,1557
"Redbridge","17:00:00","2019-05-13",2391,30,7,482,88,2998
"Bromley","18:00:00","2019-05-13",209,0,0,13,1,223
"Camden","18:00:00","2019-05-13",1074,49,17,106,1,1247
"Croydon","18:00:00","2019-05-13",929,16,18,100,4,1067
"Haringey","18:00:00","2019-05-13",22,2,0,2,0,26
"Hillingdon","18:00:00","2019-05-13",102,6,0,24,0,132
"Hounslow","18:00:00","2019-05-13",24,0,0,4,0,28
"Kensington and Chelsea","18:00:00","2019-05-13",269,46,1,25,0,341
"Kingston upon Thames","18:00:00","2019-05-13",1399,47,21,129,0,1596
"Redbridge","18:00:00","2019-05-13",2113,16,6,250,52,2437
"Barnet","07:00:00","2019-05-14",187,3,2,44,2,238
"Camden","07:00:00","2019-05-14",114,44,123,125,30,436
"Croydon","07:00:00","2019-05-14",22,0,0,3,1,26
"Greenwich","07:00:00","2019-05-14",576,33,97,164,26,896
"Hillingdon","07:00:00","2019-05-14",7,0,0,2,0,9
"Newham","07:00:00","2019-05-14",13,1,0,0,0,14
"Tower Hamlets","07:00:00","2019-05-14",61,4,0,20,1,86
"Westminster","07:00:00","2019-05-14",196,5,1,66,14,282
"Barnet","08:00:00","2019-05-14",322,0,0,45,3,370
"Camden","08:00:00","2019-05-14",121,51,119,122,31,444
"Croydon","08:00:00","2019-05-14",26,0,1,2,0,29
"Greenwich","08:00:00","2019-05-14",631,27,104,151,13,926
"Hillingdon","08:00:00","2019-05-14",12,0,0,2,0,14
"Newham","08:00:00","2019-05-14",37,0,0,3,0,40
"Tower Hamlets","08:00:00","2019-05-14",118,2,2,37,1,160
"Westminster","08:00:00","2019-05-14",260,5,1,55,19,340
"Barnet","09:00:00","2019-05-14",219,7,0,35,6,267
"Camden","09:00:00","2019-05-14",143,38,112,112,25,430
"Croydon","09:00:00","2019-05-14",17,0,0,3,0,20
"Greenwich","09:00:00","2019-05-14",534,10,112,130,16,802
"Hillingdon","09:00:00","2019-05-14",7,0,0,3,0,10
"Newham","09:00:00","2019-05-14",16,0,0,0,0,16
"Tower Hamlets","09:00:00","2019-05-14",115,5,1,33,2,156
"Westminster","09:00:00","2019-05-14",198,8,1,64,11,282
"Barnet","10:00:00","2019-05-14",237,4,0,34,1,276
"Camden","10:00:00","2019-05-14",119,31,106,108,25,389
"Croydon","10:00:00","2019-05-14",16,0,0,4,0,20
"Greenwich","10:00:00","2019-05-14",469,11,95,115,24,714
"Hillingdon","10:00:00","2019-05-14",7,0,0,0,0,7
"Newham","10:00:00","2019-05-14",6,0,0,2,0,8
"Tower Hamlets","10:00:00","2019-05-14",90,2,0,35,3,130
"Westminster","10:00:00","2019-05-14",173,12,0,68,16,269
"Barnet","11:00:00","2019-05-14",237,4,0,56,1,298
"Camden","11:00:00","2019-05-14",118,33,101,105,33,390
"Croydon","11:00:00","2019-05-14",12,0,0,4,0,16
"Greenwich","11:00:00","2019-05-14",470,17,108,92,10,697
"Hillingdon","11:00:00","2019-05-14",8,0,0,0,0,8
"Newham","11:00:00","2019-05-14",7,0,0,5,0,12
"Tower Hamlets","11:00:00","2019-05-14",87,2,0,33,6,128
"Westminster","11:00:00","2019-05-14",175,13,0,61,14,263
"Barnet","12:00:00","2019-05-14",247,8,0,46,1,302
"Camden","12:00:00","2019-05-14",112,48,93,110,18,381
"Croydon","12:00:00","2019-05-14",13,0,0,1,0,14
"Greenwich","12:00:00","2019-05-14",469,21,110,112,13,725
"Hillingdon","12:00:00","2019-05-14",9,0,0,0,0,9
"Newham","12:00:00","2019-05-14",19,0,0,1,0,20
"Tower Hamlets","12:00:00","2019-05-14",95,2,0,33,0,130
"Westminster","12:00:00","2019-05-14",183,9,1,51,7,251
"Barnet","13:00:00","2019-05-14",202,8,0,32,2,244
"Camden","13:00:00","2019-05-14",155,42,117,94,21,429
"Croydon","13:00:00","2019-05-14",19,0,0,7,0,26
"Greenwich","13:00:00","2019-05-14",450,24,91,87,15,667
"Hillingdon","13:00:00","2019-05-14",8,0,0,1,0,9
"Newham","13:00:00","2019-05-14",13,0,0,2,0,15
"Tower Hamlets","13:00:00","2019-05-14",106,7,0,36,0,149
"Westminster","13:00:00","2019-05-14",158,11,0,59,10,238
"Barnet","14:00:00","2019-05-14",241,9,0,49,4,303
"Camden","14:00:00","2019-05-14",150,58,112,97,17,434
"Croydon","14:00:00","2019-05-14",21,0,0,0,0,21
"Greenwich","14:00:00","2019-05-14",527,13,97,142,12,791
"Hillingdon","14:00:00","2019-05-14",9,0,0,0,0,9
"Newham","14:00:00","2019-05-14",15,1,0,2,0,18
"Tower Hamlets","14:00:00","2019-05-14",111,8,0,24,0,143
"Westminster","14:00:00","2019-05-14",202,9,1,52,7,271
"Barnet","15:00:00","2019-05-14",192,5,0,24,1,222
"Camden","15:00:00","2019-05-14",184,58,109,80,18,449
"Croydon","15:00:00","2019-05-14",43,0,0,4,0,47
"Greenwich","15:00:00","2019-05-14",612,22,98,154,19,905
"Hillingdon","15:00:00","2019-05-14",11,0,0,3,0,14
"Newham","15:00:00","2019-05-14",46,0,0,1,1,48
"Tower Hamlets","15:00:00","2019-05-14",120,0,0,27,0,147
"Westminster","15:00:00","2019-05-14",266,5,0,46,6,323
"Barnet","16:00:00","2019-05-14",219,15,1,43,3,281
"Camden","16:00:00","2019-05-14",171,45,96,62,11,385
"Croydon","16:00:00","2019-05-14",33,0,1,3,0,37
"Greenwich","16:00:00","2019-05-14",699,37,118,97,9,960
"Hillingdon","16:00:00","2019-05-14",13,0,0,4,0,17
"Newham","16:00:00","2019-05-14",28,0,0,4,0,32
"Tower Hamlets","16:00:00","2019-05-14",122,7,1,30,1,161
"Westminster","16:00:00","2019-05-14",251,15,0,61,5,332
"Barnet","17:00:00","2019-05-14",273,10,3,36,0,322
"Camden","17:00:00","2019-05-14",236,94,97,64,10,501
"Croydon","17:00:00","2019-05-14",32,0,0,3,0,35
"Greenwich","17:00:00","2019-05-14",793,51,114,94,5,1057
"Hillingdon","17:00:00","2019-05-14",13,0,0,2,0,15
"Newham","17:00:00","2019-05-14",37,0,0,2,0,39
"Tower Hamlets","17:00:00","2019-05-14",123,5,2,19,0,149
"Westminster","17:00:00","2019-05-14",215,11,0,40,3,269
"Barnet","18:00:00","2019-05-14",295,9,0,29,0,333
"Camden","18:00:00","2019-05-14",343,79,108,38,3,571
"Croydon","18:00:00","2019-05-14",17,0,0,1,0,18
"Greenwich","18:00:00","2019-05-14",737,46,104,52,9,948
"Hillingdon","18:00:00","2019-05-14",10,0,0,0,0,10
"Newham","18:00:00","2019-05-14",38,0,0,1,1,40
"Tower Hamlets","18:00:00","2019-05-14",128,9,0,10,3,150
"Westminster","18:00:00","2019-05-14",218,17,0,26,2,263
"Barnet","07:00:00","2019-05-15",81,0,0,11,0,92
"Brent","07:00:00","2019-05-15",623,57,43,231,51,1005
"Enfield","07:00:00","2019-05-15",2371,81,24,744,141,3361
"Greenwich","07:00:00","2019-05-15",438,7,7,94,10,556
"Hillingdon","07:00:00","2019-05-15",1545,12,11,222,33,1823
"Lambeth","07:00:00","2019-05-15",19,1,0,0,0,20
"Newham","07:00:00","2019-05-15",145,2,21,31,2,201
"Redbridge","07:00:00","2019-05-15",48,1,4,11,0,64
"Barnet","08:00:00","2019-05-15",211,0,0,12,1,224
"Brent","08:00:00","2019-05-15",517,35,31,125,57,765
"Enfield","08:00:00","2019-05-15",2506,71,28,534,153,3292
"Greenwich","08:00:00","2019-05-15",567,7,10,64,4,652
"Hillingdon","08:00:00","2019-05-15",1205,8,19,150,17,1399
"Lambeth","08:00:00","2019-05-15",16,0,0,6,0,22
"Newham","08:00:00","2019-05-15",421,0,26,78,8,533
"Redbridge","08:00:00","2019-05-15",109,2,4,7,0,122
"Barnet","09:00:00","2019-05-15",49,0,0,9,0,58
"Brent","09:00:00","2019-05-15",517,33,37,172,52,811
"Enfield","09:00:00","2019-05-15",2251,45,30,633,180,3139
"Greenwich","09:00:00","2019-05-15",286,3,3,65,5,362
"Hillingdon","09:00:00","2019-05-15",1229,14,11,181,37,1472
"Lambeth","09:00:00","2019-05-15",7,0,0,0,0,7
"Newham","09:00:00","2019-05-15",243,0,22,56,6,327
"Redbridge","09:00:00","2019-05-15",59,1,5,6,0,71
"Barnet","10:00:00","2019-05-15",25,0,0,9,0,34
"Brent","10:00:00","2019-05-15",571,38,29,175,90,903
"Enfield","10:00:00","2019-05-15",2123,31,31,522,202,2909
"Greenwich","10:00:00","2019-05-15",309,8,6,75,16,414
"Hillingdon","10:00:00","2019-05-15",948,8,2,216,42,1216
"Lambeth","10:00:00","2019-05-15",12,0,0,4,0,16
"Newham","10:00:00","2019-05-15",147,2,22,28,2,201
"Redbridge","10:00:00","2019-05-15",39,0,4,8,1,52
"Barnet","11:00:00","2019-05-15",28,0,0,4,0,32
"Brent","11:00:00","2019-05-15",496,46,38,165,84,829
"Enfield","11:00:00","2019-05-15",2190,33,28,517,157,2925
"Greenwich","11:00:00","2019-05-15",326,9,5,74,15,429
"Hillingdon","11:00:00","2019-05-15",809,8,4,194,31,1046
"Lambeth","11:00:00","2019-05-15",8,0,0,6,1,15
"Newham","11:00:00","2019-05-15",169,1,20,43,2,235
"Redbridge","11:00:00","2019-05-15",49,0,4,18,0,71
"Barnet","12:00:00","2019-05-15",35,0,0,10,0,45
"Brent","12:00:00","2019-05-15",573,50,32,168,76,899
"Enfield","12:00:00","2019-05-15",2336,27,21,512,177,3073
"Greenwich","12:00:00","2019-05-15",295,7,4,63,6,375
"Hillingdon","12:00:00","2019-05-15",937,12,6,218,38,1211
"Lambeth","12:00:00","2019-05-15",6,0,0,4,0,10
"Newham","12:00:00","2019-05-15",201,8,20,33,0,262
"Redbridge","12:00:00","2019-05-15",37,1,4,4,1,47
"Barnet","13:00:00","2019-05-15",30,0,0,5,0,35
"Brent","13:00:00","2019-05-15",589,54,36,170,71,920
"Enfield","13:00:00","2019-05-15",2277,39,20,507,156,2999
"Greenwich","13:00:00","2019-05-15",318,4,9,63,5,399
"Hillingdon","13:00:00","2019-05-15",1075,13,4,206,43,1341
"Lambeth","13:00:00","2019-05-15",13,0,0,7,0,20
"Newham","13:00:00","2019-05-15",180,2,23,57,0,262
"Redbridge","13:00:00","2019-05-15",45,0,4,8,0,57
"Barnet","14:00:00","2019-05-15",46,0,0,4,1,51
"Brent","14:00:00","2019-05-15",551,61,31,128,64,835
"Enfield","14:00:00","2019-05-15",2588,31,34,507,147,3307
"Greenwich","14:00:00","2019-05-15",375,14,9,95,17,510
"Hillingdon","14:00:00","2019-05-15",1117,10,14,215,28,1384
"Lambeth","14:00:00","2019-05-15",9,2,0,4,1,16
"Newham","14:00:00","2019-05-15",230,4,20,40,0,294
"Redbridge","14:00:00","2019-05-15",50,1,2,4,0,57
"Barnet","15:00:00","2019-05-15",108,2,0,8,0,118
"Brent","15:00:00","2019-05-15",588,49,32,133,50,852
"Enfield","15:00:00","2019-05-15",2654,40,29,500,112,3335
"Greenwich","15:00:00","2019-05-15",499,20,12,102,41,674
"Hillingdon","15:00:00","2019-05-15",1302,13,24,220,29,1588
"Lambeth","15:00:00","2019-05-15",12,2,0,7,0,21
"Newham","15:00:00","2019-05-15",248,3,31,38,1,321
"Redbridge","15:00:00","2019-05-15",105,2,2,14,1,124
"Barnet","16:00:00","2019-05-15",76,0,0,7,0,83
"Brent","16:00:00","2019-05-15",787,66,39,145,21,1058
"Enfield","16:00:00","2019-05-15",2843,67,28,575,84,3597
"Greenwich","16:00:00","2019-05-15",436,18,2,116,31,603
"Hillingdon","16:00:00","2019-05-15",1274,16,16,193,14,1513
"Lambeth","16:00:00","2019-05-15",15,1,0,5,0,21
"Newham","16:00:00","2019-05-15",310,4,23,41,1,379
"Redbridge","16:00:00","2019-05-15",68,3,4,6,1,82
"Barnet","17:00:00","2019-05-15",91,2,0,7,0,100
"Brent","17:00:00","2019-05-15",643,74,26,115,19,877
"Enfield","17:00:00","2019-05-15",2976,101,23,469,68,3637
"Greenwich","17:00:00","2019-05-15",584,12,4,100,3,703
"Hillingdon","17:00:00","2019-05-15",1178,26,2,136,3,1345
"Lambeth","17:00:00","2019-05-15",12,0,0,1,0,13
"Newham","17:00:00","2019-05-15",301,6,23,25,0,355
"Redbridge","17:00:00","2019-05-15",74,0,5,12,0,91
"Barnet","18:00:00","2019-05-15",73,2,0,6,1,82
"Brent","18:00:00","2019-05-15",957,83,35,114,7,1196
"Enfield","18:00:00","2019-05-15",3030,112,21,360,60,3583
"Greenwich","18:00:00","2019-05-15",502,5,7,55,1,570
"Hillingdon","18:00:00","2019-05-15",1212,7,3,108,4,1334
"Lambeth","18:00:00","2019-05-15",18,2,0,6,0,26
"Newham","18:00:00","2019-05-15",280,5,25,28,1,339
"Redbridge","18:00:00","2019-05-15",79,3,4,20,1,107
"Barking and Dagenham","07:00:00","2019-05-16",675,10,14,122,21,842
"Barnet","07:00:00","2019-05-16",2828,127,50,933,255,4193
"Bexley","07:00:00","2019-05-16",554,15,48,141,6,764
"Brent","07:00:00","2019-05-16",1076,53,88,278,27,1522
"Bromley","07:00:00","2019-05-16",746,8,2,208,6,970
"Hillingdon","07:00:00","2019-05-16",26,0,0,6,0,32
"Southwark","07:00:00","2019-05-16",225,79,17,167,82,570
"Barking and Dagenham","08:00:00","2019-05-16",611,8,14,97,11,741
"Barnet","08:00:00","2019-05-16",2768,93,36,556,208,3661
"Bexley","08:00:00","2019-05-16",685,9,50,93,12,849
"Brent","08:00:00","2019-05-16",1505,40,75,231,45,1896
"Bromley","08:00:00","2019-05-16",819,5,2,166,7,999
"Hillingdon","08:00:00","2019-05-16",39,1,1,6,0,47
"Southwark","08:00:00","2019-05-16",264,131,26,174,79,674
"Barking and Dagenham","09:00:00","2019-05-16",490,2,15,94,5,606
"Barnet","09:00:00","2019-05-16",2694,63,41,633,282,3713
"Bexley","09:00:00","2019-05-16",603,12,49,101,8,773
"Brent","09:00:00","2019-05-16",1147,33,81,251,39,1551
"Bromley","09:00:00","2019-05-16",584,8,2,115,5,714
"Hillingdon","09:00:00","2019-05-16",25,1,0,6,0,32
"Southwark","09:00:00","2019-05-16",259,88,27,185,105,664
"Barking and Dagenham","10:00:00","2019-05-16",410,2,12,84,11,519
"Barnet","10:00:00","2019-05-16",2594,59,28,669,380,3730
"Bexley","10:00:00","2019-05-16",641,15,56,114,12,838
"Brent","10:00:00","2019-05-16",1052,28,84,249,50,1463
"Bromley","10:00:00","2019-05-16",391,4,2,79,5,481
"Hillingdon","10:00:00","2019-05-16",19,0,0,6,0,25
"Southwark","10:00:00","2019-05-16",284,33,24,185,127,653
"Barking and Dagenham","11:00:00","2019-05-16",421,5,16,92,17,551
"Barnet","11:00:00","2019-05-16",2774,45,32,725,276,3852
"Bexley","11:00:00","2019-05-16",609,17,45,107,14,792
"Brent","11:00:00","2019-05-16",1117,25,71,236,56,1505
"Bromley","11:00:00","2019-05-16",378,1,3,80,4,466
"Hillingdon","11:00:00","2019-05-16",26,1,0,2,0,29
"Southwark","11:00:00","2019-05-16",303,48,20,173,90,634
"Barking and Dagenham","12:00:00","2019-05-16",448,4,17,101,8,578
"Barnet","12:00:00","2019-05-16",2735,35,30,742,283,3825
"Bexley","12:00:00","2019-05-16",717,17,49,91,7,881
"Brent","12:00:00","2019-05-16",1172,34,82,252,50,1590
"Bromley","12:00:00","2019-05-16",454,2,1,99,1,557
"Hillingdon","12:00:00","2019-05-16",25,0,0,6,0,31
"Southwark","12:00:00","2019-05-16",300,80,19,180,79,658
"Barking and Dagenham","13:00:00","2019-05-16",423,3,15,98,16,555
"Barnet","13:00:00","2019-05-16",2707,45,32,755,306,3845
"Bexley","13:00:00","2019-05-16",674,15,54,97,6,846
"Brent","13:00:00","2019-05-16",1330,39,72,229,43,1713
"Bromley","13:00:00","2019-05-16",509,3,1,123,1,637
"Hillingdon","13:00:00","2019-05-16",17,0,0,7,0,24
"Southwark","13:00:00","2019-05-16",262,82,16,180,86,626
"Barking and Dagenham","14:00:00","2019-05-16",444,5,14,97,10,570
"Barnet","14:00:00","2019-05-16",3005,40,28,851,274,4198
"Bexley","14:00:00","2019-05-16",692,15,57,110,11,885
"Brent","14:00:00","2019-05-16",1193,30,81,258,41,1603
"Bromley","14:00:00","2019-05-16",516,5,2,155,5,683
"Hillingdon","14:00:00","2019-05-16",18,0,0,3,0,21
"Southwark","14:00:00","2019-05-16",297,57,22,182,75,633
"Barking and Dagenham","15:00:00","2019-05-16",503,5,14,95,5,622
"Barnet","15:00:00","2019-05-16",3109,51,39,853,232,4284
"Bexley","15:00:00","2019-05-16",802,25,49,90,1,967
"Brent","15:00:00","2019-05-16",1453,51,75,289,42,1910
"Bromley","15:00:00","2019-05-16",670,4,1,217,9,901
"Hillingdon","15:00:00","2019-05-16",32,0,0,6,1,39
"Southwark","15:00:00","2019-05-16",303,67,19,176,66,631
"Barking and Dagenham","16:00:00","2019-05-16",706,7,19,111,9,852
"Barnet","16:00:00","2019-05-16",3107,91,48,794,150,4190
"Bexley","16:00:00","2019-05-16",726,31,50,97,1,905
"Brent","16:00:00","2019-05-16",1389,36,91,233,18,1767
"Bromley","16:00:00","2019-05-16",872,7,0,278,1,1158
"Hillingdon","16:00:00","2019-05-16",35,0,0,8,0,43
"Southwark","16:00:00","2019-05-16",339,89,23,185,31,667
"Barking and Dagenham","17:00:00","2019-05-16",750,12,15,111,3,891
"Barnet","17:00:00","2019-05-16",3377,142,44,693,105,4361
"Bexley","17:00:00","2019-05-16",807,34,56,100,1,998
"Brent","17:00:00","2019-05-16",1575,64,75,277,26,2017
"Bromley","17:00:00","2019-05-16",837,5,4,171,1,1018
"Hillingdon","17:00:00","2019-05-16",43,0,0,2,0,45
"Southwark","17:00:00","2019-05-16",372,161,23,153,22,731
"Barking and Dagenham","18:00:00","2019-05-16",590,11,13,67,3,684
"Barnet","18:00:00","2019-05-16",3799,149,41,531,101,4621
"Bexley","18:00:00","2019-05-16",826,29,54,78,0,987
"Brent","18:00:00","2019-05-16",1479,64,75,172,16,1806
"Bromley","18:00:00","2019-05-16",591,9,1,57,0,658
"Hillingdon","18:00:00","2019-05-16",21,1,0,3,0,25
"Southwark","18:00:00","2019-05-16",511,131,21,89,23,775
"Barking and Dagenham","07:00:00","2019-05-17",154,0,2,60,42,258
"Barnet","07:00:00","2019-05-17",958,49,16,295,33,1351
"Bromley","07:00:00","2019-05-17",86,2,0,16,5,109
"Croydon","07:00:00","2019-05-17",567,20,21,136,10,754
"Hillingdon","07:00:00","2019-05-17",256,1,0,36,2,295
"Kensington and Chelsea","07:00:00","2019-05-17",1369,129,35,581,138,2252
"Kingston upon Thames","07:00:00","2019-05-17",65,0,3,8,0,76
"Lambeth","07:00:00","2019-05-17",196,10,1,68,7,282
"Tower Hamlets","07:00:00","2019-05-17",32,1,0,6,2,41
"Barking and Dagenham","08:00:00","2019-05-17",226,0,5,57,47,335
"Barnet","08:00:00","2019-05-17",1076,57,16,207,22,1378
"Bromley","08:00:00","2019-05-17",164,0,0,27,4,195
"Croydon","08:00:00","2019-05-17",690,12,25,86,4,817
"Hillingdon","08:00:00","2019-05-17",521,0,0,41,3,565
"Kensington and Chelsea","08:00:00","2019-05-17",1414,129,53,530,97,2223
"Kingston upon Thames","08:00:00","2019-05-17",163,2,5,6,1,177
"Lambeth","08:00:00","2019-05-17",254,6,0,37,1,298
"Tower Hamlets","08:00:00","2019-05-17",77,3,0,16,4,100
"Barking and Dagenham","09:00:00","2019-05-17",114,0,9,41,52,216
"Barnet","09:00:00","2019-05-17",860,23,14,214,22,1133
"Bromley","09:00:00","2019-05-17",72,0,0,14,1,87
"Croydon","09:00:00","2019-05-17",602,14,15,87,7,725
"Hillingdon","09:00:00","2019-05-17",204,0,0,34,4,242
"Kensington and Chelsea","09:00:00","2019-05-17",1348,99,49,756,125,2377
"Kingston upon Thames","09:00:00","2019-05-17",63,1,7,10,1,82
"Lambeth","09:00:00","2019-05-17",202,19,0,54,5,280
"Tower Hamlets","09:00:00","2019-05-17",41,0,1,16,0,58
"Barking and Dagenham","10:00:00","2019-05-17",86,0,3,45,51,185
"Barnet","10:00:00","2019-05-17",971,23,12,238,22,1266
"Bromley","10:00:00","2019-05-17",74,1,0,18,2,95
"Croydon","10:00:00","2019-05-17",495,14,16,107,9,641
"Hillingdon","10:00:00","2019-05-17",133,1,0,25,2,161
"Kensington and Chelsea","10:00:00","2019-05-17",1491,76,38,574,139,2318
"Kingston upon Thames","10:00:00","2019-05-17",50,1,4,10,1,66
"Lambeth","10:00:00","2019-05-17",161,3,1,52,1,218
"Tower Hamlets","10:00:00","2019-05-17",46,0,0,15,3,64
"Barking and Dagenham","11:00:00","2019-05-17",100,0,0,56,59,215
"Barnet","11:00:00","2019-05-17",935,25,11,218,27,1216
"Bromley","11:00:00","2019-05-17",68,1,0,14,2,85
"Croydon","11:00:00","2019-05-17",599,16,19,125,11,770
"Hillingdon","11:00:00","2019-05-17",114,0,0,16,2,132
"Kensington and Chelsea","11:00:00","2019-05-17",1392,69,26,640,115,2242
"Kingston upon Thames","11:00:00","2019-05-17",52,0,4,14,0,70
"Lambeth","11:00:00","2019-05-17",145,15,0,45,3,208
"Tower Hamlets","11:00:00","2019-05-17",50,3,0,19,1,73
"Barking and Dagenham","12:00:00","2019-05-17",91,1,0,57,41,190
"Barnet","12:00:00","2019-05-17",920,13,15,196,17,1161
"Bromley","12:00:00","2019-05-17",59,3,0,14,0,76
"Croydon","12:00:00","2019-05-17",577,12,17,87,8,701
"Hillingdon","12:00:00","2019-05-17",195,2,0,23,3,223
"Kensington and Chelsea","12:00:00","2019-05-17",1352,64,33,516,92,2057
"Kingston upon Thames","12:00:00","2019-05-17",68,0,6,17,1,92
"Lambeth","12:00:00","2019-05-17",175,8,0,46,6,235
"Tower Hamlets","12:00:00","2019-05-17",67,6,0,16,0,89
"Barking and Dagenham","13:00:00","2019-05-17",126,1,3,60,46,236
"Barnet","13:00:00","2019-05-17",972,38,12,206,23,1251
"Bromley","13:00:00","2019-05-17",77,0,0,16,2,95
"Croydon","13:00:00","2019-05-17",594,13,16,112,8,743
"Hillingdon","13:00:00","2019-05-17",182,3,0,25,1,211
"Kensington and Chelsea","13:00:00","2019-05-17",1512,77,40,587,107,2323
"Kingston upon Thames","13:00:00","2019-05-17",59,0,4,13,0,76
"Lambeth","13:00:00","2019-05-17",164,24,0,55,4,247
"Tower Hamlets","13:00:00","2019-05-17",62,3,0,17,3,85
"Barking and Dagenham","14:00:00","2019-05-17",152,0,2,46,48,248
"Barnet","14:00:00","2019-05-17",980,25,16,170,15,1206
"Bromley","14:00:00","2019-05-17",63,1,0,17,2,83
"Croydon","14:00:00","2019-05-17",772,12,18,114,8,924
"Hillingdon","14:00:00","2019-05-17",241,3,0,37,1,282
"Kensington and Chelsea","14:00:00","2019-05-17",1548,94,34,550,86,2312
"Kingston upon Thames","14:00:00","2019-05-17",64,3,4,10,1,82
"Lambeth","14:00:00","2019-05-17",177,17,0,51,3,248
"Tower Hamlets","14:00:00","2019-05-17",51,2,0,10,0,63
"Barking and Dagenham","15:00:00","2019-05-17",205,0,1,47,31,284
"Barnet","15:00:00","2019-05-17",1129,34,17,148,10,1338
"Bromley","15:00:00","2019-05-17",228,0,0,55,6,289
"Croydon","15:00:00","2019-05-17",849,13,23,108,7,1000
"Hillingdon","15:00:00","2019-05-17",563,4,0,74,4,645
"Kensington and Chelsea","15:00:00","2019-05-17",1609,96,56,542,63,2366
"Kingston upon Thames","15:00:00","2019-05-17",180,0,5,19,0,204
"Lambeth","15:00:00","2019-05-17",254,15,0,51,0,320
"Tower Hamlets","15:00:00","2019-05-17",92,3,0,20,0,115
"Barking and Dagenham","16:00:00","2019-05-17",143,0,1,31,26,201
"Barnet","16:00:00","2019-05-17",1146,24,12,152,10,1344
"Bromley","16:00:00","2019-05-17",151,0,0,46,1,198
"Croydon","16:00:00","2019-05-17",841,21,17,120,8,1007
"Hillingdon","16:00:00","2019-05-17",654,1,0,86,2,743
"Kensington and Chelsea","16:00:00","2019-05-17",1718,136,36,483,51,2424
"Kingston upon Thames","16:00:00","2019-05-17",216,1,4,24,0,245
"Lambeth","16:00:00","2019-05-17",221,12,0,46,0,279
"Tower Hamlets","16:00:00","2019-05-17",84,5,1,11,0,101
"Barking and Dagenham","17:00:00","2019-05-17",130,3,2,20,14,169
"Barnet","17:00:00","2019-05-17",1237,68,11,168,5,1489
"Bromley","17:00:00","2019-05-17",192,0,0,41,0,233
"Croydon","17:00:00","2019-05-17",868,35,14,129,4,1050
"Hillingdon","17:00:00","2019-05-17",627,2,0,90,5,724
"Kensington and Chelsea","17:00:00","2019-05-17",2128,174,37,453,24,2816
"Kingston upon Thames","17:00:00","2019-05-17",113,1,4,12,0,130
"Lambeth","17:00:00","2019-05-17",245,33,0,31,1,310
"Tower Hamlets","17:00:00","2019-05-17",62,2,1,14,0,79
"Barking and Dagenham","18:00:00","2019-05-17",71,0,0,6,3,80
"Barnet","18:00:00","2019-05-17",1136,78,9,127,3,1353
"Bromley","18:00:00","2019-05-17",100,1,0,12,0,113
"Croydon","18:00:00","2019-05-17",979,25,19,120,3,1146
"Hillingdon","18:00:00","2019-05-17",462,3,0,48,0,513
"Kensington and Chelsea","18:00:00","2019-05-17",2186,124,40,344,16,2710
"Kingston upon Thames","18:00:00","2019-05-17",96,5,4,6,0,111
"Lambeth","18:00:00","2019-05-17",298,45,0,18,0,361
"Tower Hamlets","18:00:00","2019-05-17",88,7,0,9,0,104
"Havering","07:00:00","2019-05-20",1074,7,66,177,11,1335
"Hillingdon","07:00:00","2019-05-20",234,1,1,34,0,270
"Islington","07:00:00","2019-05-20",36,1,0,15,5,57
"Redbridge","07:00:00","2019-05-20",358,2,8,61,4,433
"Richmond upon Thames","07:00:00","2019-05-20",495,6,5,88,7,601
"Sutton","07:00:00","2019-05-20",107,2,0,12,0,121
"Wandsworth","07:00:00","2019-05-20",640,32,123,160,36,991
"Havering","08:00:00","2019-05-20",1055,12,61,131,24,1283
"Hillingdon","08:00:00","2019-05-20",356,1,1,31,0,389
"Islington","08:00:00","2019-05-20",58,5,2,32,2,99
"Redbridge","08:00:00","2019-05-20",580,0,7,72,7,666
"Richmond upon Thames","08:00:00","2019-05-20",569,6,6,57,4,642
"Sutton","08:00:00","2019-05-20",335,1,0,23,2,361
"Wandsworth","08:00:00","2019-05-20",740,43,111,136,34,1064
"Havering","09:00:00","2019-05-20",936,8,59,138,25,1166
"Hillingdon","09:00:00","2019-05-20",127,2,0,23,0,152
"Islington","09:00:00","2019-05-20",83,6,4,30,4,127
"Redbridge","09:00:00","2019-05-20",423,2,9,88,3,525
"Richmond upon Thames","09:00:00","2019-05-20",448,5,4,94,16,567
"Sutton","09:00:00","2019-05-20",110,0,0,12,3,125
"Wandsworth","09:00:00","2019-05-20",716,28,126,128,53,1051
"Havering","10:00:00","2019-05-20",1092,9,62,125,21,1309
"Hillingdon","10:00:00","2019-05-20",97,0,0,15,5,117
"Islington","10:00:00","2019-05-20",69,10,1,58,5,143
"Redbridge","10:00:00","2019-05-20",325,0,9,64,4,402
"Richmond upon Thames","10:00:00","2019-05-20",373,5,4,87,9,478
"Sutton","10:00:00","2019-05-20",66,3,0,8,2,79
"Wandsworth","10:00:00","2019-05-20",602,27,117,178,49,973
"Havering","11:00:00","2019-05-20",808,10,53,115,20,1006
"Hillingdon","11:00:00","2019-05-20",132,2,0,19,0,153
"Islington","11:00:00","2019-05-20",62,6,2,45,3,118
"Redbridge","11:00:00","2019-05-20",317,2,8,49,4,380
"Richmond upon Thames","11:00:00","2019-05-20",411,4,5,80,14,514
"Sutton","11:00:00","2019-05-20",64,0,0,14,1,79
"Wandsworth","11:00:00","2019-05-20",463,22,107,94,26,712
"Havering","12:00:00","2019-05-20",813,10,60,111,29,1023
"Hillingdon","12:00:00","2019-05-20",111,2,0,24,0,137
"Islington","12:00:00","2019-05-20",82,14,2,47,4,149
"Redbridge","12:00:00","2019-05-20",350,4,8,64,4,430
"Richmond upon Thames","12:00:00","2019-05-20",459,7,3,78,10,557
"Sutton","12:00:00","2019-05-20",98,1,0,18,1,118
"Wandsworth","12:00:00","2019-05-20",432,23,112,90,26,683
"Havering","13:00:00","2019-05-20",722,8,43,96,17,886
"Hillingdon","13:00:00","2019-05-20",100,0,0,25,1,126
"Islington","13:00:00","2019-05-20",75,11,2,56,4,148
"Redbridge","13:00:00","2019-05-20",390,4,8,50,1,453
"Richmond upon Thames","13:00:00","2019-05-20",439,7,8,68,5,527
"Sutton","13:00:00","2019-05-20",74,0,0,10,0,84
"Wandsworth","13:00:00","2019-05-20",397,29,109,122,20,677
"Havering","14:00:00","2019-05-20",829,11,47,89,14,990
"Hillingdon","14:00:00","2019-05-20",134,0,0,24,2,160
"Islington","14:00:00","2019-05-20",101,10,2,48,5,166
"Redbridge","14:00:00","2019-05-20",449,2,8,69,3,531
"Richmond upon Thames","14:00:00","2019-05-20",467,5,3,57,11,543
"Sutton","14:00:00","2019-05-20",134,0,0,12,0,146
"Wandsworth","14:00:00","2019-05-20",503,27,109,103,21,763
"Havering","15:00:00","2019-05-20",1012,17,61,157,22,1269
"Hillingdon","15:00:00","2019-05-20",187,4,1,26,0,218
"Islington","15:00:00","2019-05-20",89,13,4,40,2,148
"Redbridge","15:00:00","2019-05-20",539,2,7,51,1,600
"Richmond upon Thames","15:00:00","2019-05-20",555,3,4,83,2,647
"Sutton","15:00:00","2019-05-20",204,0,0,16,0,220
"Wandsworth","15:00:00","2019-05-20",532,30,114,91,29,796
"Havering","16:00:00","2019-05-20",944,18,58,126,8,1154
"Hillingdon","16:00:00","2019-05-20",194,4,1,25,0,224
"Islington","16:00:00","2019-05-20",86,9,2,47,0,144
"Redbridge","16:00:00","2019-05-20",486,5,11,50,4,556
"Richmond upon Thames","16:00:00","2019-05-20",576,6,9,94,5,690
"Sutton","16:00:00","2019-05-20",118,0,1,13,3,135
"Wandsworth","16:00:00","2019-05-20",476,32,108,120,7,743
"Havering","17:00:00","2019-05-20",975,15,49,142,6,1187
"Hillingdon","17:00:00","2019-05-20",209,0,0,22,0,231
"Islington","17:00:00","2019-05-20",88,18,0,28,5,139
"Redbridge","17:00:00","2019-05-20",566,1,8,80,0,655
"Richmond upon Thames","17:00:00","2019-05-20",693,17,3,59,7,779
"Sutton","17:00:00","2019-05-20",132,5,0,9,0,146
"Wandsworth","17:00:00","2019-05-20",460,51,119,69,10,709
"Havering","18:00:00","2019-05-20",943,10,61,98,9,1121
"Hillingdon","18:00:00","2019-05-20",223,4,0,19,0,246
"Islington","18:00:00","2019-05-20",120,29,0,27,2,178
"Redbridge","18:00:00","2019-05-20",574,7,9,58,1,649
"Richmond upon Thames","18:00:00","2019-05-20",514,10,4,48,6,582
"Sutton","18:00:00","2019-05-20",121,5,0,3,0,129
"Wandsworth","18:00:00","2019-05-20",492,50,110,53,6,711
"Barking and Dagenham","07:00:00","2019-05-21",606,7,16,110,13,752
"Bexley","07:00:00","2019-05-21",1277,10,41,332,24,1684
"Croydon","07:00:00","2019-05-21",75,0,0,9,1,85
"Ealing","07:00:00","2019-05-21",11,0,0,2,1,14
"Greenwich","07:00:00","2019-05-21",604,7,46,93,29,779
"Haringey","07:00:00","2019-05-21",170,5,9,40,2,226
"Lambeth","07:00:00","2019-05-21",16,0,0,6,0,22
"Lewisham","07:00:00","2019-05-21",137,1,0,15,3,156
"Richmond upon Thames","07:00:00","2019-05-21",1298,77,36,212,25,1648
"Waltham Forest","07:00:00","2019-05-21",20,0,0,0,0,20
"Wandsworth","07:00:00","2019-05-21",110,15,28,35,9,197
"Barking and Dagenham","08:00:00","2019-05-21",704,4,16,89,12,825
"Bexley","08:00:00","2019-05-21",1274,19,69,227,6,1595
"Croydon","08:00:00","2019-05-21",98,0,0,4,1,103
"Ealing","08:00:00","2019-05-21",22,0,0,1,1,24
"Greenwich","08:00:00","2019-05-21",868,11,35,78,9,1001
"Haringey","08:00:00","2019-05-21",291,5,12,47,5,360
"Lambeth","08:00:00","2019-05-21",20,0,0,3,1,24
"Lewisham","08:00:00","2019-05-21",218,1,1,31,2,253
"Richmond upon Thames","08:00:00","2019-05-21",1096,45,44,182,25,1392
"Waltham Forest","08:00:00","2019-05-21",34,0,0,7,0,41
"Wandsworth","08:00:00","2019-05-21",182,41,27,48,7,305
"Barking and Dagenham","09:00:00","2019-05-21",570,4,24,93,14,705
"Bexley","09:00:00","2019-05-21",968,8,44,213,20,1253
"Croydon","09:00:00","2019-05-21",45,1,0,3,0,49
"Ealing","09:00:00","2019-05-21",8,1,0,6,0,15
"Greenwich","09:00:00","2019-05-21",676,9,41,70,12,808
"Haringey","09:00:00","2019-05-21",170,4,9,28,5,216
"Lambeth","09:00:00","2019-05-21",22,2,0,3,0,27
"Lewisham","09:00:00","2019-05-21",144,2,0,23,2,171
"Richmond upon Thames","09:00:00","2019-05-21",888,35,38,225,32,1218
"Waltham Forest","09:00:00","2019-05-21",15,0,0,4,1,20
"Wandsworth","09:00:00","2019-05-21",115,9,26,38,0,188
"Barking and Dagenham","10:00:00","2019-05-21",515,5,22,80,14,636
"Bexley","10:00:00","2019-05-21",942,8,35,231,17,1233
"Croydon","10:00:00","2019-05-21",33,1,0,7,0,41
"Ealing","10:00:00","2019-05-21",20,0,0,3,0,23
"Greenwich","10:00:00","2019-05-21",545,7,36,94,16,698
"Haringey","10:00:00","2019-05-21",177,5,8,40,3,233
"Hillingdon","10:00:00","2019-05-21",6802,40,67,1309,730,8948
"Lambeth","10:00:00","2019-05-21",22,0,0,7,0,29
"Lewisham","10:00:00","2019-05-21",121,1,0,22,6,150
"Richmond upon Thames","10:00:00","2019-05-21",909,22,38,187,36,1192
"Waltham Forest","10:00:00","2019-05-21",10,0,0,6,1,17
"Wandsworth","10:00:00","2019-05-21",110,8,24,42,2,186
"Barking and Dagenham","11:00:00","2019-05-21",539,4,15,97,17,672
"Bexley","11:00:00","2019-05-21",1069,3,43,219,14,1348
"Croydon","11:00:00","2019-05-21",41,1,0,8,0,50
"Ealing","11:00:00","2019-05-21",12,0,0,1,0,13
"Greenwich","11:00:00","2019-05-21",592,7,37,93,7,736
"Haringey","11:00:00","2019-05-21",138,3,9,37,1,188
"Hillingdon","11:00:00","2019-05-21",6561,40,59,1341,832,8833
"Lambeth","11:00:00","2019-05-21",21,2,0,7,0,30
"Lewisham","11:00:00","2019-05-21",153,2,0,19,1,175
"Richmond upon Thames","11:00:00","2019-05-21",978,23,41,210,33,1285
"Waltham Forest","11:00:00","2019-05-21",9,0,0,4,0,13
"Wandsworth","11:00:00","2019-05-21",122,9,25,44,2,202
"Barking and Dagenham","12:00:00","2019-05-21",542,3,20,85,10,660
"Bexley","12:00:00","2019-05-21",1038,11,41,216,20,1326
"Croydon","12:00:00","2019-05-21",42,0,0,4,0,46
"Ealing","12:00:00","2019-05-21",9,0,0,2,0,11
"Greenwich","12:00:00","2019-05-21",699,6,39,103,14,861
"Haringey","12:00:00","2019-05-21",164,10,8,38,4,224
"Lambeth","12:00:00","2019-05-21",18,0,0,6,0,24
"Lewisham","12:00:00","2019-05-21",149,1,0,31,3,184
"Richmond upon Thames","12:00:00","2019-05-21",963,19,33,193,31,1239
"Waltham Forest","12:00:00","2019-05-21",12,0,0,5,2,19
"Wandsworth","12:00:00","2019-05-21",137,13,23,30,1,204
"Barking and Dagenham","13:00:00","2019-05-21",556,3,19,79,15,672
"Bexley","13:00:00","2019-05-21",1029,9,38,246,16,1338
"Croydon","13:00:00","2019-05-21",47,1,0,9,0,57
"Ealing","13:00:00","2019-05-21",10,0,0,3,2,15
"Greenwich","13:00:00","2019-05-21",658,6,38,88,19,809
"Haringey","13:00:00","2019-05-21",156,4,8,37,2,207
"Lambeth","13:00:00","2019-05-21",16,0,0,13,0,29
"Lewisham","13:00:00","2019-05-21",140,1,0,21,4,166
"Richmond upon Thames","13:00:00","2019-05-21",943,25,35,224,41,1268
"Waltham Forest","13:00:00","2019-05-21",20,0,0,5,0,25
"Wandsworth","13:00:00","2019-05-21",121,15,24,40,0,200
"Barking and Dagenham","14:00:00","2019-05-21",563,5,14,103,16,701
"Bexley","14:00:00","2019-05-21",1081,8,43,202,7,1341
"Croydon","14:00:00","2019-05-21",59,0,0,3,0,62
"Ealing","14:00:00","2019-05-21",12,0,0,2,0,14
"Greenwich","14:00:00","2019-05-21",622,9,33,76,2,742
"Haringey","14:00:00","2019-05-21",172,1,9,37,1,220
"Lambeth","14:00:00","2019-05-21",19,0,0,3,0,22
"Lewisham","14:00:00","2019-05-21",151,1,3,26,0,181
"Richmond upon Thames","14:00:00","2019-05-21",963,20,33,213,34,1263
"Waltham Forest","14:00:00","2019-05-21",16,0,0,4,1,21
"Wandsworth","14:00:00","2019-05-21",121,16,27,38,0,202
"Barking and Dagenham","15:00:00","2019-05-21",628,6,15,96,6,751
"Bexley","15:00:00","2019-05-21",1053,10,47,183,4,1297
"Croydon","15:00:00","2019-05-21",93,1,0,11,0,105
"Ealing","15:00:00","2019-05-21",20,0,0,3,0,23
"Greenwich","15:00:00","2019-05-21",1019,7,43,75,12,1156
"Haringey","15:00:00","2019-05-21",230,5,8,45,2,290
"Lambeth","15:00:00","2019-05-21",25,1,0,5,0,31
"Lewisham","15:00:00","2019-05-21",227,0,0,22,0,249
"Richmond upon Thames","15:00:00","2019-05-21",1096,30,34,232,13,1405
"Waltham Forest","15:00:00","2019-05-21",26,0,0,2,2,30
"Wandsworth","15:00:00","2019-05-21",126,13,23,38,1,201
"Barking and Dagenham","16:00:00","2019-05-21",640,8,20,79,11,758
"Bexley","16:00:00","2019-05-21",1077,19,45,237,4,1382
"Croydon","16:00:00","2019-05-21",60,4,0,9,0,73
"Ealing","16:00:00","2019-05-21",16,0,0,1,0,17
"Greenwich","16:00:00","2019-05-21",814,7,38,82,3,944
"Haringey","16:00:00","2019-05-21",285,8,11,61,0,365
"Lambeth","16:00:00","2019-05-21",29,1,0,6,0,36
"Lewisham","16:00:00","2019-05-21",202,4,0,19,1,226
"Richmond upon Thames","16:00:00","2019-05-21",1133,44,45,187,7,1416
"Waltham Forest","16:00:00","2019-05-21",39,0,0,3,0,42
"Wandsworth","16:00:00","2019-05-21",171,16,23,61,0,271
"Barking and Dagenham","17:00:00","2019-05-21",705,12,20,68,6,811
"Bexley","17:00:00","2019-05-21",1183,22,42,165,3,1415
"Croydon","17:00:00","2019-05-21",59,3,0,4,0,66
"Ealing","17:00:00","2019-05-21",12,1,0,6,0,19
"Greenwich","17:00:00","2019-05-21",916,15,32,65,4,1032
"Haringey","17:00:00","2019-05-21",348,8,9,44,0,409
"Lambeth","17:00:00","2019-05-21",34,0,0,3,0,37
"Lewisham","17:00:00","2019-05-21",222,2,0,22,0,246
"Richmond upon Thames","17:00:00","2019-05-21",1203,59,35,97,6,1400
"Waltham Forest","17:00:00","2019-05-21",23,3,0,2,0,28
"Wandsworth","17:00:00","2019-05-21",164,22,19,35,0,240
"Barking and Dagenham","18:00:00","2019-05-21",681,6,15,73,3,778
"Bexley","18:00:00","2019-05-21",1087,12,40,149,2,1290
"Croydon","18:00:00","2019-05-21",48,1,0,13,1,63
"Ealing","18:00:00","2019-05-21",18,0,0,2,0,20
"Greenwich","18:00:00","2019-05-21",813,10,39,46,4,912
"Haringey","18:00:00","2019-05-21",287,6,8,33,0,334
"Lambeth","18:00:00","2019-05-21",30,1,0,4,0,35
"Lewisham","18:00:00","2019-05-21",233,0,0,12,0,245
"Richmond upon Thames","18:00:00","2019-05-21",1262,55,35,88,6,1446
"Waltham Forest","18:00:00","2019-05-21",16,0,0,5,0,21
"Wandsworth","18:00:00","2019-05-21",162,37,22,9,0,230
"Barnet","07:00:00","2019-05-22",536,3,0,53,2,594
"Croydon","07:00:00","2019-05-22",34,1,1,11,2,49
"Hackney","07:00:00","2019-05-22",173,3,1,56,3,236
"Hounslow","07:00:00","2019-05-22",152,3,0,24,0,179
"Kingston upon Thames","07:00:00","2019-05-22",6621,243,33,1846,306,9049
"Wandsworth","07:00:00","2019-05-22",326,4,1,51,3,385
"Barnet","08:00:00","2019-05-22",815,5,0,61,2,883
"Bromley","08:00:00","2019-05-22",1633,18,9,434,101,2195
"Croydon","08:00:00","2019-05-22",67,0,1,12,3,83
"Hackney","08:00:00","2019-05-22",249,4,4,81,7,345
"Hounslow","08:00:00","2019-05-22",320,2,0,21,1,344
"Kingston upon Thames","08:00:00","2019-05-22",6210,211,41,1144,314,7920
"Wandsworth","08:00:00","2019-05-22",403,7,0,75,3,488
"Barnet","09:00:00","2019-05-22",442,5,0,46,3,496
"Bromley","09:00:00","2019-05-22",1540,15,7,360,130,2052
"Croydon","09:00:00","2019-05-22",43,0,2,9,0,54
"Hackney","09:00:00","2019-05-22",259,6,0,58,5,328
"Hounslow","09:00:00","2019-05-22",150,4,0,33,2,189
"Kingston upon Thames","09:00:00","2019-05-22",5370,123,35,1151,346,7025
"Wandsworth","09:00:00","2019-05-22",295,14,0,93,3,405
"Barnet","10:00:00","2019-05-22",343,5,0,54,2,404
"Bromley","10:00:00","2019-05-22",1432,10,11,345,151,1949
"Croydon","10:00:00","2019-05-22",33,4,0,6,3,46
"Hackney","10:00:00","2019-05-22",163,12,0,64,1,240
"Hounslow","10:00:00","2019-05-22",68,4,0,20,0,92
"Kingston upon Thames","10:00:00","2019-05-22",4564,77,39,1037,369,6086
"Wandsworth","10:00:00","2019-05-22",223,8,1,82,3,317
"Barnet","11:00:00","2019-05-22",367,7,2,38,4,418
"Bromley","11:00:00","2019-05-22",1459,10,9,414,101,1993
"Croydon","11:00:00","2019-05-22",49,0,0,8,0,57
"Hackney","11:00:00","2019-05-22",169,5,0,52,2,228
"Hounslow","11:00:00","2019-05-22",84,2,0,16,0,102
"Kingston upon Thames","11:00:00","2019-05-22",4392,75,25,1107,353,5952
"Wandsworth","11:00:00","2019-05-22",197,9,1,83,7,297
"Barnet","12:00:00","2019-05-22",428,6,1,70,3,508
"Bromley","12:00:00","2019-05-22",1393,14,9,311,108,1835
"Croydon","12:00:00","2019-05-22",36,4,0,9,1,50
"Hackney","12:00:00","2019-05-22",172,5,0,59,3,239
"Hounslow","12:00:00","2019-05-22",97,6,0,28,0,131
"Kingston upon Thames","12:00:00","2019-05-22",4555,90,24,1106,336,6111
"Wandsworth","12:00:00","2019-05-22",279,14,1,65,7,366
"Barnet","13:00:00","2019-05-22",391,10,1,45,2,449
"Bromley","13:00:00","2019-05-22",1452,7,8,389,129,1985
"Croydon","13:00:00","2019-05-22",38,1,0,15,2,56
"Hackney","13:00:00","2019-05-22",191,17,0,58,6,272
"Hounslow","13:00:00","2019-05-22",79,6,0,22,1,108
"Kingston upon Thames","13:00:00","2019-05-22",4727,95,28,1231,369,6450
"Wandsworth","13:00:00","2019-05-22",260,12,0,85,10,367
"Barnet","14:00:00","2019-05-22",422,12,0,61,1,496
"Bromley","14:00:00","2019-05-22",1439,16,12,429,79,1975
"Croydon","14:00:00","2019-05-22",55,1,0,10,0,66
"Hackney","14:00:00","2019-05-22",191,13,0,75,4,283
"Hounslow","14:00:00","2019-05-22",109,2,0,23,0,134
"Kingston upon Thames","14:00:00","2019-05-22",4960,83,33,1294,316,6686
"Wandsworth","14:00:00","2019-05-22",251,14,0,81,2,348
"Barnet","15:00:00","2019-05-22",747,5,2,67,0,821
"Bromley","15:00:00","2019-05-22",1626,12,11,470,90,2209
"Croydon","15:00:00","2019-05-22",85,3,0,18,0,106
"Hackney","15:00:00","2019-05-22",236,6,0,83,3,328
"Hounslow","15:00:00","2019-05-22",211,1,0,33,0,245
"Kingston upon Thames","15:00:00","2019-05-22",5921,124,29,1513,267,7854
"Wandsworth","15:00:00","2019-05-22",314,6,0,77,1,398
"Barnet","16:00:00","2019-05-22",706,5,0,83,1,795
"Croydon","16:00:00","2019-05-22",66,4,4,11,0,85
"Hackney","16:00:00","2019-05-22",275,24,0,116,3,418
"Hounslow","16:00:00","2019-05-22",164,2,0,37,1,204
"Kingston upon Thames","16:00:00","2019-05-22",6648,184,32,1593,142,8599
"Wandsworth","16:00:00","2019-05-22",405,3,0,70,1,479
"Barnet","17:00:00","2019-05-22",793,13,1,74,0,881
"Croydon","17:00:00","2019-05-22",62,2,0,6,0,70
"Hackney","17:00:00","2019-05-22",271,18,1,92,2,384
"Hounslow","17:00:00","2019-05-22",209,2,0,38,0,249
"Wandsworth","17:00:00","2019-05-22",226,11,2,28,2,269
"Barnet","18:00:00","2019-05-22",687,9,1,53,0,750
"Croydon","18:00:00","2019-05-22",51,1,0,11,0,63
"Hackney","18:00:00","2019-05-22",262,12,0,66,1,341
"Hounslow","18:00:00","2019-05-22",172,5,0,19,0,196
"Kingston upon Thames","18:00:00","2019-05-22",6033,225,45,638,78,7019
"Wandsworth","18:00:00","2019-05-22",325,11,2,21,0,359
"Barnet","07:00:00","2019-05-23",1208,14,15,344,21,1602
"Bexley","07:00:00","2019-05-23",610,4,2,129,10,755
"Bromley","07:00:00","2019-05-23",697,10,9,165,19,900
"Enfield","07:00:00","2019-05-23",352,2,1,88,4,447
"Greenwich","07:00:00","2019-05-23",21,0,0,1,2,24
"Harrow","07:00:00","2019-05-23",95,1,0,15,1,112
"Hillingdon","07:00:00","2019-05-23",1729,23,17,279,32,2080
"Kensington and Chelsea","07:00:00","2019-05-23",580,60,30,354,68,1092
"Newham","07:00:00","2019-05-23",28,0,0,2,2,32
"Westminster","07:00:00","2019-05-23",229,7,6,45,6,293
"Barnet","08:00:00","2019-05-23",872,8,13,186,12,1091
"Bexley","08:00:00","2019-05-23",734,5,5,85,10,839
"Bromley","08:00:00","2019-05-23",662,17,12,144,16,851
"Enfield","08:00:00","2019-05-23",495,3,1,47,5,551
"Greenwich","08:00:00","2019-05-23",34,0,0,7,1,42
"Harrow","08:00:00","2019-05-23",169,0,2,13,3,187
"Hillingdon","08:00:00","2019-05-23",1757,15,21,226,41,2060
"Kensington and Chelsea","08:00:00","2019-05-23",617,52,23,307,60,1059
"Newham","08:00:00","2019-05-23",102,0,0,14,0,116
"Westminster","08:00:00","2019-05-23",251,11,8,47,3,320
"Barnet","09:00:00","2019-05-23",851,8,19,201,19,1098
"Bexley","09:00:00","2019-05-23",464,2,0,80,9,555
"Bromley","09:00:00","2019-05-23",536,8,8,102,20,674
"Enfield","09:00:00","2019-05-23",291,2,0,47,3,343
"Greenwich","09:00:00","2019-05-23",22,0,0,2,2,26
"Harrow","09:00:00","2019-05-23",74,0,0,19,5,98
"Hillingdon","09:00:00","2019-05-23",1649,15,23,255,38,1980
"Kensington and Chelsea","09:00:00","2019-05-23",656,44,26,210,59,995
"Newham","09:00:00","2019-05-23",54,0,1,4,1,60
"Westminster","09:00:00","2019-05-23",242,17,4,97,5,365
"Barnet","10:00:00","2019-05-23",724,5,11,196,19,955
"Bexley","10:00:00","2019-05-23",343,3,0,55,5,406
"Bromley","10:00:00","2019-05-23",459,8,9,87,14,577
"Enfield","10:00:00","2019-05-23",337,1,0,54,11,403
"Greenwich","10:00:00","2019-05-23",14,1,0,1,1,17
"Harrow","10:00:00","2019-05-23",76,2,0,16,2,96
"Hillingdon","10:00:00","2019-05-23",1338,13,8,210,40,1609
"Kensington and Chelsea","10:00:00","2019-05-23",554,37,32,241,93,957
"Newham","10:00:00","2019-05-23",33,0,1,11,1,46
"Westminster","10:00:00","2019-05-23",316,13,6,94,9,438
"Barnet","11:00:00","2019-05-23",904,11,10,186,29,1140
"Bexley","11:00:00","2019-05-23",407,2,2,64,5,480
"Bromley","11:00:00","2019-05-23",512,5,9,87,20,633
"Enfield","11:00:00","2019-05-23",426,5,0,47,11,489
"Greenwich","11:00:00","2019-05-23",22,1,0,0,2,25
"Harrow","11:00:00","2019-05-23",78,1,0,14,0,93
"Hillingdon","11:00:00","2019-05-23",1266,16,9,233,28,1552
"Kensington and Chelsea","11:00:00","2019-05-23",555,22,22,288,74,961
"Newham","11:00:00","2019-05-23",47,0,0,8,2,57
"Westminster","11:00:00","2019-05-23",371,21,4,75,8,479
"Barnet","12:00:00","2019-05-23",885,12,8,201,14,1120
"Bexley","12:00:00","2019-05-23",453,4,0,77,1,535
"Bromley","12:00:00","2019-05-23",525,9,12,76,5,627
"Enfield","12:00:00","2019-05-23",447,7,1,81,10,546
"Greenwich","12:00:00","2019-05-23",13,0,0,3,0,16
"Harrow","12:00:00","2019-05-23",95,2,0,19,4,120
"Hillingdon","12:00:00","2019-05-23",1437,16,12,243,27,1735
"Kensington and Chelsea","12:00:00","2019-05-23",599,39,28,173,64,903
"Newham","12:00:00","2019-05-23",30,0,0,9,2,41
"Westminster","12:00:00","2019-05-23",255,20,4,96,7,382
"Barnet","13:00:00","2019-05-23",853,11,9,186,20,1079
"Bexley","13:00:00","2019-05-23",393,5,0,54,5,457
"Bromley","13:00:00","2019-05-23",443,6,8,75,13,545
"Enfield","13:00:00","2019-05-23",428,5,1,88,8,530
"Greenwich","13:00:00","2019-05-23",21,1,0,3,0,25
"Harrow","13:00:00","2019-05-23",68,0,0,9,1,78
"Hillingdon","13:00:00","2019-05-23",1237,31,16,217,25,1526
"Kensington and Chelsea","13:00:00","2019-05-23",592,34,28,254,53,961
"Newham","13:00:00","2019-05-23",36,1,0,11,1,49
"Westminster","13:00:00","2019-05-23",332,25,7,95,5,464
"Barnet","14:00:00","2019-05-23",731,8,22,151,20,932
"Bexley","14:00:00","2019-05-23",453,5,2,84,3,547
"Bromley","14:00:00","2019-05-23",529,6,7,105,9,656
"Enfield","14:00:00","2019-05-23",556,6,1,100,18,681
"Greenwich","14:00:00","2019-05-23",29,0,0,2,0,31
"Harrow","14:00:00","2019-05-23",84,1,0,5,1,91
"Hillingdon","14:00:00","2019-05-23",1431,21,19,254,25,1750
"Kensington and Chelsea","14:00:00","2019-05-23",625,33,21,276,52,1007
"Newham","14:00:00","2019-05-23",86,1,0,13,2,102
"Westminster","14:00:00","2019-05-23",314,25,8,58,12,417
"Barnet","15:00:00","2019-05-23",789,17,19,194,9,1028
"Bexley","15:00:00","2019-05-23",480,2,3,70,11,566
"Bromley","15:00:00","2019-05-23",667,6,11,139,7,830
"Enfield","15:00:00","2019-05-23",508,2,0,80,18,608
"Greenwich","15:00:00","2019-05-23",34,2,0,6,1,43
"Harrow","15:00:00","2019-05-23",146,1,0,16,0,163
"Hillingdon","15:00:00","2019-05-23",1572,22,28,246,22,1890
"Kensington and Chelsea","15:00:00","2019-05-23",684,54,24,222,40,1024
"Newham","15:00:00","2019-05-23",109,0,0,11,0,120
"Westminster","15:00:00","2019-05-23",416,20,7,81,8,532
"Barnet","16:00:00","2019-05-23",753,10,10,167,14,954
"Bexley","16:00:00","2019-05-23",529,6,1,88,3,627
"Bromley","16:00:00","2019-05-23",658,13,6,132,3,812
"Enfield","16:00:00","2019-05-23",542,7,0,73,14,636
"Greenwich","16:00:00","2019-05-23",30,1,0,1,0,32
"Harrow","16:00:00","2019-05-23",140,2,0,19,1,162
"Hillingdon","16:00:00","2019-05-23",1725,20,14,252,23,2034
"Kensington and Chelsea","16:00:00","2019-05-23",734,55,29,246,36,1100
"Newham","16:00:00","2019-05-23",72,3,0,10,1,86
"Westminster","16:00:00","2019-05-23",406,33,7,118,4,568
"Barnet","17:00:00","2019-05-23",892,16,6,167,8,1089
"Bexley","17:00:00","2019-05-23",643,7,1,87,1,739
"Bromley","17:00:00","2019-05-23",689,14,6,98,3,810
"Enfield","17:00:00","2019-05-23",639,5,2,63,9,718
"Greenwich","17:00:00","2019-05-23",24,0,0,6,0,30
"Harrow","17:00:00","2019-05-23",127,5,0,19,0,151
"Hillingdon","17:00:00","2019-05-23",1834,31,11,211,8,2095
"Kensington and Chelsea","17:00:00","2019-05-23",727,71,22,139,24,983
"Newham","17:00:00","2019-05-23",68,3,0,3,0,74
"Westminster","17:00:00","2019-05-23",461,45,5,62,4,577
"Barnet","18:00:00","2019-05-23",1024,20,11,131,3,1189
"Bexley","18:00:00","2019-05-23",540,15,0,60,2,617
"Bromley","18:00:00","2019-05-23",703,6,8,57,1,775
"Enfield","18:00:00","2019-05-23",387,11,0,35,3,436
"Greenwich","18:00:00","2019-05-23",27,0,0,2,0,29
"Harrow","18:00:00","2019-05-23",154,3,0,13,0,170
"Hillingdon","18:00:00","2019-05-23",1790,22,14,151,5,1982
"Kensington and Chelsea","18:00:00","2019-05-23",788,84,29,130,17,1048
"Newham","18:00:00","2019-05-23",71,1,1,6,0,79
"Westminster","18:00:00","2019-05-23",449,29,6,43,2,529
"Barnet","07:00:00","2019-05-24",115,0,0,11,0,126
"Haringey","07:00:00","2019-05-24",1103,57,43,470,58,1731
"Havering","07:00:00","2019-05-24",324,0,0,73,1,398
"Hillingdon","07:00:00","2019-05-24",155,1,0,14,3,173
"Redbridge","07:00:00","2019-05-24",3809,172,63,1448,362,5854
"Southwark","07:00:00","2019-05-24",303,14,24,99,5,445
"Barnet","08:00:00","2019-05-24",213,0,0,8,1,222
"Haringey","08:00:00","2019-05-24",1285,48,49,330,49,1761
"Havering","08:00:00","2019-05-24",463,3,0,46,2,514
"Hillingdon","08:00:00","2019-05-24",284,0,1,23,2,310
"Redbridge","08:00:00","2019-05-24",4194,112,49,1119,403,5877
"Southwark","08:00:00","2019-05-24",350,7,22,99,9,487
"Barnet","09:00:00","2019-05-24",99,1,0,13,0,113
"Haringey","09:00:00","2019-05-24",1213,35,49,411,65,1773
"Havering","09:00:00","2019-05-24",308,0,0,29,3,340
"Hillingdon","09:00:00","2019-05-24",150,0,1,14,1,166
"Redbridge","09:00:00","2019-05-24",3802,72,71,1087,393,5425
"Southwark","09:00:00","2019-05-24",340,5,23,78,8,454
"Barnet","10:00:00","2019-05-24",95,0,0,13,0,108
"Haringey","10:00:00","2019-05-24",1244,19,47,427,55,1792
"Havering","10:00:00","2019-05-24",220,0,0,31,2,253
"Hillingdon","10:00:00","2019-05-24",138,0,0,19,0,157
"Redbridge","10:00:00","2019-05-24",3711,67,62,1156,407,5403
"Southwark","10:00:00","2019-05-24",316,8,25,114,8,471
"Barnet","11:00:00","2019-05-24",99,0,2,14,0,115
"Haringey","11:00:00","2019-05-24",1229,27,41,341,66,1704
"Havering","11:00:00","2019-05-24",234,3,0,37,4,278
"Hillingdon","11:00:00","2019-05-24",120,2,0,12,6,140
"Redbridge","11:00:00","2019-05-24",3912,56,54,1214,413,5649
"Southwark","11:00:00","2019-05-24",334,11,22,75,9,451
"Barnet","12:00:00","2019-05-24",97,0,0,8,0,105
"Haringey","12:00:00","2019-05-24",1338,32,44,382,56,1852
"Havering","12:00:00","2019-05-24",257,1,0,25,2,285
"Hillingdon","12:00:00","2019-05-24",150,0,0,16,2,168
"Redbridge","12:00:00","2019-05-24",4142,72,48,1206,441,5909
"Southwark","12:00:00","2019-05-24",383,14,24,90,7,518
"Barnet","13:00:00","2019-05-24",80,1,0,8,1,90
"Haringey","13:00:00","2019-05-24",1239,24,45,281,44,1633
"Havering","13:00:00","2019-05-24",257,1,0,23,1,282
"Hillingdon","13:00:00","2019-05-24",147,2,1,12,1,163
"Redbridge","13:00:00","2019-05-24",4377,75,57,1256,376,6141
"Southwark","13:00:00","2019-05-24",366,18,21,81,5,491
"Barnet","14:00:00","2019-05-24",70,0,0,9,1,80
"Haringey","14:00:00","2019-05-24",1289,36,43,363,52,1783
"Havering","14:00:00","2019-05-24",299,0,0,40,6,345
"Hillingdon","14:00:00","2019-05-24",189,3,0,19,1,212
"Redbridge","14:00:00","2019-05-24",4524,80,61,1266,315,6246
"Southwark","14:00:00","2019-05-24",396,17,23,72,8,516
"Barnet","15:00:00","2019-05-24",168,1,0,6,0,175
"Haringey","15:00:00","2019-05-24",1337,39,52,323,23,1774
"Havering","15:00:00","2019-05-24",393,3,0,41,4,441
"Hillingdon","15:00:00","2019-05-24",231,1,0,31,0,263
"Redbridge","15:00:00","2019-05-24",4782,108,69,1355,252,6566
"Southwark","15:00:00","2019-05-24",403,16,29,82,2,532
"Barnet","16:00:00","2019-05-24",123,1,0,6,0,130
"Haringey","16:00:00","2019-05-24",1467,46,42,286,22,1863
"Havering","16:00:00","2019-05-24",464,1,0,81,5,551
"Hillingdon","16:00:00","2019-05-24",235,0,1,31,0,267
"Redbridge","16:00:00","2019-05-24",4919,145,57,1155,169,6445
"Southwark","16:00:00","2019-05-24",454,15,27,92,3,591
"Barnet","17:00:00","2019-05-24",111,2,0,6,0,119
"Haringey","17:00:00","2019-05-24",1650,79,43,300,12,2084
"Havering","17:00:00","2019-05-24",427,0,0,56,2,485
"Hillingdon","17:00:00","2019-05-24",210,2,0,14,0,226
"Redbridge","17:00:00","2019-05-24",4915,168,53,947,156,6239
"Southwark","17:00:00","2019-05-24",394,17,28,43,5,487
"Barnet","18:00:00","2019-05-24",112,0,0,9,0,121
"Haringey","18:00:00","2019-05-24",1532,43,38,197,12,1822
"Havering","18:00:00","2019-05-24",384,6,0,26,2,418
"Hillingdon","18:00:00","2019-05-24",181,6,0,4,0,191
"Redbridge","18:00:00","2019-05-24",5134,113,46,723,141,6157
"Southwark","18:00:00","2019-05-24",378,20,23,70,2,493
"Barnet","07:00:00","2019-06-03",535,2,15,145,4,701
"Greenwich","07:00:00","2019-06-03",18,0,0,4,0,22
"Hammersmith and Fulham","07:00:00","2019-06-03",82,1,0,17,2,102
"Hounslow","07:00:00","2019-06-03",223,2,0,25,1,251
"Islington","07:00:00","2019-06-03",187,19,0,75,8,289
"Newham","07:00:00","2019-06-03",399,7,44,71,15,536
"Redbridge","07:00:00","2019-06-03",3169,197,32,1305,302,5005
"Richmond upon Thames","07:00:00","2019-06-03",17,1,0,1,1,20
"Barnet","08:00:00","2019-06-03",530,2,12,80,7,631
"Greenwich","08:00:00","2019-06-03",19,0,0,7,0,26
"Hammersmith and Fulham","08:00:00","2019-06-03",132,5,1,20,0,158
"Hounslow","08:00:00","2019-06-03",283,3,0,24,5,315
"Islington","08:00:00","2019-06-03",281,43,5,95,4,428
"Newham","08:00:00","2019-06-03",565,9,38,81,22,715
"Redbridge","08:00:00","2019-06-03",3280,119,24,915,288,4626
"Richmond upon Thames","08:00:00","2019-06-03",22,1,0,4,1,28
"Barnet","09:00:00","2019-06-03",397,5,11,75,3,491
"Greenwich","09:00:00","2019-06-03",12,0,0,2,0,14
"Hammersmith and Fulham","09:00:00","2019-06-03",109,7,0,18,1,135
"Hounslow","09:00:00","2019-06-03",222,2,0,25,2,251
"Islington","09:00:00","2019-06-03",273,17,3,118,3,414
"Newham","09:00:00","2019-06-03",454,5,41,99,25,624
"Redbridge","09:00:00","2019-06-03",2879,72,35,990,371,4347
"Richmond upon Thames","09:00:00","2019-06-03",23,0,0,2,0,25
"Barnet","10:00:00","2019-06-03",371,2,11,64,5,453
"Greenwich","10:00:00","2019-06-03",16,0,0,1,0,17
"Hammersmith and Fulham","10:00:00","2019-06-03",93,2,0,24,0,119
"Hounslow","10:00:00","2019-06-03",140,3,0,19,1,163
"Islington","10:00:00","2019-06-03",274,28,4,132,14,452
"Newham","10:00:00","2019-06-03",452,4,36,112,28,632
"Redbridge","10:00:00","2019-06-03",2706,55,36,928,402,4127
"Richmond upon Thames","10:00:00","2019-06-03",18,0,0,1,2,21
"Barnet","11:00:00","2019-06-03",310,1,11,67,7,396
"Greenwich","11:00:00","2019-06-03",17,0,0,3,0,20
"Hammersmith and Fulham","11:00:00","2019-06-03",79,3,0,26,1,109
"Hounslow","11:00:00","2019-06-03",139,0,0,18,2,159
"Islington","11:00:00","2019-06-03",256,35,2,143,4,440
"Newham","11:00:00","2019-06-03",406,6,31,95,37,575
"Redbridge","11:00:00","2019-06-03",2842,47,35,961,394,4279
"Richmond upon Thames","11:00:00","2019-06-03",16,1,0,2,0,19
"Barnet","12:00:00","2019-06-03",387,4,11,78,6,486
"Greenwich","12:00:00","2019-06-03",13,0,0,3,0,16
"Hammersmith and Fulham","12:00:00","2019-06-03",87,4,0,16,2,109
"Hounslow","12:00:00","2019-06-03",109,1,0,16,1,127
"Islington","12:00:00","2019-06-03",235,30,5,128,6,404
"Newham","12:00:00","2019-06-03",460,12,37,94,36,639
"Redbridge","12:00:00","2019-06-03",2826,43,30,1030,374,4303
"Richmond upon Thames","12:00:00","2019-06-03",22,0,0,7,0,29
"Barnet","13:00:00","2019-06-03",404,4,10,92,6,516
"Greenwich","13:00:00","2019-06-03",7,0,0,2,0,9
"Hammersmith and Fulham","13:00:00","2019-06-03",98,7,0,23,0,128
"Hounslow","13:00:00","2019-06-03",124,3,0,18,4,149
"Islington","13:00:00","2019-06-03",237,30,3,127,9,406
"Newham","13:00:00","2019-06-03",423,12,37,110,31,613
"Redbridge","13:00:00","2019-06-03",3057,48,31,1027,384,4547
"Richmond upon Thames","13:00:00","2019-06-03",30,2,0,8,0,40
"Barnet","14:00:00","2019-06-03",415,4,10,65,6,500
"Greenwich","14:00:00","2019-06-03",20,0,0,1,0,21
"Hammersmith and Fulham","14:00:00","2019-06-03",106,10,0,18,0,134
"Hounslow","14:00:00","2019-06-03",171,0,0,21,0,192
"Islington","14:00:00","2019-06-03",224,38,7,101,8,378
"Newham","14:00:00","2019-06-03",476,7,32,111,30,656
"Redbridge","14:00:00","2019-06-03",3283,58,40,1168,377,4926
"Richmond upon Thames","14:00:00","2019-06-03",32,0,0,5,0,37
"Barnet","15:00:00","2019-06-03",530,6,11,60,7,614
"Greenwich","15:00:00","2019-06-03",17,0,0,5,0,22
"Hammersmith and Fulham","15:00:00","2019-06-03",126,3,0,21,0,150
"Hounslow","15:00:00","2019-06-03",224,2,0,22,3,251
"Islington","15:00:00","2019-06-03",272,32,13,125,5,447
"Newham","15:00:00","2019-06-03",597,10,34,88,25,754
"Redbridge","15:00:00","2019-06-03",3503,82,33,1375,254,5247
"Richmond upon Thames","15:00:00","2019-06-03",35,2,0,10,0,47
"Barnet","16:00:00","2019-06-03",585,7,11,76,6,685
"Greenwich","16:00:00","2019-06-03",32,0,0,2,0,34
"Hammersmith and Fulham","16:00:00","2019-06-03",152,10,0,26,1,189
"Hounslow","16:00:00","2019-06-03",233,1,0,22,0,256
"Islington","16:00:00","2019-06-03",294,47,4,129,6,480
"Newham","16:00:00","2019-06-03",580,11,34,81,13,719
"Redbridge","16:00:00","2019-06-03",3578,117,25,1227,170,5117
"Richmond upon Thames","16:00:00","2019-06-03",24,0,0,9,0,33
"Barnet","17:00:00","2019-06-03",586,4,19,51,0,660
"Greenwich","17:00:00","2019-06-03",23,0,0,4,0,27
"Hammersmith and Fulham","17:00:00","2019-06-03",146,10,0,18,1,175
"Hounslow","17:00:00","2019-06-03",226,4,0,19,0,249
"Islington","17:00:00","2019-06-03",263,55,0,78,2,398
"Newham","17:00:00","2019-06-03",624,15,41,72,8,760
"Redbridge","17:00:00","2019-06-03",3637,174,25,879,145,4860
"Richmond upon Thames","17:00:00","2019-06-03",13,0,0,5,0,18
"Barnet","18:00:00","2019-06-03",564,7,13,28,1,613
"Greenwich","18:00:00","2019-06-03",15,0,0,3,0,18
"Hammersmith and Fulham","18:00:00","2019-06-03",134,16,0,10,0,160
"Hounslow","18:00:00","2019-06-03",254,5,0,30,0,289
"Islington","18:00:00","2019-06-03",379,69,0,87,1,536
"Newham","18:00:00","2019-06-03",482,15,34,53,5,589
"Redbridge","18:00:00","2019-06-03",3620,177,27,606,152,4582
"Richmond upon Thames","18:00:00","2019-06-03",25,5,0,1,0,31
"Brent","07:00:00","2019-06-04",273,17,1,79,4,374
"Bromley","07:00:00","2019-06-04",220,2,42,36,6,306
"Hillingdon","07:00:00","2019-06-04",539,4,2,138,1,684
"Hounslow","07:00:00","2019-06-04",392,8,13,85,12,510
"Sutton","07:00:00","2019-06-04",72,1,0,24,0,97
"Brent","08:00:00","2019-06-04",377,18,0,88,4,487
"Bromley","08:00:00","2019-06-04",368,3,50,46,8,475
"Hillingdon","08:00:00","2019-06-04",687,13,1,153,4,858
"Hounslow","08:00:00","2019-06-04",493,10,11,75,14,603
"Richmond upon Thames","08:00:00","2019-06-04",2588,116,25,458,93,3280
"Sutton","08:00:00","2019-06-04",146,0,0,17,0,163
"Brent","09:00:00","2019-06-04",278,18,0,72,6,374
"Bromley","09:00:00","2019-06-04",251,4,44,32,11,342
"Hillingdon","09:00:00","2019-06-04",548,7,0,128,7,690
"Hounslow","09:00:00","2019-06-04",416,5,10,64,20,515
"Richmond upon Thames","09:00:00","2019-06-04",2188,51,26,490,88,2843
"Sutton","09:00:00","2019-06-04",55,0,0,13,1,69
"Brent","10:00:00","2019-06-04",240,19,2,69,7,337
"Bromley","10:00:00","2019-06-04",247,2,41,53,7,350
"Hillingdon","10:00:00","2019-06-04",522,5,0,121,18,666
"Hounslow","10:00:00","2019-06-04",383,3,7,70,28,491
"Richmond upon Thames","10:00:00","2019-06-04",1954,36,18,520,109,2637
"Sutton","10:00:00","2019-06-04",42,0,0,7,0,49
"Brent","11:00:00","2019-06-04",222,18,0,56,6,302
"Bromley","11:00:00","2019-06-04",262,4,43,44,9,362
"Hillingdon","11:00:00","2019-06-04",503,8,0,126,12,649
"Hounslow","11:00:00","2019-06-04",399,9,11,77,20,516
"Richmond upon Thames","11:00:00","2019-06-04",1778,23,11,467,117,2396
"Sutton","11:00:00","2019-06-04",48,0,0,13,1,62
"Brent","12:00:00","2019-06-04",212,17,0,69,5,303
"Bromley","12:00:00","2019-06-04",231,3,40,30,9,313
"Hillingdon","12:00:00","2019-06-04",529,3,0,156,11,699
"Hounslow","12:00:00","2019-06-04",342,9,7,68,22,448
"Richmond upon Thames","12:00:00","2019-06-04",1929,32,14,521,104,2600
"Sutton","12:00:00","2019-06-04",43,1,0,12,1,57
"Brent","13:00:00","2019-06-04",210,13,0,69,6,298
"Bromley","13:00:00","2019-06-04",213,6,38,24,4,285
"Hillingdon","13:00:00","2019-06-04",558,7,0,119,3,687
"Hounslow","13:00:00","2019-06-04",386,4,8,60,18,476
"Richmond upon Thames","13:00:00","2019-06-04",1901,37,9,507,114,2568
"Sutton","13:00:00","2019-06-04",49,0,0,10,0,59
"Brent","14:00:00","2019-06-04",270,17,0,57,3,347
"Bromley","14:00:00","2019-06-04",255,4,39,33,4,335
"Hillingdon","14:00:00","2019-06-04",578,8,0,115,8,709
"Hounslow","14:00:00","2019-06-04",430,2,8,75,12,527
"Richmond upon Thames","14:00:00","2019-06-04",2196,31,22,561,86,2896
"Sutton","14:00:00","2019-06-04",52,0,0,17,0,69
"Brent","15:00:00","2019-06-04",369,41,0,61,5,476
"Bromley","15:00:00","2019-06-04",324,2,36,41,1,404
"Hillingdon","15:00:00","2019-06-04",525,5,0,114,5,649
"Hounslow","15:00:00","2019-06-04",418,9,8,60,6,501
"Richmond upon Thames","15:00:00","2019-06-04",2051,41,22,538,52,2704
"Sutton","15:00:00","2019-06-04",79,0,0,8,0,87
"Brent","16:00:00","2019-06-04",331,20,0,63,1,415
"Bromley","16:00:00","2019-06-04",316,5,47,39,1,408
"Hillingdon","16:00:00","2019-06-04",529,12,4,127,1,673
"Hounslow","16:00:00","2019-06-04",390,8,8,55,7,468
"Richmond upon Thames","16:00:00","2019-06-04",2442,70,25,457,26,3020
"Sutton","16:00:00","2019-06-04",75,0,0,16,0,91
"Brent","17:00:00","2019-06-04",361,21,0,45,1,428
"Bromley","17:00:00","2019-06-04",348,3,34,34,2,421
"Hillingdon","17:00:00","2019-06-04",543,6,2,120,2,673
"Hounslow","17:00:00","2019-06-04",430,22,10,34,2,498
"Richmond upon Thames","17:00:00","2019-06-04",2642,94,7,344,22,3109
"Sutton","17:00:00","2019-06-04",92,0,0,10,0,102
"Brent","18:00:00","2019-06-04",325,20,0,34,1,380
"Bromley","18:00:00","2019-06-04",313,9,47,14,0,383
"Hillingdon","18:00:00","2019-06-04",574,3,1,51,1,630
"Hounslow","18:00:00","2019-06-04",381,5,10,46,6,448
"Richmond upon Thames","18:00:00","2019-06-04",2476,108,9,279,21,2893
"Sutton","18:00:00","2019-06-04",64,0,0,10,0,74
"Barnet","07:00:00","2019-06-05",5273,146,91,1230,240,6980
"Croydon","07:00:00","2019-06-05",1039,14,14,239,67,1373
"Havering","07:00:00","2019-06-05",34,0,0,17,59,110
"Redbridge","07:00:00","2019-06-05",590,3,2,99,4,698
"Barnet","08:00:00","2019-06-05",5524,114,104,957,333,7032
"Croydon","08:00:00","2019-06-05",1177,8,28,179,70,1462
"Havering","08:00:00","2019-06-05",31,1,0,19,70,121
"Redbridge","08:00:00","2019-06-05",887,1,0,82,2,972
"Barnet","09:00:00","2019-06-05",4683,85,103,1039,382,6292
"Croydon","09:00:00","2019-06-05",684,7,10,181,82,964
"Havering","09:00:00","2019-06-05",22,0,0,46,95,163
"Redbridge","09:00:00","2019-06-05",355,1,4,76,3,439
"Barnet","10:00:00","2019-06-05",3969,47,86,995,409,5506
"Croydon","10:00:00","2019-06-05",757,8,10,249,115,1139
"Havering","10:00:00","2019-06-05",31,2,0,44,89,166
"Redbridge","10:00:00","2019-06-05",308,7,3,73,6,397
"Barnet","11:00:00","2019-06-05",4144,59,67,1107,421,5798
"Croydon","11:00:00","2019-06-05",889,10,17,225,120,1261
"Havering","11:00:00","2019-06-05",38,0,0,39,97,174
"Redbridge","11:00:00","2019-06-05",360,6,2,55,6,429
"Barnet","12:00:00","2019-06-05",4414,56,62,1082,436,6050
"Croydon","12:00:00","2019-06-05",871,9,13,218,101,1212
"Havering","12:00:00","2019-06-05",40,0,0,30,74,144
"Redbridge","12:00:00","2019-06-05",320,3,2,46,1,372
"Barnet","13:00:00","2019-06-05",4171,56,60,1132,468,5887
"Croydon","13:00:00","2019-06-05",826,6,10,232,80,1154
"Havering","13:00:00","2019-06-05",33,0,0,28,108,169
"Redbridge","13:00:00","2019-06-05",350,3,4,59,3,419
"Barnet","14:00:00","2019-06-05",4642,47,97,1184,416,6386
"Croydon","14:00:00","2019-06-05",833,7,23,234,99,1196
"Havering","14:00:00","2019-06-05",54,0,0,26,99,179
"Redbridge","14:00:00","2019-06-05",406,2,4,74,3,489
"Barnet","15:00:00","2019-06-05",5186,64,96,1385,390,7121
"Croydon","15:00:00","2019-06-05",963,8,14,272,63,1320
"Havering","15:00:00","2019-06-05",61,0,0,32,63,156
"Redbridge","15:00:00","2019-06-05",547,5,2,76,3,633
"Barnet","16:00:00","2019-06-05",5734,105,118,1457,207,7621
"Croydon","16:00:00","2019-06-05",976,13,12,225,34,1260
"Havering","16:00:00","2019-06-05",62,1,0,24,18,105
"Redbridge","16:00:00","2019-06-05",512,4,4,95,2,617
"Barnet","17:00:00","2019-06-05",6437,151,91,1189,153,8021
"Croydon","17:00:00","2019-06-05",1136,30,19,153,32,1370
"Havering","17:00:00","2019-06-05",51,0,0,11,11,73
"Redbridge","17:00:00","2019-06-05",561,8,1,79,0,649
"Barnet","18:00:00","2019-06-05",6157,110,72,813,124,7276
"Croydon","18:00:00","2019-06-05",1280,31,19,116,26,1472
"Havering","18:00:00","2019-06-05",28,0,0,7,3,38
"Redbridge","18:00:00","2019-06-05",521,3,2,64,1,591
"Croydon","07:00:00","2019-06-06",292,0,0,26,1,319
"Greenwich","07:00:00","2019-06-06",439,12,35,105,33,624
"Haringey","07:00:00","2019-06-06",6,0,0,0,0,6
"Havering","07:00:00","2019-06-06",610,7,2,204,14,837
"Hounslow","07:00:00","2019-06-06",491,5,7,60,8,571
"Islington","07:00:00","2019-06-06",196,14,12,70,6,298
"Richmond upon Thames","07:00:00","2019-06-06",571,23,9,135,25,763
"Westminster","07:00:00","2019-06-06",52,5,0,80,12,149
"Croydon","08:00:00","2019-06-06",449,2,0,59,3,513
"Greenwich","08:00:00","2019-06-06",491,11,26,100,39,667
"Haringey","08:00:00","2019-06-06",9,0,0,0,0,9
"Havering","08:00:00","2019-06-06",626,4,2,126,16,774
"Hounslow","08:00:00","2019-06-06",549,5,11,69,6,640
"Islington","08:00:00","2019-06-06",297,7,14,89,8,415
"Richmond upon Thames","08:00:00","2019-06-06",778,31,9,116,38,972
"Westminster","08:00:00","2019-06-06",109,12,0,65,11,197
"Croydon","09:00:00","2019-06-06",212,0,0,32,3,247
"Greenwich","09:00:00","2019-06-06",632,9,52,101,26,820
"Haringey","09:00:00","2019-06-06",5,0,0,1,0,6
"Havering","09:00:00","2019-06-06",417,2,2,112,19,552
"Hounslow","09:00:00","2019-06-06",424,5,7,80,15,531
"Islington","09:00:00","2019-06-06",215,7,13,80,7,322
"Richmond upon Thames","09:00:00","2019-06-06",792,14,13,144,35,998
"Westminster","09:00:00","2019-06-06",120,16,0,105,11,252
"Croydon","10:00:00","2019-06-06",111,1,0,29,2,143
"Greenwich","10:00:00","2019-06-06",457,2,44,146,39,688
"Haringey","10:00:00","2019-06-06",3,0,0,3,0,6
"Havering","10:00:00","2019-06-06",286,2,3,87,20,398
"Hounslow","10:00:00","2019-06-06",256,0,7,46,9,318
"Islington","10:00:00","2019-06-06",155,14,13,81,12,275
"Richmond upon Thames","10:00:00","2019-06-06",790,11,10,95,44,950
"Westminster","10:00:00","2019-06-06",145,13,1,89,6,254
"Croydon","11:00:00","2019-06-06",112,0,0,32,0,144
"Greenwich","11:00:00","2019-06-06",411,5,42,137,36,631
"Haringey","11:00:00","2019-06-06",16,0,0,3,0,19
"Havering","11:00:00","2019-06-06",268,2,1,80,24,375
"Hounslow","11:00:00","2019-06-06",314,2,7,61,9,393
"Islington","11:00:00","2019-06-06",157,5,10,65,10,247
"Richmond upon Thames","11:00:00","2019-06-06",858,7,7,118,49,1039
"Westminster","11:00:00","2019-06-06",148,16,0,87,12,263
"Croydon","12:00:00","2019-06-06",118,1,0,21,0,140
"Greenwich","12:00:00","2019-06-06",430,13,32,109,41,625
"Haringey","12:00:00","2019-06-06",10,0,0,5,0,15
"Havering","12:00:00","2019-06-06",307,2,1,96,18,424
"Hounslow","12:00:00","2019-06-06",341,5,7,67,4,424
"Islington","12:00:00","2019-06-06",143,14,10,61,3,231
"Richmond upon Thames","12:00:00","2019-06-06",720,4,5,167,35,931
"Westminster","12:00:00","2019-06-06",159,12,1,67,5,244
"Croydon","13:00:00","2019-06-06",108,0,0,32,2,142
"Greenwich","13:00:00","2019-06-06",495,9,28,122,40,694
"Haringey","13:00:00","2019-06-06",5,0,0,1,0,6
"Havering","13:00:00","2019-06-06",299,3,3,83,19,407
"Hounslow","13:00:00","2019-06-06",369,3,5,57,8,442
"Islington","13:00:00","2019-06-06",147,14,10,53,3,227
"Richmond upon Thames","13:00:00","2019-06-06",719,15,7,156,41,938
"Westminster","13:00:00","2019-06-06",158,17,2,72,6,255
"Croydon","14:00:00","2019-06-06",148,2,0,24,0,174
"Greenwich","14:00:00","2019-06-06",554,11,34,80,31,710
"Haringey","14:00:00","2019-06-06",12,0,0,2,1,15
"Havering","14:00:00","2019-06-06",342,2,2,109,20,475
"Hounslow","14:00:00","2019-06-06",354,8,6,56,5,429
"Islington","14:00:00","2019-06-06",166,12,11,54,8,251
"Richmond upon Thames","14:00:00","2019-06-06",771,15,12,169,35,1002
"Westminster","14:00:00","2019-06-06",203,10,0,58,6,277
"Croydon","15:00:00","2019-06-06",213,1,0,33,3,250
"Greenwich","15:00:00","2019-06-06",599,13,31,147,32,822
"Haringey","15:00:00","2019-06-06",14,0,0,1,1,16
"Havering","15:00:00","2019-06-06",424,3,2,121,16,566
"Hounslow","15:00:00","2019-06-06",440,9,10,89,4,552
"Islington","15:00:00","2019-06-06",205,16,10,46,4,281
"Richmond upon Thames","15:00:00","2019-06-06",847,18,7,145,26,1043
"Westminster","15:00:00","2019-06-06",181,13,1,55,0,250
"Croydon","16:00:00","2019-06-06",262,0,0,39,1,302
"Greenwich","16:00:00","2019-06-06",826,17,31,122,10,1006
"Haringey","16:00:00","2019-06-06",12,1,0,2,0,15
"Havering","16:00:00","2019-06-06",527,9,2,184,18,740
"Hounslow","16:00:00","2019-06-06",419,4,4,68,10,505
"Islington","16:00:00","2019-06-06",192,16,11,63,4,286
"Richmond upon Thames","16:00:00","2019-06-06",828,24,6,126,21,1005
"Westminster","16:00:00","2019-06-06",174,16,1,39,0,230
"Croydon","17:00:00","2019-06-06",271,2,0,43,0,316
"Greenwich","17:00:00","2019-06-06",1055,21,32,77,6,1191
"Haringey","17:00:00","2019-06-06",13,2,0,4,0,19
"Havering","17:00:00","2019-06-06",660,16,1,123,10,810
"Hounslow","17:00:00","2019-06-06",569,21,8,66,1,665
"Islington","17:00:00","2019-06-06",237,24,10,49,6,326
"Richmond upon Thames","17:00:00","2019-06-06",921,34,10,117,10,1092
"Westminster","17:00:00","2019-06-06",152,16,3,29,4,204
"Croydon","18:00:00","2019-06-06",272,3,0,25,0,300
"Greenwich","18:00:00","2019-06-06",1099,18,27,44,3,1191
"Haringey","18:00:00","2019-06-06",18,0,0,1,2,21
"Havering","18:00:00","2019-06-06",464,10,1,82,8,565
"Hounslow","18:00:00","2019-06-06",492,21,9,51,1,574
"Islington","18:00:00","2019-06-06",255,31,12,32,4,334
"Richmond upon Thames","18:00:00","2019-06-06",791,18,5,80,8,902
"Westminster","18:00:00","2019-06-06",157,21,0,14,1,193
"Bexley","07:00:00","2019-06-07",228,1,23,42,6,300
"Camden","07:00:00","2019-06-07",370,14,25,162,7,578
"Ealing","07:00:00","2019-06-07",24,0,0,3,0,27
"Greenwich","07:00:00","2019-06-07",3083,240,54,1107,411,4895
"Hillingdon","07:00:00","2019-06-07",128,2,0,26,1,157
"Kingston upon Thames","07:00:00","2019-06-07",73,4,0,10,0,87
"Lewisham","07:00:00","2019-06-07",253,3,6,89,3,354
"Redbridge","07:00:00","2019-06-07",49,3,0,15,0,67
"Richmond upon Thames","07:00:00","2019-06-07",43,1,0,11,3,58
"Sutton","07:00:00","2019-06-07",6,0,0,1,0,7
"Bexley","08:00:00","2019-06-07",411,1,12,33,7,464
"Camden","08:00:00","2019-06-07",502,14,26,150,6,698
"Ealing","08:00:00","2019-06-07",32,0,0,12,1,45
"Greenwich","08:00:00","2019-06-07",3305,182,48,916,445,4896
"Hillingdon","08:00:00","2019-06-07",202,0,0,19,3,224
"Kingston upon Thames","08:00:00","2019-06-07",147,0,0,14,1,162
"Lewisham","08:00:00","2019-06-07",288,4,5,64,5,366
"Redbridge","08:00:00","2019-06-07",62,1,0,8,0,71
"Richmond upon Thames","08:00:00","2019-06-07",95,0,0,11,1,107
"Sutton","08:00:00","2019-06-07",7,0,0,3,0,10
"Bexley","09:00:00","2019-06-07",235,1,22,48,0,306
"Camden","09:00:00","2019-06-07",483,15,27,153,13,691
"Ealing","09:00:00","2019-06-07",38,0,0,14,2,54
"Greenwich","09:00:00","2019-06-07",3539,93,50,1011,469,5162
"Hillingdon","09:00:00","2019-06-07",162,0,0,33,2,197
"Kingston upon Thames","09:00:00","2019-06-07",105,5,0,14,1,125
"Lewisham","09:00:00","2019-06-07",216,2,5,66,1,290
"Redbridge","09:00:00","2019-06-07",62,0,0,6,1,69
"Richmond upon Thames","09:00:00","2019-06-07",79,0,0,12,3,94
"Sutton","09:00:00","2019-06-07",8,0,0,0,0,8
"Bexley","10:00:00","2019-06-07",233,3,22,41,6,305
"Camden","10:00:00","2019-06-07",402,12,26,141,17,598
"Ealing","10:00:00","2019-06-07",15,0,0,6,1,22
"Greenwich","10:00:00","2019-06-07",3440,63,34,1044,576,5157
"Hillingdon","10:00:00","2019-06-07",104,0,0,23,0,127
"Kingston upon Thames","10:00:00","2019-06-07",55,1,0,13,0,69
"Lewisham","10:00:00","2019-06-07",156,5,8,39,2,210
"Redbridge","10:00:00","2019-06-07",67,2,0,10,1,80
"Richmond upon Thames","10:00:00","2019-06-07",42,0,0,3,4,49
"Sutton","10:00:00","2019-06-07",6,0,0,3,0,9
"Bexley","11:00:00","2019-06-07",298,1,43,23,3,368
"Camden","11:00:00","2019-06-07",387,11,27,135,9,569
"Ealing","11:00:00","2019-06-07",28,2,0,11,0,41
"Greenwich","11:00:00","2019-06-07",3674,52,27,1041,520,5314
"Hillingdon","11:00:00","2019-06-07",129,0,0,22,2,153
"Kingston upon Thames","11:00:00","2019-06-07",92,10,0,16,2,120
"Lewisham","11:00:00","2019-06-07",128,2,5,22,2,159
"Redbridge","11:00:00","2019-06-07",33,0,0,7,1,41
"Richmond upon Thames","11:00:00","2019-06-07",54,0,0,9,0,63
"Sutton","11:00:00","2019-06-07",4,0,0,0,0,4
"Bexley","12:00:00","2019-06-07",258,2,18,30,4,312
"Camden","12:00:00","2019-06-07",392,11,26,127,8,564
"Ealing","12:00:00","2019-06-07",31,3,0,23,0,57
"Greenwich","12:00:00","2019-06-07",3802,49,23,1117,521,5512
"Hillingdon","12:00:00","2019-06-07",154,1,0,34,0,189
"Kingston upon Thames","12:00:00","2019-06-07",185,5,0,17,1,208
"Lewisham","12:00:00","2019-06-07",139,7,5,24,0,175
"Redbridge","12:00:00","2019-06-07",47,2,0,8,0,57
"Richmond upon Thames","12:00:00","2019-06-07",66,1,0,8,0,75
"Sutton","12:00:00","2019-06-07",5,0,0,1,0,6
"Bexley","13:00:00","2019-06-07",309,5,19,39,9,381
"Camden","13:00:00","2019-06-07",379,23,24,123,9,558
"Ealing","13:00:00","2019-06-07",34,0,0,16,0,50
"Greenwich","13:00:00","2019-06-07",3678,55,20,1146,490,5389
"Hillingdon","13:00:00","2019-06-07",156,0,1,36,0,193
"Kingston upon Thames","13:00:00","2019-06-07",160,6,0,15,0,181
"Lewisham","13:00:00","2019-06-07",126,6,6,36,0,174
"Redbridge","13:00:00","2019-06-07",73,0,0,8,0,81
"Richmond upon Thames","13:00:00","2019-06-07",70,0,0,8,0,78
"Sutton","13:00:00","2019-06-07",2,0,0,0,0,2
"Bexley","14:00:00","2019-06-07",399,2,12,74,6,493
"Camden","14:00:00","2019-06-07",405,20,26,98,10,559
"Ealing","14:00:00","2019-06-07",38,0,0,10,2,50
"Greenwich","14:00:00","2019-06-07",3919,68,33,1143,422,5585
"Hillingdon","14:00:00","2019-06-07",184,1,0,36,1,222
"Kingston upon Thames","14:00:00","2019-06-07",188,5,0,11,1,205
"Lewisham","14:00:00","2019-06-07",168,7,5,37,4,221
"Redbridge","14:00:00","2019-06-07",62,1,0,5,1,69
"Richmond upon Thames","14:00:00","2019-06-07",60,0,0,9,0,69
"Sutton","14:00:00","2019-06-07",6,0,0,3,0,9
"Bexley","15:00:00","2019-06-07",494,1,15,62,1,573
"Camden","15:00:00","2019-06-07",534,23,28,118,9,712
"Ealing","15:00:00","2019-06-07",45,4,0,9,0,58
"Greenwich","15:00:00","2019-06-07",4190,108,27,1054,324,5703
"Hillingdon","15:00:00","2019-06-07",228,2,2,41,1,274
"Kingston upon Thames","15:00:00","2019-06-07",172,10,0,13,0,195
"Lewisham","15:00:00","2019-06-07",175,1,6,54,1,237
"Redbridge","15:00:00","2019-06-07",66,0,1,8,0,75
"Richmond upon Thames","15:00:00","2019-06-07",71,0,0,8,1,80
"Sutton","15:00:00","2019-06-07",6,0,0,0,0,6
"Bexley","16:00:00","2019-06-07",382,6,20,48,1,457
"Camden","16:00:00","2019-06-07",506,24,28,118,7,683
"Ealing","16:00:00","2019-06-07",66,0,0,13,0,79
"Greenwich","16:00:00","2019-06-07",4382,194,23,990,178,5767
"Hillingdon","16:00:00","2019-06-07",218,0,0,41,0,259
"Kingston upon Thames","16:00:00","2019-06-07",147,3,0,8,0,158
"Lewisham","16:00:00","2019-06-07",245,6,6,63,0,320
"Redbridge","16:00:00","2019-06-07",91,1,0,3,0,95
"Richmond upon Thames","16:00:00","2019-06-07",78,0,0,5,0,83
"Sutton","16:00:00","2019-06-07",10,1,0,1,0,12
"Bexley","17:00:00","2019-06-07",368,2,16,65,4,455
"Camden","17:00:00","2019-06-07",604,23,25,85,2,739
"Ealing","17:00:00","2019-06-07",53,0,0,10,0,63
"Greenwich","17:00:00","2019-06-07",4588,242,47,803,142,5822
"Hillingdon","17:00:00","2019-06-07",202,2,0,33,0,237
"Kingston upon Thames","17:00:00","2019-06-07",111,8,0,11,0,130
"Lewisham","17:00:00","2019-06-07",217,9,6,37,2,271
"Redbridge","17:00:00","2019-06-07",103,2,0,1,0,106
"Richmond upon Thames","17:00:00","2019-06-07",95,4,0,5,0,104
"Sutton","17:00:00","2019-06-07",6,0,0,1,0,7
"Bexley","18:00:00","2019-06-07",495,6,24,37,0,562
"Camden","18:00:00","2019-06-07",566,36,23,65,2,692
"Ealing","18:00:00","2019-06-07",61,0,0,9,0,70
"Greenwich","18:00:00","2019-06-07",4330,189,59,628,107,5313
"Hillingdon","18:00:00","2019-06-07",164,3,0,20,1,188
"Kingston upon Thames","18:00:00","2019-06-07",142,11,0,10,0,163
"Lewisham","18:00:00","2019-06-07",217,7,6,24,0,254
"Redbridge","18:00:00","2019-06-07",81,0,0,3,0,84
"Richmond upon Thames","18:00:00","2019-06-07",90,1,0,5,0,96
"Sutton","18:00:00","2019-06-07",10,0,0,1,0,11
"Brent","07:00:00","2019-06-11",335,12,24,94,12,477
"Croydon","07:00:00","2019-06-11",281,1,1,57,2,342
"Hammersmith and Fulham","07:00:00","2019-06-11",943,109,37,447,48,1584
"Haringey","07:00:00","2019-06-11",471,11,31,142,12,667
"Hillingdon","07:00:00","2019-06-11",85,0,3,13,0,101
"Brent","08:00:00","2019-06-11",438,9,22,97,7,573
"Croydon","08:00:00","2019-06-11",365,1,0,37,1,404
"Hammersmith and Fulham","08:00:00","2019-06-11",980,130,35,346,59,1550
"Haringey","08:00:00","2019-06-11",441,14,23,86,8,572
"Hillingdon","08:00:00","2019-06-11",185,0,1,15,1,202
"Brent","09:00:00","2019-06-11",286,7,27,61,10,391
"Croydon","09:00:00","2019-06-11",162,3,0,18,3,186
"Hammersmith and Fulham","09:00:00","2019-06-11",777,68,30,326,80,1281
"Haringey","09:00:00","2019-06-11",433,12,31,103,13,592
"Hillingdon","09:00:00","2019-06-11",79,0,1,17,0,97
"Brent","10:00:00","2019-06-11",267,6,21,68,10,372
"Croydon","10:00:00","2019-06-11",113,4,0,15,7,139
"Hammersmith and Fulham","10:00:00","2019-06-11",827,59,28,370,60,1344
"Haringey","10:00:00","2019-06-11",369,12,28,78,8,495
"Hillingdon","10:00:00","2019-06-11",68,0,0,11,0,79
"Brent","11:00:00","2019-06-11",245,10,23,71,17,366
"Croydon","11:00:00","2019-06-11",129,1,0,29,0,159
"Hammersmith and Fulham","11:00:00","2019-06-11",854,70,27,411,78,1440
"Haringey","11:00:00","2019-06-11",363,12,23,95,15,508
"Hillingdon","11:00:00","2019-06-11",78,0,0,21,1,100
"Brent","12:00:00","2019-06-11",263,17,20,72,18,390
"Croydon","12:00:00","2019-06-11",138,2,0,18,1,159
"Hammersmith and Fulham","12:00:00","2019-06-11",791,71,28,338,67,1295
"Haringey","12:00:00","2019-06-11",452,27,22,115,16,632
"Hillingdon","12:00:00","2019-06-11",87,4,0,25,1,117
"Brent","13:00:00","2019-06-11",337,20,20,97,26,500
"Croydon","13:00:00","2019-06-11",106,3,0,16,0,125
"Hammersmith and Fulham","13:00:00","2019-06-11",746,87,23,371,68,1295
"Haringey","13:00:00","2019-06-11",410,17,20,99,4,550
"Hillingdon","13:00:00","2019-06-11",112,1,0,13,1,127
"Brent","14:00:00","2019-06-11",423,9,23,74,12,541
"Croydon","14:00:00","2019-06-11",136,0,0,29,0,165
"Hammersmith and Fulham","14:00:00","2019-06-11",834,89,33,352,67,1375
"Haringey","14:00:00","2019-06-11",460,17,24,117,2,620
"Hillingdon","14:00:00","2019-06-11",138,0,0,15,0,153
"Brent","15:00:00","2019-06-11",454,21,24,89,13,601
"Croydon","15:00:00","2019-06-11",285,2,0,37,0,324
"Hammersmith and Fulham","15:00:00","2019-06-11",910,54,31,348,41,1384
"Haringey","15:00:00","2019-06-11",496,26,25,101,5,653
"Hillingdon","15:00:00","2019-06-11",174,1,2,19,0,196
"Brent","16:00:00","2019-06-11",430,21,24,85,8,568
"Croydon","16:00:00","2019-06-11",240,3,0,30,4,277
"Hammersmith and Fulham","16:00:00","2019-06-11",1130,85,31,309,21,1576
"Haringey","16:00:00","2019-06-11",456,15,28,107,5,611
"Hillingdon","16:00:00","2019-06-11",164,0,4,22,0,190
"Brent","17:00:00","2019-06-11",505,25,20,72,9,631
"Croydon","17:00:00","2019-06-11",324,2,0,51,0,377
"Hammersmith and Fulham","17:00:00","2019-06-11",1143,167,32,275,17,1634
"Haringey","17:00:00","2019-06-11",528,26,24,78,1,657
"Hillingdon","17:00:00","2019-06-11",189,1,1,25,0,216
"Brent","18:00:00","2019-06-11",601,21,21,57,9,709
"Croydon","18:00:00","2019-06-11",332,0,0,33,0,365
"Hammersmith and Fulham","18:00:00","2019-06-11",1320,183,32,175,9,1719
"Haringey","18:00:00","2019-06-11",668,27,18,32,1,746
"Hillingdon","18:00:00","2019-06-11",157,3,0,10,0,170
"Bexley","07:00:00","2019-06-12",1236,23,6,253,10,1528
"Brent","07:00:00","2019-06-12",64,5,0,22,0,91
"Bromley","07:00:00","2019-06-12",40,0,0,10,0,50
"Greenwich","07:00:00","2019-06-12",801,17,16,176,21,1031
"Haringey","07:00:00","2019-06-12",535,19,24,147,12,737
"Lewisham","07:00:00","2019-06-12",637,19,6,189,21,872
"Redbridge","07:00:00","2019-06-12",650,7,9,104,1,771
"Westminster","07:00:00","2019-06-12",1041,49,86,603,84,1863
"Bexley","08:00:00","2019-06-12",1120,12,3,183,19,1337
"Brent","08:00:00","2019-06-12",134,4,0,22,0,160
"Bromley","08:00:00","2019-06-12",89,0,0,8,2,99
"Greenwich","08:00:00","2019-06-12",872,16,21,119,20,1048
"Haringey","08:00:00","2019-06-12",641,15,20,132,21,829
"Lewisham","08:00:00","2019-06-12",656,22,9,148,20,855
"Redbridge","08:00:00","2019-06-12",759,4,11,78,4,856
"Westminster","08:00:00","2019-06-12",1198,51,110,550,89,1998
"Bexley","09:00:00","2019-06-12",903,15,7,212,22,1159
"Brent","09:00:00","2019-06-12",81,6,0,30,2,119
"Bromley","09:00:00","2019-06-12",87,0,0,11,1,99
"Greenwich","09:00:00","2019-06-12",593,6,18,124,22,763
"Haringey","09:00:00","2019-06-12",564,14,23,147,17,765
"Lewisham","09:00:00","2019-06-12",522,15,6,133,35,711
"Redbridge","09:00:00","2019-06-12",526,4,9,95,2,636
"Westminster","09:00:00","2019-06-12",1189,72,112,483,106,1962
"Bexley","10:00:00","2019-06-12",911,9,6,201,17,1144
"Brent","10:00:00","2019-06-12",78,6,0,30,2,116
"Bromley","10:00:00","2019-06-12",61,0,0,8,1,70
"Greenwich","10:00:00","2019-06-12",519,2,17,119,25,682
"Haringey","10:00:00","2019-06-12",420,15,22,112,22,591
"Lewisham","10:00:00","2019-06-12",406,15,6,138,21,586
"Redbridge","10:00:00","2019-06-12",296,2,7,48,6,359
"Westminster","10:00:00","2019-06-12",1051,48,119,525,107,1850
"Bexley","11:00:00","2019-06-12",1066,8,6,221,32,1333
"Brent","11:00:00","2019-06-12",72,9,0,34,0,115
"Bromley","11:00:00","2019-06-12",57,0,0,9,1,67
"Greenwich","11:00:00","2019-06-12",564,7,17,108,22,718
"Haringey","11:00:00","2019-06-12",490,26,19,119,13,667
"Lewisham","11:00:00","2019-06-12",350,19,5,153,25,552
"Redbridge","11:00:00","2019-06-12",239,5,6,42,2,294
"Westminster","11:00:00","2019-06-12",1147,70,115,570,93,1995
"Bexley","12:00:00","2019-06-12",815,8,6,206,25,1060
"Brent","12:00:00","2019-06-12",84,16,0,36,1,137
"Bromley","12:00:00","2019-06-12",59,0,0,9,1,69
"Greenwich","12:00:00","2019-06-12",564,6,17,108,27,722
"Haringey","12:00:00","2019-06-12",502,25,20,110,23,680
"Lewisham","12:00:00","2019-06-12",446,25,6,149,24,650
"Redbridge","12:00:00","2019-06-12",202,1,8,33,1,245
"Westminster","12:00:00","2019-06-12",1122,57,122,485,111,1897
"Bexley","13:00:00","2019-06-12",814,6,4,186,21,1031
"Brent","13:00:00","2019-06-12",97,5,0,32,1,135
"Bromley","13:00:00","2019-06-12",44,0,0,7,0,51
"Greenwich","13:00:00","2019-06-12",657,7,18,108,15,805
"Haringey","13:00:00","2019-06-12",550,21,19,123,10,723
"Lewisham","13:00:00","2019-06-12",520,27,7,170,19,743
"Redbridge","13:00:00","2019-06-12",196,4,8,25,4,237
"Westminster","13:00:00","2019-06-12",1104,87,121,509,93,1914
"Bexley","14:00:00","2019-06-12",812,11,9,179,10,1021
"Brent","14:00:00","2019-06-12",136,6,0,41,0,183
"Bromley","14:00:00","2019-06-12",67,0,0,3,0,70
"Greenwich","14:00:00","2019-06-12",598,6,21,125,20,770
"Haringey","14:00:00","2019-06-12",511,29,21,124,17,702
"Lewisham","14:00:00","2019-06-12",570,17,6,203,21,817
"Redbridge","14:00:00","2019-06-12",197,0,8,44,3,252
"Westminster","14:00:00","2019-06-12",1089,80,133,480,67,1849
"Bexley","15:00:00","2019-06-12",803,5,6,163,17,994
"Brent","15:00:00","2019-06-12",177,13,1,29,0,220
"Bromley","15:00:00","2019-06-12",80,0,0,7,0,87
"Greenwich","15:00:00","2019-06-12",754,10,16,105,16,901
"Haringey","15:00:00","2019-06-12",627,29,19,148,10,833
"Lewisham","15:00:00","2019-06-12",691,35,6,200,12,944
"Redbridge","15:00:00","2019-06-12",436,0,7,49,3,495
"Westminster","15:00:00","2019-06-12",1208,82,121,474,77,1962
"Bexley","16:00:00","2019-06-12",979,19,8,198,6,1210
"Brent","16:00:00","2019-06-12",124,4,2,31,0,161
"Bromley","16:00:00","2019-06-12",57,0,0,5,0,62
"Greenwich","16:00:00","2019-06-12",719,15,16,122,11,883
"Haringey","16:00:00","2019-06-12",767,21,20,152,10,970
"Lewisham","16:00:00","2019-06-12",705,34,6,182,16,943
"Redbridge","16:00:00","2019-06-12",432,5,8,39,0,484
"Westminster","16:00:00","2019-06-12",1250,70,120,468,35,1943
"Bexley","17:00:00","2019-06-12",1057,7,4,187,3,1258
"Brent","17:00:00","2019-06-12",152,12,0,30,0,194
"Bromley","17:00:00","2019-06-12",52,0,0,9,0,61
"Greenwich","17:00:00","2019-06-12",756,18,11,100,6,891
"Haringey","17:00:00","2019-06-12",771,22,19,102,2,916
"Lewisham","17:00:00","2019-06-12",726,27,7,129,9,898
"Redbridge","17:00:00","2019-06-12",406,2,9,35,1,453
"Westminster","17:00:00","2019-06-12",1348,133,138,380,24,2023
"Bexley","18:00:00","2019-06-12",1161,17,8,161,4,1351
"Brent","18:00:00","2019-06-12",156,20,0,20,0,196
"Bromley","18:00:00","2019-06-12",48,0,0,4,0,52
"Greenwich","18:00:00","2019-06-12",802,15,19,82,9,927
"Haringey","18:00:00","2019-06-12",861,17,19,104,4,1005
"Lewisham","18:00:00","2019-06-12",662,30,6,124,18,840
"Redbridge","18:00:00","2019-06-12",259,0,7,25,0,291
"Westminster","18:00:00","2019-06-12",1457,117,133,235,15,1957
"Brent","07:00:00","2019-06-13",4835,147,28,1623,560,7193
"Camden","07:00:00","2019-06-13",381,14,32,172,25,624
"Croydon","07:00:00","2019-06-13",354,4,0,72,2,432
"Hackney","07:00:00","2019-06-13",41,1,0,11,1,54
"Harrow","07:00:00","2019-06-13",663,8,43,155,12,881
"Hillingdon","07:00:00","2019-06-13",5246,82,24,1385,514,7251
"Hounslow","07:00:00","2019-06-13",1134,24,51,197,26,1432
"Southwark","07:00:00","2019-06-13",114,6,8,25,3,156
"Tower Hamlets","07:00:00","2019-06-13",520,23,44,143,20,750
"Westminster","07:00:00","2019-06-13",291,23,22,103,25,464
"Brent","08:00:00","2019-06-13",4820,109,24,1275,597,6825
"Camden","08:00:00","2019-06-13",485,12,29,131,14,671
"Croydon","08:00:00","2019-06-13",415,3,0,53,3,474
"Hackney","08:00:00","2019-06-13",62,2,1,12,3,80
"Harrow","08:00:00","2019-06-13",672,3,31,99,8,813
"Hillingdon","08:00:00","2019-06-13",5243,78,25,944,515,6805
"Hounslow","08:00:00","2019-06-13",1347,33,47,181,28,1636
"Southwark","08:00:00","2019-06-13",197,4,7,49,6,263
"Tower Hamlets","08:00:00","2019-06-13",574,27,43,122,12,778
"Westminster","08:00:00","2019-06-13",416,33,31,99,19,598
"Brent","09:00:00","2019-06-13",4259,74,17,1275,640,6265
"Camden","09:00:00","2019-06-13",464,12,27,111,15,629
"Croydon","09:00:00","2019-06-13",249,2,1,36,3,291
"Hackney","09:00:00","2019-06-13",51,0,1,15,1,68
"Harrow","09:00:00","2019-06-13",639,3,30,98,12,782
"Hillingdon","09:00:00","2019-06-13",4540,47,48,1000,666,6301
"Hounslow","09:00:00","2019-06-13",1190,15,52,144,31,1432
"Southwark","09:00:00","2019-06-13",124,3,9,32,3,171
"Tower Hamlets","09:00:00","2019-06-13",477,27,34,153,28,719
"Westminster","09:00:00","2019-06-13",483,30,28,113,12,666
"Brent","10:00:00","2019-06-13",4108,47,13,1331,758,6257
"Camden","10:00:00","2019-06-13",408,8,24,156,8,604
"Croydon","10:00:00","2019-06-13",189,0,0,21,3,213
"Hackney","10:00:00","2019-06-13",47,4,1,16,1,69
"Harrow","10:00:00","2019-06-13",532,1,37,89,15,674
"Hillingdon","10:00:00","2019-06-13",3708,35,34,1055,661,5493
"Hounslow","10:00:00","2019-06-13",1006,9,52,149,47,1263
"Southwark","10:00:00","2019-06-13",86,1,8,18,3,116
"Tower Hamlets","10:00:00","2019-06-13",529,23,30,154,29,765
"Westminster","10:00:00","2019-06-13",431,35,26,125,22,639
"Brent","11:00:00","2019-06-13",3960,61,11,1465,713,6210
"Camden","11:00:00","2019-06-13",432,15,28,170,11,656
"Croydon","11:00:00","2019-06-13",178,2,0,21,1,202
"Hackney","11:00:00","2019-06-13",51,2,2,16,2,73
"Harrow","11:00:00","2019-06-13",577,3,33,107,13,733
"Hillingdon","11:00:00","2019-06-13",3789,37,23,1218,668,5735
"Hounslow","11:00:00","2019-06-13",1059,17,40,158,48,1322
"Southwark","11:00:00","2019-06-13",90,0,9,36,3,138
"Tower Hamlets","11:00:00","2019-06-13",486,36,32,149,23,726
"Westminster","11:00:00","2019-06-13",428,25,25,135,19,632
"Brent","12:00:00","2019-06-13",4031,55,2,1335,646,6069
"Camden","12:00:00","2019-06-13",450,14,31,142,12,649
"Croydon","12:00:00","2019-06-13",222,1,0,36,2,261
"Hackney","12:00:00","2019-06-13",46,7,1,17,0,71
"Harrow","12:00:00","2019-06-13",573,8,31,104,15,731
"Hillingdon","12:00:00","2019-06-13",3917,20,23,1211,659,5830
"Hounslow","12:00:00","2019-06-13",1034,11,40,159,42,1286
"Southwark","12:00:00","2019-06-13",90,2,8,26,4,130
"Tower Hamlets","12:00:00","2019-06-13",532,54,29,145,28,788
"Westminster","12:00:00","2019-06-13",426,38,21,144,16,645
"Brent","13:00:00","2019-06-13",4433,81,11,1386,674,6585
"Camden","13:00:00","2019-06-13",469,25,23,144,15,676
"Croydon","13:00:00","2019-06-13",206,0,2,42,2,252
"Hackney","13:00:00","2019-06-13",44,4,2,20,1,71
"Harrow","13:00:00","2019-06-13",578,6,34,97,17,732
"Hillingdon","13:00:00","2019-06-13",4078,31,25,1224,691,6049
"Hounslow","13:00:00","2019-06-13",1049,13,43,139,31,1275
"Southwark","13:00:00","2019-06-13",95,4,8,29,7,143
"Tower Hamlets","13:00:00","2019-06-13",561,41,35,172,23,832
"Westminster","13:00:00","2019-06-13",492,47,26,105,15,685
"Brent","14:00:00","2019-06-13",4631,76,9,1304,576,6596
"Camden","14:00:00","2019-06-13",486,16,22,157,19,700
"Croydon","14:00:00","2019-06-13",260,0,1,49,0,310
"Hackney","14:00:00","2019-06-13",38,3,0,14,1,56
"Harrow","14:00:00","2019-06-13",629,13,33,85,12,772
"Hillingdon","14:00:00","2019-06-13",4420,28,32,1210,613,6303
"Hounslow","14:00:00","2019-06-13",1010,22,40,158,25,1255
"Southwark","14:00:00","2019-06-13",114,3,7,35,1,160
"Tower Hamlets","14:00:00","2019-06-13",555,35,27,116,14,747
"Westminster","14:00:00","2019-06-13",493,48,22,96,11,670
"Brent","15:00:00","2019-06-13",4842,70,24,1452,489,6877
"Camden","15:00:00","2019-06-13",470,13,27,146,9,665
"Croydon","15:00:00","2019-06-13",301,1,0,44,1,347
"Hackney","15:00:00","2019-06-13",36,3,1,16,2,58
"Harrow","15:00:00","2019-06-13",656,7,30,72,9,774
"Hillingdon","15:00:00","2019-06-13",5426,52,45,1365,569,7457
"Hounslow","15:00:00","2019-06-13",1187,16,50,140,20,1413
"Southwark","15:00:00","2019-06-13",200,1,9,63,3,276
"Tower Hamlets","15:00:00","2019-06-13",679,44,34,133,13,903
"Westminster","15:00:00","2019-06-13",597,46,25,94,8,770
"Brent","16:00:00","2019-06-13",5184,137,15,1310,318,6964
"Camden","16:00:00","2019-06-13",617,32,26,145,7,827
"Croydon","16:00:00","2019-06-13",317,3,1,60,2,383
"Hackney","16:00:00","2019-06-13",54,6,1,10,3,74
"Harrow","16:00:00","2019-06-13",720,10,35,112,9,886
"Hillingdon","16:00:00","2019-06-13",6419,59,40,1401,370,8289
"Hounslow","16:00:00","2019-06-13",1135,26,43,144,17,1365
"Southwark","16:00:00","2019-06-13",272,12,8,60,4,356
"Tower Hamlets","16:00:00","2019-06-13",615,42,30,96,17,800
"Westminster","16:00:00","2019-06-13",569,46,34,95,3,747
"Brent","17:00:00","2019-06-13",5688,152,11,1050,243,7144
"Camden","17:00:00","2019-06-13",584,47,29,134,5,799
"Croydon","17:00:00","2019-06-13",420,4,0,45,3,472
"Hackney","17:00:00","2019-06-13",60,6,0,6,0,72
"Harrow","17:00:00","2019-06-13",898,12,23,114,3,1050
"Hillingdon","17:00:00","2019-06-13",7192,83,40,1125,271,8711
"Hounslow","17:00:00","2019-06-13",1497,37,45,157,17,1753
"Southwark","17:00:00","2019-06-13",259,5,8,65,1,338
"Tower Hamlets","17:00:00","2019-06-13",844,65,39,130,9,1087
"Westminster","17:00:00","2019-06-13",673,59,30,67,3,832
"Brent","18:00:00","2019-06-13",5973,117,14,820,222,7146
"Camden","18:00:00","2019-06-13",689,42,31,111,5,878
"Croydon","18:00:00","2019-06-13",332,6,0,24,0,362
"Hackney","18:00:00","2019-06-13",47,5,0,4,0,56
"Harrow","18:00:00","2019-06-13",912,9,27,93,1,1042
"Hillingdon","18:00:00","2019-06-13",6994,71,43,878,230,8216
"Hounslow","18:00:00","2019-06-13",1526,31,49,149,14,1769
"Southwark","18:00:00","2019-06-13",192,6,10,38,2,248
"Tower Hamlets","18:00:00","2019-06-13",669,90,39,135,12,945
"Westminster","18:00:00","2019-06-13",695,65,22,42,2,826
"Havering","07:00:00","2019-06-14",2511,66,25,796,107,3505
"Hillingdon","07:00:00","2019-06-14",560,3,28,57,8,656
"Merton","07:00:00","2019-06-14",321,8,0,89,3,421
"Southwark","07:00:00","2019-06-14",83,0,0,7,1,91
"Havering","08:00:00","2019-06-14",2343,52,20,554,94,3063
"Hillingdon","08:00:00","2019-06-14",673,0,27,46,12,758
"Merton","08:00:00","2019-06-14",381,11,2,58,4,456
"Southwark","08:00:00","2019-06-14",210,1,0,14,1,226
"Havering","09:00:00","2019-06-14",2292,20,16,517,121,2966
"Hillingdon","09:00:00","2019-06-14",593,0,29,71,17,710
"Merton","09:00:00","2019-06-14",241,6,3,66,9,325
"Southwark","09:00:00","2019-06-14",78,2,0,7,2,89
"Havering","10:00:00","2019-06-14",2155,26,19,479,121,2800
"Hillingdon","10:00:00","2019-06-14",480,0,25,39,9,553
"Merton","10:00:00","2019-06-14",237,5,2,73,9,326
"Southwark","10:00:00","2019-06-14",68,2,0,14,2,86
"Havering","11:00:00","2019-06-14",2062,24,17,535,109,2747
"Hillingdon","11:00:00","2019-06-14",543,2,27,68,6,646
"Merton","11:00:00","2019-06-14",258,3,0,84,9,354
"Southwark","11:00:00","2019-06-14",78,1,0,13,2,94
"Havering","12:00:00","2019-06-14",2297,18,16,487,118,2936
"Hillingdon","12:00:00","2019-06-14",546,1,24,57,7,635
"Merton","12:00:00","2019-06-14",301,3,2,93,8,407
"Southwark","12:00:00","2019-06-14",70,2,0,16,5,93
"Havering","13:00:00","2019-06-14",2125,19,16,508,94,2762
"Hillingdon","13:00:00","2019-06-14",484,1,29,77,9,600
"Merton","13:00:00","2019-06-14",260,2,3,104,11,380
"Southwark","13:00:00","2019-06-14",81,2,0,12,3,98
"Havering","14:00:00","2019-06-14",2200,21,18,496,71,2806
"Hillingdon","14:00:00","2019-06-14",551,1,31,65,10,658
"Merton","14:00:00","2019-06-14",273,1,2,70,7,353
"Southwark","14:00:00","2019-06-14",112,2,0,9,4,127
"Havering","15:00:00","2019-06-14",2507,36,16,572,59,3190
"Hillingdon","15:00:00","2019-06-14",681,2,24,58,4,769
"Merton","15:00:00","2019-06-14",279,7,1,98,8,393
"Southwark","15:00:00","2019-06-14",157,1,0,11,0,169
"Havering","16:00:00","2019-06-14",2460,31,24,624,56,3195
"Hillingdon","16:00:00","2019-06-14",628,1,29,45,3,706
"Merton","16:00:00","2019-06-14",263,4,1,71,5,344
"Southwark","16:00:00","2019-06-14",131,1,0,14,3,149
"Havering","17:00:00","2019-06-14",2625,51,18,443,29,3166
"Hillingdon","17:00:00","2019-06-14",644,3,36,42,2,727
"Merton","17:00:00","2019-06-14",270,9,0,82,0,361
"Southwark","17:00:00","2019-06-14",135,4,0,15,0,154
"Havering","18:00:00","2019-06-14",2279,61,25,316,27,2708
"Hillingdon","18:00:00","2019-06-14",651,3,26,44,2,726
"Merton","18:00:00","2019-06-14",294,7,0,53,0,354
"Southwark","18:00:00","2019-06-14",146,6,0,6,1,159
"Brent","07:00:00","2019-06-17",854,19,40,219,42,1174
"Ealing","07:00:00","2019-06-17",10,0,0,1,0,11
"Greenwich","07:00:00","2019-06-17",43,1,0,7,2,53
"Havering","07:00:00","2019-06-17",35,0,0,4,1,40
"Hounslow","07:00:00","2019-06-17",27,0,1,0,0,28
"Kingston upon Thames","07:00:00","2019-06-17",479,6,13,45,1,544
"Lewisham","07:00:00","2019-06-17",518,23,14,146,14,715
"Southwark","07:00:00","2019-06-17",95,34,0,143,19,291
"Brent","08:00:00","2019-06-17",639,12,35,107,30,823
"Ealing","08:00:00","2019-06-17",20,0,0,3,0,23
"Greenwich","08:00:00","2019-06-17",60,1,1,8,2,72
"Havering","08:00:00","2019-06-17",155,0,0,2,0,157
"Hounslow","08:00:00","2019-06-17",37,1,1,5,1,45
"Kingston upon Thames","08:00:00","2019-06-17",530,9,12,40,3,594
"Lewisham","08:00:00","2019-06-17",590,15,15,94,15,729
"Southwark","08:00:00","2019-06-17",107,46,1,119,25,298
"Brent","09:00:00","2019-06-17",786,22,38,187,39,1072
"Ealing","09:00:00","2019-06-17",26,1,1,5,2,35
"Greenwich","09:00:00","2019-06-17",31,0,1,5,0,37
"Havering","09:00:00","2019-06-17",40,0,0,5,0,45
"Hounslow","09:00:00","2019-06-17",49,0,0,5,1,55
"Kingston upon Thames","09:00:00","2019-06-17",334,4,14,48,0,400
"Lewisham","09:00:00","2019-06-17",464,6,17,102,11,600
"Southwark","09:00:00","2019-06-17",92,37,2,71,19,221
"Brent","10:00:00","2019-06-17",698,14,25,188,44,969
"Ealing","10:00:00","2019-06-17",10,1,0,2,2,15
"Greenwich","10:00:00","2019-06-17",18,1,0,2,0,21
"Havering","10:00:00","2019-06-17",32,0,0,5,0,37
"Hounslow","10:00:00","2019-06-17",21,0,0,8,0,29
"Kingston upon Thames","10:00:00","2019-06-17",272,0,14,32,1,319
"Lewisham","10:00:00","2019-06-17",437,9,15,104,18,583
"Southwark","10:00:00","2019-06-17",76,15,3,70,20,184
"Brent","11:00:00","2019-06-17",754,17,30,176,42,1019
"Ealing","11:00:00","2019-06-17",18,0,0,2,0,20
"Greenwich","11:00:00","2019-06-17",20,1,1,2,1,25
"Havering","11:00:00","2019-06-17",43,0,0,3,0,46
"Hounslow","11:00:00","2019-06-17",29,0,1,6,1,37
"Kingston upon Thames","11:00:00","2019-06-17",238,0,11,25,1,275
"Lewisham","11:00:00","2019-06-17",449,9,15,89,10,572
"Southwark","11:00:00","2019-06-17",82,24,2,87,11,206
"Brent","12:00:00","2019-06-17",904,29,30,172,41,1176
"Ealing","12:00:00","2019-06-17",13,1,1,3,0,18
"Greenwich","12:00:00","2019-06-17",25,2,0,4,0,31
"Havering","12:00:00","2019-06-17",34,0,0,3,0,37
"Hounslow","12:00:00","2019-06-17",19,0,0,6,0,25
"Kingston upon Thames","12:00:00","2019-06-17",250,2,14,33,2,301
"Lewisham","12:00:00","2019-06-17",441,9,12,91,11,564
"Southwark","12:00:00","2019-06-17",92,34,0,80,16,222
"Brent","13:00:00","2019-06-17",924,33,26,192,33,1208
"Ealing","13:00:00","2019-06-17",10,1,0,3,0,14
"Greenwich","13:00:00","2019-06-17",20,1,0,5,1,27
"Havering","13:00:00","2019-06-17",29,0,0,8,2,39
"Hounslow","13:00:00","2019-06-17",28,1,0,8,0,37
"Kingston upon Thames","13:00:00","2019-06-17",264,0,14,35,1,314
"Lewisham","13:00:00","2019-06-17",429,12,11,102,16,570
"Southwark","13:00:00","2019-06-17",79,21,0,59,11,170
"Brent","14:00:00","2019-06-17",953,25,30,194,27,1229
"Ealing","14:00:00","2019-06-17",13,0,0,4,0,17
"Greenwich","14:00:00","2019-06-17",35,3,0,5,0,43
"Havering","14:00:00","2019-06-17",54,0,0,5,0,59
"Hounslow","14:00:00","2019-06-17",32,1,0,4,0,37
"Kingston upon Thames","14:00:00","2019-06-17",313,2,12,45,1,373
"Lewisham","14:00:00","2019-06-17",487,18,13,113,3,634
"Southwark","14:00:00","2019-06-17",85,21,1,68,10,185
"Brent","15:00:00","2019-06-17",975,28,39,187,34,1263
"Ealing","15:00:00","2019-06-17",24,1,1,1,0,27
"Greenwich","15:00:00","2019-06-17",63,1,1,3,0,68
"Havering","15:00:00","2019-06-17",62,0,0,4,1,67
"Hounslow","15:00:00","2019-06-17",48,0,0,3,0,51
"Kingston upon Thames","15:00:00","2019-06-17",388,7,11,34,1,441
"Lewisham","15:00:00","2019-06-17",531,10,10,84,11,646
"Southwark","15:00:00","2019-06-17",91,23,0,52,11,177
"Brent","16:00:00","2019-06-17",900,24,29,189,35,1177
"Ealing","16:00:00","2019-06-17",22,2,0,2,0,26
"Greenwich","16:00:00","2019-06-17",47,3,0,8,0,58
"Havering","16:00:00","2019-06-17",59,0,0,4,0,63
"Hounslow","16:00:00","2019-06-17",41,2,2,1,0,46
"Kingston upon Thames","16:00:00","2019-06-17",432,2,13,34,1,482
"Lewisham","16:00:00","2019-06-17",559,20,12,80,8,679
"Southwark","16:00:00","2019-06-17",80,18,1,43,7,149
"Brent","17:00:00","2019-06-17",760,29,34,133,28,984
"Ealing","17:00:00","2019-06-17",19,1,1,2,0,23
"Greenwich","17:00:00","2019-06-17",37,1,0,6,1,45
"Havering","17:00:00","2019-06-17",88,3,0,7,0,98
"Hounslow","17:00:00","2019-06-17",46,0,0,6,0,52
"Kingston upon Thames","17:00:00","2019-06-17",446,5,14,29,0,494
"Lewisham","17:00:00","2019-06-17",673,21,11,74,0,779
"Southwark","17:00:00","2019-06-17",99,24,0,48,5,176
"Brent","18:00:00","2019-06-17",804,24,32,99,15,974
"Ealing","18:00:00","2019-06-17",15,2,0,1,0,18
"Greenwich","18:00:00","2019-06-17",26,0,0,1,0,27
"Havering","18:00:00","2019-06-17",46,1,0,2,0,49
"Hounslow","18:00:00","2019-06-17",34,2,0,5,0,41
"Kingston upon Thames","18:00:00","2019-06-17",399,5,12,17,0,433
"Lewisham","18:00:00","2019-06-17",665,21,11,53,3,753
"Southwark","18:00:00","2019-06-17",154,33,0,18,1,206
"Brent","07:00:00","2019-06-18",23,0,0,4,0,27
"Croydon","07:00:00","2019-06-18",1486,21,40,383,64,1994
"Enfield","07:00:00","2019-06-18",5237,141,48,1891,555,7872
"Hillingdon","07:00:00","2019-06-18",26,0,0,6,0,32
"Kingston upon Thames","07:00:00","2019-06-18",133,1,13,24,4,175
"Lewisham","07:00:00","2019-06-18",52,1,0,13,2,68
"Newham","07:00:00","2019-06-18",334,3,0,64,6,407
"Brent","08:00:00","2019-06-18",49,0,0,3,1,53
"Croydon","08:00:00","2019-06-18",1609,9,39,294,52,2003
"Enfield","08:00:00","2019-06-18",5268,86,35,1387,551,7327
"Hillingdon","08:00:00","2019-06-18",38,0,0,5,0,43
"Kingston upon Thames","08:00:00","2019-06-18",206,3,11,28,0,248
"Lewisham","08:00:00","2019-06-18",73,0,0,6,3,82
"Newham","08:00:00","2019-06-18",404,5,0,70,7,486
"Brent","09:00:00","2019-06-18",24,1,0,1,0,26
"Croydon","09:00:00","2019-06-18",1323,12,36,233,67,1671
"Enfield","09:00:00","2019-06-18",4263,71,53,1281,616,6284
"Hillingdon","09:00:00","2019-06-18",29,1,0,7,3,40
"Kingston upon Thames","09:00:00","2019-06-18",161,4,13,34,6,218
"Lewisham","09:00:00","2019-06-18",52,3,0,14,0,69
"Newham","09:00:00","2019-06-18",343,6,0,64,6,419
"Brent","10:00:00","2019-06-18",20,1,0,3,1,25
"Croydon","10:00:00","2019-06-18",1108,11,35,207,83,1444
"Enfield","10:00:00","2019-06-18",3922,37,38,1451,651,6099
"Hillingdon","10:00:00","2019-06-18",34,0,0,11,2,47
"Kingston upon Thames","10:00:00","2019-06-18",139,1,14,23,4,181
"Lewisham","10:00:00","2019-06-18",34,1,0,10,3,48
"Newham","10:00:00","2019-06-18",233,4,0,58,12,307
"Brent","11:00:00","2019-06-18",19,0,0,5,2,26
"Croydon","11:00:00","2019-06-18",1176,10,37,223,52,1498
"Enfield","11:00:00","2019-06-18",3998,39,33,1358,643,6071
"Havering","11:00:00","2019-06-18",4226,20,12,1308,2144,7710
"Hillingdon","11:00:00","2019-06-18",28,0,0,6,0,34
"Kensington and Chelsea","11:00:00","2019-06-18",2651,112,19,1043,336,4161
"Kingston upon Thames","11:00:00","2019-06-18",128,0,10,30,1,169
"Lewisham","11:00:00","2019-06-18",27,1,0,5,0,33
"Newham","11:00:00","2019-06-18",246,4,0,60,6,316
"Brent","12:00:00","2019-06-18",23,1,0,7,0,31
"Croydon","12:00:00","2019-06-18",1249,8,35,285,65,1642
"Enfield","12:00:00","2019-06-18",4182,59,38,1389,624,6292
"Hillingdon","12:00:00","2019-06-18",18,0,0,8,2,28
"Kingston upon Thames","12:00:00","2019-06-18",144,1,12,29,2,188
"Lewisham","12:00:00","2019-06-18",39,0,0,5,3,47
"Newham","12:00:00","2019-06-18",286,5,0,62,5,358
"Brent","13:00:00","2019-06-18",24,2,0,3,0,29
"Croydon","13:00:00","2019-06-18",1120,7,35,253,63,1478
"Enfield","13:00:00","2019-06-18",4124,54,37,1435,624,6274
"Hillingdon","13:00:00","2019-06-18",27,0,0,8,0,35
"Kensington and Chelsea","13:00:00","2019-06-18",2756,127,25,976,280,4164
"Kingston upon Thames","13:00:00","2019-06-18",134,2,11,27,3,177
"Lewisham","13:00:00","2019-06-18",31,0,1,7,2,41
"Newham","13:00:00","2019-06-18",248,6,0,56,1,311
"Brent","14:00:00","2019-06-18",28,0,0,1,0,29
"Croydon","14:00:00","2019-06-18",1419,13,41,306,69,1848
"Enfield","14:00:00","2019-06-18",4566,45,39,1491,558,6699
"Hillingdon","14:00:00","2019-06-18",23,0,0,7,0,30
"Kingston upon Thames","14:00:00","2019-06-18",138,4,11,20,4,177
"Lewisham","14:00:00","2019-06-18",35,2,0,10,0,47
"Newham","14:00:00","2019-06-18",307,5,0,52,4,368
"Brent","15:00:00","2019-06-18",57,0,0,1,0,58
"Croydon","15:00:00","2019-06-18",1639,24,38,255,54,2010
"Enfield","15:00:00","2019-06-18",4729,67,43,1518,456,6813
"Hillingdon","15:00:00","2019-06-18",23,0,0,4,0,27
"Kingston upon Thames","15:00:00","2019-06-18",170,0,12,32,5,219
"Lewisham","15:00:00","2019-06-18",61,2,0,8,0,71
"Newham","15:00:00","2019-06-18",386,6,0,53,5,450
"Brent","16:00:00","2019-06-18",34,0,0,8,0,42
"Croydon","16:00:00","2019-06-18",1527,21,39,329,31,1947
"Enfield","16:00:00","2019-06-18",5071,113,41,1482,276,6983
"Hillingdon","16:00:00","2019-06-18",28,0,0,2,0,30
"Kingston upon Thames","16:00:00","2019-06-18",177,2,11,34,0,224
"Lewisham","16:00:00","2019-06-18",50,1,0,8,1,60
"Newham","16:00:00","2019-06-18",393,5,0,77,3,478
"Brent","17:00:00","2019-06-18",41,4,0,3,0,48
"Croydon","17:00:00","2019-06-18",1691,23,34,264,18,2030
"Enfield","17:00:00","2019-06-18",5487,132,32,1181,191,7023
"Hillingdon","17:00:00","2019-06-18",32,0,0,2,0,34
"Kingston upon Thames","17:00:00","2019-06-18",197,2,8,16,0,223
"Lewisham","17:00:00","2019-06-18",63,2,0,9,0,74
"Newham","17:00:00","2019-06-18",470,6,0,77,5,558
"Brent","18:00:00","2019-06-18",50,2,0,2,0,54
"Croydon","18:00:00","2019-06-18",1564,16,36,214,20,1850
"Enfield","18:00:00","2019-06-18",5947,110,36,1066,172,7331
"Hillingdon","18:00:00","2019-06-18",26,2,0,0,0,28
"Kingston upon Thames","18:00:00","2019-06-18",165,5,13,14,0,197
"Lewisham","18:00:00","2019-06-18",58,1,0,7,0,66
"Newham","18:00:00","2019-06-18",432,5,0,38,0,475
"Havering","07:00:00","2019-06-19",19,0,1,4,0,24
"Hillingdon","07:00:00","2019-06-19",611,8,35,108,15,777
"Kensington and Chelsea","07:00:00","2019-06-19",473,18,23,166,17,697
"Lewisham","07:00:00","2019-06-19",7,0,0,0,0,7
"Wandsworth","07:00:00","2019-06-19",548,38,6,195,6,793
"Westminster","07:00:00","2019-06-19",251,23,17,87,16,394
"Havering","08:00:00","2019-06-19",22,0,1,6,0,29
"Hillingdon","08:00:00","2019-06-19",794,7,29,104,16,950
"Kensington and Chelsea","08:00:00","2019-06-19",816,18,26,155,14,1029
"Lewisham","08:00:00","2019-06-19",5,0,0,1,0,6
"Wandsworth","08:00:00","2019-06-19",788,29,7,153,11,988
"Westminster","08:00:00","2019-06-19",304,32,22,90,23,471
"Havering","09:00:00","2019-06-19",16,0,0,4,0,20
"Hillingdon","09:00:00","2019-06-19",558,3,28,74,23,686
"Kensington and Chelsea","09:00:00","2019-06-19",595,33,36,183,10,857
"Lewisham","09:00:00","2019-06-19",5,0,0,0,0,5
"Wandsworth","09:00:00","2019-06-19",508,26,7,167,19,727
"Westminster","09:00:00","2019-06-19",302,24,19,97,30,472
"Havering","10:00:00","2019-06-19",14,0,0,7,0,21
"Hillingdon","10:00:00","2019-06-19",615,5,29,107,14,770
"Kensington and Chelsea","10:00:00","2019-06-19",533,24,26,184,12,779
"Lewisham","10:00:00","2019-06-19",9,0,0,0,0,9
"Wandsworth","10:00:00","2019-06-19",425,16,6,144,7,598
"Westminster","10:00:00","2019-06-19",329,15,16,130,20,510
"Havering","11:00:00","2019-06-19",12,0,0,4,0,16
"Hillingdon","11:00:00","2019-06-19",647,6,30,95,29,807
"Kensington and Chelsea","11:00:00","2019-06-19",513,44,29,184,16,786
"Lewisham","11:00:00","2019-06-19",5,0,0,1,0,6
"Wandsworth","11:00:00","2019-06-19",412,19,6,135,12,584
"Westminster","11:00:00","2019-06-19",387,37,10,132,16,582
"Havering","12:00:00","2019-06-19",22,0,0,6,0,28
"Hillingdon","12:00:00","2019-06-19",705,7,28,108,9,857
"Kensington and Chelsea","12:00:00","2019-06-19",535,39,33,155,14,776
"Lewisham","12:00:00","2019-06-19",6,0,0,0,0,6
"Wandsworth","12:00:00","2019-06-19",440,25,6,127,14,612
"Westminster","12:00:00","2019-06-19",301,33,11,105,18,468
"Havering","13:00:00","2019-06-19",17,0,0,7,0,24
"Hillingdon","13:00:00","2019-06-19",705,4,31,97,20,857
"Kensington and Chelsea","13:00:00","2019-06-19",573,41,32,167,10,823
"Lewisham","13:00:00","2019-06-19",7,0,0,0,0,7
"Wandsworth","13:00:00","2019-06-19",422,23,6,125,6,582
"Westminster","13:00:00","2019-06-19",321,26,9,114,17,487
"Havering","14:00:00","2019-06-19",16,0,0,8,1,25
"Hillingdon","14:00:00","2019-06-19",806,8,28,85,13,940
"Kensington and Chelsea","14:00:00","2019-06-19",549,41,29,153,9,781
"Lewisham","14:00:00","2019-06-19",6,0,0,2,0,8
"Wandsworth","14:00:00","2019-06-19",426,27,7,121,17,598
"Westminster","14:00:00","2019-06-19",302,26,11,101,14,454
"Havering","15:00:00","2019-06-19",34,0,0,2,1,37
"Hillingdon","15:00:00","2019-06-19",887,11,30,86,13,1027
"Kensington and Chelsea","15:00:00","2019-06-19",799,45,34,132,18,1028
"Lewisham","15:00:00","2019-06-19",5,0,0,1,0,6
"Wandsworth","15:00:00","2019-06-19",584,21,6,147,6,764
"Westminster","15:00:00","2019-06-19",309,36,8,65,8,426
"Havering","16:00:00","2019-06-19",19,0,1,5,2,27
"Hillingdon","16:00:00","2019-06-19",778,21,33,90,16,938
"Kensington and Chelsea","16:00:00","2019-06-19",896,31,30,179,4,1140
"Lewisham","16:00:00","2019-06-19",7,0,0,1,0,8
"Wandsworth","16:00:00","2019-06-19",724,40,6,175,6,951
"Westminster","16:00:00","2019-06-19",373,24,19,79,10,505
"Havering","17:00:00","2019-06-19",35,1,0,1,0,37
"Hillingdon","17:00:00","2019-06-19",811,13,26,82,9,941
"Kensington and Chelsea","17:00:00","2019-06-19",870,55,36,132,5,1098
"Lewisham","17:00:00","2019-06-19",11,0,0,0,0,11
"Wandsworth","17:00:00","2019-06-19",766,54,6,142,3,971
"Westminster","17:00:00","2019-06-19",393,47,23,74,6,543
"Havering","18:00:00","2019-06-19",28,0,0,2,0,30
"Hillingdon","18:00:00","2019-06-19",803,22,35,89,7,956
"Kensington and Chelsea","18:00:00","2019-06-19",832,66,26,78,3,1005
"Lewisham","18:00:00","2019-06-19",8,0,0,1,0,9
"Wandsworth","18:00:00","2019-06-19",759,65,6,88,4,922
"Westminster","18:00:00","2019-06-19",471,46,18,49,1,585
"Barnet","07:00:00","2019-06-20",2435,99,57,836,128,3555
"Bexley","07:00:00","2019-06-20",50,0,0,10,0,60
"Haringey","07:00:00","2019-06-20",734,84,48,356,67,1289
"Kingston upon Thames","07:00:00","2019-06-20",92,1,17,27,4,141
"Newham","07:00:00","2019-06-20",991,19,59,215,23,1307
"Redbridge","07:00:00","2019-06-20",34,2,0,5,1,42
"Tower Hamlets","07:00:00","2019-06-20",867,111,50,363,56,1447
"Barnet","08:00:00","2019-06-20",3204,87,58,658,85,4092
"Bexley","08:00:00","2019-06-20",92,0,0,22,0,114
"Haringey","08:00:00","2019-06-20",747,73,42,298,84,1244
"Kingston upon Thames","08:00:00","2019-06-20",177,2,15,28,4,226
"Newham","08:00:00","2019-06-20",1079,15,52,194,30,1370
"Redbridge","08:00:00","2019-06-20",82,0,0,4,0,86
"Tower Hamlets","08:00:00","2019-06-20",1130,95,62,323,61,1671
"Barnet","09:00:00","2019-06-20",2443,69,80,488,155,3235
"Bexley","09:00:00","2019-06-20",45,0,0,6,0,51
"Haringey","09:00:00","2019-06-20",683,50,48,351,128,1260
"Kingston upon Thames","09:00:00","2019-06-20",142,1,20,24,2,189
"Newham","09:00:00","2019-06-20",943,27,53,219,31,1273
"Redbridge","09:00:00","2019-06-20",49,0,0,5,0,54
"Tower Hamlets","09:00:00","2019-06-20",811,59,73,293,85,1321
"Barnet","10:00:00","2019-06-20",2551,51,64,615,158,3439
"Bexley","10:00:00","2019-06-20",42,0,0,5,0,47
"Haringey","10:00:00","2019-06-20",698,45,47,317,81,1188
"Kingston upon Thames","10:00:00","2019-06-20",108,0,16,21,1,146
"Newham","10:00:00","2019-06-20",868,23,53,212,27,1183
"Redbridge","10:00:00","2019-06-20",35,0,0,7,0,42
"Tower Hamlets","10:00:00","2019-06-20",995,44,58,328,83,1508
"Barnet","11:00:00","2019-06-20",2492,51,53,712,163,3471
"Bexley","11:00:00","2019-06-20",45,1,0,8,0,54
"Haringey","11:00:00","2019-06-20",701,55,37,326,86,1205
"Kingston upon Thames","11:00:00","2019-06-20",91,0,18,28,1,138
"Newham","11:00:00","2019-06-20",972,26,44,191,29,1262
"Redbridge","11:00:00","2019-06-20",41,0,0,3,0,44
"Tower Hamlets","11:00:00","2019-06-20",918,62,59,273,98,1410
"Barnet","12:00:00","2019-06-20",2933,55,59,615,184,3846
"Bexley","12:00:00","2019-06-20",42,2,0,8,0,52
"Haringey","12:00:00","2019-06-20",796,60,43,304,82,1285
"Kingston upon Thames","12:00:00","2019-06-20",109,0,17,23,1,150
"Newham","12:00:00","2019-06-20",893,15,46,197,15,1166
"Redbridge","12:00:00","2019-06-20",42,0,0,5,0,47
"Tower Hamlets","12:00:00","2019-06-20",934,67,59,274,80,1414
"Barnet","13:00:00","2019-06-20",2941,60,115,654,236,4006
"Bexley","13:00:00","2019-06-20",55,0,0,7,0,62
"Haringey","13:00:00","2019-06-20",763,87,38,282,80,1250
"Kingston upon Thames","13:00:00","2019-06-20",106,3,17,26,0,152
"Newham","13:00:00","2019-06-20",1047,12,47,170,10,1286
"Redbridge","13:00:00","2019-06-20",34,0,0,3,1,38
"Tower Hamlets","13:00:00","2019-06-20",945,64,51,276,61,1397
"Barnet","14:00:00","2019-06-20",3229,58,60,693,124,4164
"Bexley","14:00:00","2019-06-20",46,1,0,2,3,52
"Haringey","14:00:00","2019-06-20",860,62,40,321,94,1377
"Kingston upon Thames","14:00:00","2019-06-20",122,0,17,26,0,165
"Newham","14:00:00","2019-06-20",1028,18,42,135,22,1245
"Redbridge","14:00:00","2019-06-20",54,3,0,5,0,62
"Tower Hamlets","14:00:00","2019-06-20",1136,78,64,285,66,1629
"Barnet","15:00:00","2019-06-20",2988,47,60,651,144,3890
"Bexley","15:00:00","2019-06-20",78,0,0,10,0,88
"Haringey","15:00:00","2019-06-20",787,53,43,256,48,1187
"Kingston upon Thames","15:00:00","2019-06-20",144,0,16,23,0,183
"Newham","15:00:00","2019-06-20",1086,15,52,161,12,1326
"Redbridge","15:00:00","2019-06-20",80,1,0,9,1,91
"Tower Hamlets","15:00:00","2019-06-20",1181,67,64,262,55,1629
"Barnet","16:00:00","2019-06-20",3148,101,99,669,74,4091
"Bexley","16:00:00","2019-06-20",69,2,0,9,0,80
"Haringey","16:00:00","2019-06-20",937,97,46,268,34,1382
"Kingston upon Thames","16:00:00","2019-06-20",147,2,21,30,1,201
"Newham","16:00:00","2019-06-20",1123,16,50,175,10,1374
"Redbridge","16:00:00","2019-06-20",60,0,0,14,0,74
"Tower Hamlets","16:00:00","2019-06-20",1254,93,64,247,33,1691
"Barnet","17:00:00","2019-06-20",3543,91,57,609,116,4416
"Bexley","17:00:00","2019-06-20",85,1,0,18,0,104
"Haringey","17:00:00","2019-06-20",1059,106,45,243,21,1474
"Kingston upon Thames","17:00:00","2019-06-20",163,3,15,22,0,203
"Newham","17:00:00","2019-06-20",1225,10,41,142,5,1423
"Redbridge","17:00:00","2019-06-20",86,0,0,9,0,95
"Tower Hamlets","17:00:00","2019-06-20",1282,149,57,164,28,1680
"Barnet","18:00:00","2019-06-20",3368,70,71,486,57,4052
"Bexley","18:00:00","2019-06-20",75,0,0,8,0,83
"Haringey","18:00:00","2019-06-20",1105,97,40,196,21,1459
"Kingston upon Thames","18:00:00","2019-06-20",172,2,17,16,0,207
"Newham","18:00:00","2019-06-20",851,15,53,110,4,1033
"Redbridge","18:00:00","2019-06-20",76,1,0,8,0,85
"Tower Hamlets","18:00:00","2019-06-20",1346,136,62,119,19,1682
"Bromley","07:00:00","2019-06-21",942,9,18,296,19,1284
"Ealing","07:00:00","2019-06-21",66,3,0,22,0,91
"Hammersmith and Fulham","07:00:00","2019-06-21",524,55,66,170,17,832
"Hillingdon","07:00:00","2019-06-21",38,0,0,13,1,52
"Kingston upon Thames","07:00:00","2019-06-21",26,1,0,2,0,29
"Newham","07:00:00","2019-06-21",126,5,25,43,32,231
"Sutton","07:00:00","2019-06-21",659,10,23,199,38,929
"Wandsworth","07:00:00","2019-06-21",745,29,1,176,8,959
"Bromley","08:00:00","2019-06-21",1014,6,26,251,10,1307
"Ealing","08:00:00","2019-06-21",113,3,0,10,1,127
"Hammersmith and Fulham","08:00:00","2019-06-21",705,63,62,147,21,998
"Hillingdon","08:00:00","2019-06-21",141,0,0,13,0,154
"Kingston upon Thames","08:00:00","2019-06-21",70,0,0,6,0,76
"Newham","08:00:00","2019-06-21",147,3,10,56,34,250
"Sutton","08:00:00","2019-06-21",781,11,20,209,30,1051
"Wandsworth","08:00:00","2019-06-21",793,29,0,119,10,951
"Bromley","09:00:00","2019-06-21",815,8,21,223,16,1083
"Ealing","09:00:00","2019-06-21",111,3,0,23,0,137
"Hammersmith and Fulham","09:00:00","2019-06-21",581,53,61,154,19,868
"Hillingdon","09:00:00","2019-06-21",62,0,0,7,1,70
"Kingston upon Thames","09:00:00","2019-06-21",44,1,0,3,1,49
"Newham","09:00:00","2019-06-21",135,2,11,75,39,262
"Sutton","09:00:00","2019-06-21",665,12,26,164,39,906
"Wandsworth","09:00:00","2019-06-21",779,17,0,146,13,955
"Bromley","10:00:00","2019-06-21",740,3,19,182,11,955
"Ealing","10:00:00","2019-06-21",113,5,0,32,0,150
"Hammersmith and Fulham","10:00:00","2019-06-21",608,38,56,162,24,888
"Hillingdon","10:00:00","2019-06-21",54,2,0,6,2,64
"Kingston upon Thames","10:00:00","2019-06-21",30,0,0,0,1,31
"Newham","10:00:00","2019-06-21",131,3,10,79,34,257
"Sutton","10:00:00","2019-06-21",551,5,20,160,40,776
"Wandsworth","10:00:00","2019-06-21",633,12,0,150,15,810
"Bromley","11:00:00","2019-06-21",688,2,18,160,22,890
"Ealing","11:00:00","2019-06-21",109,3,0,19,0,131
"Hammersmith and Fulham","11:00:00","2019-06-21",667,60,57,170,13,967
"Hillingdon","11:00:00","2019-06-21",54,0,0,8,2,64
"Kingston upon Thames","11:00:00","2019-06-21",38,0,0,3,0,41
"Newham","11:00:00","2019-06-21",120,3,11,65,32,231
"Sutton","11:00:00","2019-06-21",606,7,29,220,45,907
"Wandsworth","11:00:00","2019-06-21",709,14,0,165,11,899
"Bromley","12:00:00","2019-06-21",720,8,21,176,13,938
"Ealing","12:00:00","2019-06-21",114,7,0,29,0,150
"Hammersmith and Fulham","12:00:00","2019-06-21",522,58,55,166,19,820
"Hillingdon","12:00:00","2019-06-21",58,0,0,9,1,68
"Kingston upon Thames","12:00:00","2019-06-21",39,1,0,7,0,47
"Newham","12:00:00","2019-06-21",170,3,11,71,25,280
"Sutton","12:00:00","2019-06-21",612,11,23,169,37,852
"Wandsworth","12:00:00","2019-06-21",841,13,0,173,11,1038
"Bromley","13:00:00","2019-06-21",838,2,22,230,24,1116
"Ealing","13:00:00","2019-06-21",97,0,0,24,0,121
"Hammersmith and Fulham","13:00:00","2019-06-21",481,72,59,136,25,773
"Hillingdon","13:00:00","2019-06-21",72,0,0,10,0,82
"Kingston upon Thames","13:00:00","2019-06-21",33,0,0,8,0,41
"Newham","13:00:00","2019-06-21",168,5,10,66,33,282
"Sutton","13:00:00","2019-06-21",727,17,24,187,35,990
"Wandsworth","13:00:00","2019-06-21",834,13,1,193,8,1049
"Bromley","14:00:00","2019-06-21",837,8,20,186,13,1064
"Ealing","14:00:00","2019-06-21",127,2,0,23,0,152
"Hammersmith and Fulham","14:00:00","2019-06-21",612,67,52,162,12,905
"Hillingdon","14:00:00","2019-06-21",55,1,0,11,0,67
"Kingston upon Thames","14:00:00","2019-06-21",28,0,0,7,0,35
"Newham","14:00:00","2019-06-21",160,11,12,60,23,266
"Sutton","14:00:00","2019-06-21",875,22,27,238,34,1196
"Wandsworth","14:00:00","2019-06-21",835,13,0,184,16,1048
"Bromley","15:00:00","2019-06-21",923,6,21,204,14,1168
"Ealing","15:00:00","2019-06-21",118,1,0,30,0,149
"Hammersmith and Fulham","15:00:00","2019-06-21",633,49,59,124,15,880
"Hillingdon","15:00:00","2019-06-21",108,1,0,15,0,124
"Kingston upon Thames","15:00:00","2019-06-21",53,0,0,5,0,58
"Newham","15:00:00","2019-06-21",196,4,9,73,41,323
"Sutton","15:00:00","2019-06-21",820,15,22,176,35,1068
"Wandsworth","15:00:00","2019-06-21",992,12,0,130,6,1140
"Bromley","16:00:00","2019-06-21",1004,13,19,214,11,1261
"Ealing","16:00:00","2019-06-21",141,7,0,22,1,171
"Hammersmith and Fulham","16:00:00","2019-06-21",622,62,61,109,4,858
"Hillingdon","16:00:00","2019-06-21",80,0,1,11,0,92
"Kingston upon Thames","16:00:00","2019-06-21",32,0,0,5,0,37
"Newham","16:00:00","2019-06-21",184,6,13,66,36,305
"Sutton","16:00:00","2019-06-21",1050,33,18,211,24,1336
"Wandsworth","16:00:00","2019-06-21",916,18,0,136,1,1071
"Bromley","17:00:00","2019-06-21",1130,9,17,159,3,1318
"Ealing","17:00:00","2019-06-21",135,11,0,21,0,167
"Hammersmith and Fulham","17:00:00","2019-06-21",649,90,59,71,4,873
"Hillingdon","17:00:00","2019-06-21",90,2,2,9,0,103
"Kingston upon Thames","17:00:00","2019-06-21",35,0,0,3,0,38
"Newham","17:00:00","2019-06-21",191,5,13,42,13,264
"Sutton","17:00:00","2019-06-21",988,29,22,187,11,1237
"Wandsworth","17:00:00","2019-06-21",937,37,1,109,0,1084
"Bromley","18:00:00","2019-06-21",840,14,20,83,2,959
"Ealing","18:00:00","2019-06-21",128,8,0,11,0,147
"Hammersmith and Fulham","18:00:00","2019-06-21",717,110,55,63,1,946
"Hillingdon","18:00:00","2019-06-21",82,1,0,5,0,88
"Kingston upon Thames","18:00:00","2019-06-21",43,0,0,3,0,46
"Newham","18:00:00","2019-06-21",165,8,18,36,0,227
"Sutton","18:00:00","2019-06-21",956,36,20,123,6,1141
"Wandsworth","18:00:00","2019-06-21",932,26,1,76,2,1037
"Barnet","07:00:00","2019-06-24",1337,24,40,267,15,1683
"Bromley","07:00:00","2019-06-24",322,2,3,102,7,436
"Greenwich","07:00:00","2019-06-24",20,0,0,9,1,30
"Havering","07:00:00","2019-06-24",102,0,1,16,0,119
"Hillingdon","07:00:00","2019-06-24",581,3,0,49,3,636
"Islington","07:00:00","2019-06-24",361,39,52,133,29,614
"Richmond upon Thames","07:00:00","2019-06-24",1080,13,10,146,13,1262
"Westminster","07:00:00","2019-06-24",27,6,0,2,0,35
"Barnet","08:00:00","2019-06-24",1589,21,37,194,30,1871
"Bromley","08:00:00","2019-06-24",352,2,2,83,9,448
"Greenwich","08:00:00","2019-06-24",27,2,0,8,0,37
"Havering","08:00:00","2019-06-24",167,0,0,17,0,184
"Hillingdon","08:00:00","2019-06-24",831,2,0,40,1,874
"Islington","08:00:00","2019-06-24",499,57,36,157,27,776
"Richmond upon Thames","08:00:00","2019-06-24",1302,13,10,145,16,1486
"Westminster","08:00:00","2019-06-24",54,1,0,14,0,69
"Barnet","09:00:00","2019-06-24",1118,8,33,219,21,1399
"Bromley","09:00:00","2019-06-24",209,0,5,51,8,273
"Greenwich","09:00:00","2019-06-24",28,2,0,7,0,37
"Havering","09:00:00","2019-06-24",57,1,0,15,1,74
"Hillingdon","09:00:00","2019-06-24",310,0,0,32,3,345
"Islington","09:00:00","2019-06-24",436,31,46,146,34,693
"Richmond upon Thames","09:00:00","2019-06-24",838,4,14,137,19,1012
"Westminster","09:00:00","2019-06-24",34,2,0,9,1,46
"Barnet","10:00:00","2019-06-24",836,10,24,176,15,1061
"Bromley","10:00:00","2019-06-24",163,2,3,47,12,227
"Greenwich","10:00:00","2019-06-24",13,0,0,4,0,17
"Havering","10:00:00","2019-06-24",51,0,0,7,0,58
"Hillingdon","10:00:00","2019-06-24",111,0,0,10,0,121
"Islington","10:00:00","2019-06-24",350,20,43,144,29,586
"Richmond upon Thames","10:00:00","2019-06-24",663,7,15,162,19,866
"Westminster","10:00:00","2019-06-24",29,0,0,11,5,45
"Barnet","11:00:00","2019-06-24",893,13,27,206,28,1167
"Bromley","11:00:00","2019-06-24",177,0,4,49,6,236
"Greenwich","11:00:00","2019-06-24",23,0,0,4,0,27
"Havering","11:00:00","2019-06-24",77,0,0,11,1,89
"Hillingdon","11:00:00","2019-06-24",113,0,0,25,3,141
"Islington","11:00:00","2019-06-24",291,32,43,178,38,582
"Richmond upon Thames","11:00:00","2019-06-24",693,4,12,142,13,864
"Westminster","11:00:00","2019-06-24",33,3,0,10,2,48
"Barnet","12:00:00","2019-06-24",884,10,23,172,32,1121
"Bromley","12:00:00","2019-06-24",169,1,4,51,3,228
"Greenwich","12:00:00","2019-06-24",24,0,0,4,1,29
"Havering","12:00:00","2019-06-24",62,0,0,12,1,75
"Hillingdon","12:00:00","2019-06-24",125,0,0,14,1,140
"Islington","12:00:00","2019-06-24",297,32,41,132,27,529
"Richmond upon Thames","12:00:00","2019-06-24",641,5,9,107,12,774
"Westminster","12:00:00","2019-06-24",44,6,0,12,3,65
"Barnet","13:00:00","2019-06-24",889,12,31,152,23,1107
"Bromley","13:00:00","2019-06-24",185,0,5,41,4,235
"Greenwich","13:00:00","2019-06-24",16,1,0,4,0,21
"Havering","13:00:00","2019-06-24",59,0,0,12,0,71
"Hillingdon","13:00:00","2019-06-24",99,1,0,21,1,122
"Islington","13:00:00","2019-06-24",357,32,35,168,29,621
"Richmond upon Thames","13:00:00","2019-06-24",649,8,12,100,21,790
"Westminster","13:00:00","2019-06-24",28,5,0,7,0,40
"Barnet","14:00:00","2019-06-24",1010,13,34,166,29,1252
"Bromley","14:00:00","2019-06-24",190,1,3,50,11,255
"Greenwich","14:00:00","2019-06-24",16,0,0,3,0,19
"Havering","14:00:00","2019-06-24",78,0,0,15,1,94
"Hillingdon","14:00:00","2019-06-24",129,0,0,14,3,146
"Islington","14:00:00","2019-06-24",355,34,39,155,21,604
"Richmond upon Thames","14:00:00","2019-06-24",655,10,12,123,20,820
"Westminster","14:00:00","2019-06-24",43,2,0,10,0,55
"Barnet","15:00:00","2019-06-24",1342,17,44,186,12,1601
"Bromley","15:00:00","2019-06-24",190,3,4,37,5,239
"Greenwich","15:00:00","2019-06-24",29,0,0,8,0,37
"Havering","15:00:00","2019-06-24",91,0,1,14,0,106
"Hillingdon","15:00:00","2019-06-24",293,1,0,14,1,309
"Islington","15:00:00","2019-06-24",394,28,39,147,9,617
"Richmond upon Thames","15:00:00","2019-06-24",898,10,9,124,11,1052
"Westminster","15:00:00","2019-06-24",48,2,0,15,0,65
"Barnet","16:00:00","2019-06-24",1262,19,51,182,10,1524
"Bromley","16:00:00","2019-06-24",253,0,3,70,3,329
"Greenwich","16:00:00","2019-06-24",26,0,0,6,0,32
"Havering","16:00:00","2019-06-24",92,0,0,22,0,114
"Hillingdon","16:00:00","2019-06-24",226,1,0,24,2,253
"Islington","16:00:00","2019-06-24",439,48,38,157,9,691
"Richmond upon Thames","16:00:00","2019-06-24",1068,12,10,156,8,1254
"Westminster","16:00:00","2019-06-24",49,3,0,11,1,64
"Barnet","17:00:00","2019-06-24",1359,21,23,151,4,1558
"Bromley","17:00:00","2019-06-24",337,7,4,49,3,400
"Greenwich","17:00:00","2019-06-24",19,0,0,3,0,22
"Havering","17:00:00","2019-06-24",109,0,0,11,0,120
"Hillingdon","17:00:00","2019-06-24",295,7,0,25,1,328
"Islington","17:00:00","2019-06-24",463,66,39,82,4,654
"Richmond upon Thames","17:00:00","2019-06-24",1180,21,12,117,4,1334
"Westminster","17:00:00","2019-06-24",48,4,0,3,0,55
"Barnet","18:00:00","2019-06-24",1134,10,27,97,4,1272
"Bromley","18:00:00","2019-06-24",219,2,3,34,5,263
"Greenwich","18:00:00","2019-06-24",27,2,0,2,0,31
"Havering","18:00:00","2019-06-24",68,0,0,5,0,73
"Hillingdon","18:00:00","2019-06-24",220,0,0,12,1,233
"Islington","18:00:00","2019-06-24",546,79,49,86,7,767
"Richmond upon Thames","18:00:00","2019-06-24",1082,13,12,70,6,1183
"Westminster","18:00:00","2019-06-24",45,6,0,6,0,57
"Bexley","07:00:00","2019-06-25",1751,33,36,526,44,2390
"Bromley","07:00:00","2019-06-25",51,0,0,12,1,64
"Croydon","07:00:00","2019-06-25",641,27,7,206,32,913
"Ealing","07:00:00","2019-06-25",23,0,0,0,0,23
"Kingston upon Thames","07:00:00","2019-06-25",7272,160,43,1685,309,9469
"Lewisham","07:00:00","2019-06-25",324,5,14,150,2,495
"Newham","07:00:00","2019-06-25",80,0,0,19,0,99
"Southwark","07:00:00","2019-06-25",304,35,36,181,12,568
"Sutton","07:00:00","2019-06-25",1008,19,18,177,25,1247
"Bexley","08:00:00","2019-06-25",1782,19,42,430,46,2319
"Bromley","08:00:00","2019-06-25",60,0,0,12,0,72
"Croydon","08:00:00","2019-06-25",615,17,3,200,41,876
"Ealing","08:00:00","2019-06-25",21,0,0,4,1,26
"Kingston upon Thames","08:00:00","2019-06-25",6910,146,33,1176,347,8612
"Lewisham","08:00:00","2019-06-25",398,4,14,97,2,515
"Newham","08:00:00","2019-06-25",264,1,0,28,2,295
"Southwark","08:00:00","2019-06-25",454,54,30,173,5,716
"Sutton","08:00:00","2019-06-25",1170,12,20,135,25,1362
"Bexley","09:00:00","2019-06-25",1446,13,46,477,70,2052
"Bromley","09:00:00","2019-06-25",61,0,0,11,1,73
"Croydon","09:00:00","2019-06-25",674,10,1,190,51,926
"Ealing","09:00:00","2019-06-25",16,1,0,8,0,25
"Kingston upon Thames","09:00:00","2019-06-25",5732,73,40,1246,421,7512
"Lewisham","09:00:00","2019-06-25",360,9,12,72,2,455
"Newham","09:00:00","2019-06-25",149,3,0,21,1,174
"Southwark","09:00:00","2019-06-25",366,59,37,136,8,606
"Sutton","09:00:00","2019-06-25",852,5,23,140,35,1055
"Bexley","10:00:00","2019-06-25",1524,17,35,371,74,2021
"Bromley","10:00:00","2019-06-25",41,0,0,7,0,48
"Croydon","10:00:00","2019-06-25",527,13,6,144,39,729
"Ealing","10:00:00","2019-06-25",22,1,0,1,0,24
"Kingston upon Thames","10:00:00","2019-06-25",4895,38,15,1173,430,6551
"Lewisham","10:00:00","2019-06-25",266,2,11,75,4,358
"Newham","10:00:00","2019-06-25",107,0,0,26,4,137
"Southwark","10:00:00","2019-06-25",310,21,28,116,10,485
"Sutton","10:00:00","2019-06-25",696,8,19,139,38,900
"Bexley","11:00:00","2019-06-25",1349,11,36,336,76,1808
"Bromley","11:00:00","2019-06-25",40,0,0,14,0,54
"Croydon","11:00:00","2019-06-25",547,9,1,142,61,760
"Ealing","11:00:00","2019-06-25",14,0,0,7,0,21
"Kingston upon Thames","11:00:00","2019-06-25",4424,49,10,1181,468,6132
"Lewisham","11:00:00","2019-06-25",229,4,9,76,2,320
"Newham","11:00:00","2019-06-25",147,5,0,27,3,182
"Southwark","11:00:00","2019-06-25",301,34,30,105,11,481
"Sutton","11:00:00","2019-06-25",762,13,18,139,43,975
"Bexley","12:00:00","2019-06-25",1422,10,33,367,57,1889
"Bromley","12:00:00","2019-06-25",51,0,0,10,0,61
"Croydon","12:00:00","2019-06-25",693,9,2,174,62,940
"Ealing","12:00:00","2019-06-25",25,0,0,13,0,38
"Kingston upon Thames","12:00:00","2019-06-25",4501,57,6,1121,416,6101
"Lewisham","12:00:00","2019-06-25",249,5,12,71,4,341
"Newham","12:00:00","2019-06-25",153,3,0,26,7,189
"Southwark","12:00:00","2019-06-25",322,21,30,136,6,515
"Sutton","12:00:00","2019-06-25",798,9,19,154,35,1015
"Bexley","13:00:00","2019-06-25",1317,19,30,300,52,1718
"Bromley","13:00:00","2019-06-25",27,0,0,10,0,37
"Croydon","13:00:00","2019-06-25",594,11,6,174,53,838
"Ealing","13:00:00","2019-06-25",18,0,0,5,1,24
"Kingston upon Thames","13:00:00","2019-06-25",4654,60,11,1086,433,6244
"Lewisham","13:00:00","2019-06-25",319,10,13,112,2,456
"Newham","13:00:00","2019-06-25",140,4,0,31,3,178
"Southwark","13:00:00","2019-06-25",307,28,31,126,13,505
"Sutton","13:00:00","2019-06-25",760,14,21,128,28,951
"Bexley","14:00:00","2019-06-25",1527,16,38,407,53,2041
"Bromley","14:00:00","2019-06-25",32,0,0,15,1,48
"Croydon","14:00:00","2019-06-25",710,16,2,190,35,953
"Ealing","14:00:00","2019-06-25",31,0,0,3,0,34
"Kingston upon Thames","14:00:00","2019-06-25",5244,62,27,1264,389,6986
"Lewisham","14:00:00","2019-06-25",337,12,10,106,5,470
"Newham","14:00:00","2019-06-25",221,5,0,20,1,247
"Southwark","14:00:00","2019-06-25",370,32,30,114,4,550
"Sutton","14:00:00","2019-06-25",947,15,19,133,33,1147
"Bexley","15:00:00","2019-06-25",1492,17,44,474,48,2075
"Bromley","15:00:00","2019-06-25",48,0,0,6,0,54
"Croydon","15:00:00","2019-06-25",720,11,2,170,30,933
"Ealing","15:00:00","2019-06-25",28,0,0,1,0,29
"Kingston upon Thames","15:00:00","2019-06-25",6061,77,18,1453,298,7907
"Lewisham","15:00:00","2019-06-25",419,8,10,127,6,570
"Newham","15:00:00","2019-06-25",308,4,0,35,2,349
"Southwark","15:00:00","2019-06-25",441,36,34,130,2,643
"Sutton","15:00:00","2019-06-25",1046,10,20,145,23,1244
"Bexley","16:00:00","2019-06-25",1757,18,37,353,34,2199
"Bromley","16:00:00","2019-06-25",61,1,0,11,0,73
"Croydon","16:00:00","2019-06-25",672,18,3,142,28,863
"Ealing","16:00:00","2019-06-25",49,2,2,5,0,58
"Kingston upon Thames","16:00:00","2019-06-25",7019,131,29,1469,196,8844
"Lewisham","16:00:00","2019-06-25",486,6,14,123,2,631
"Newham","16:00:00","2019-06-25",244,0,0,25,5,274
"Southwark","16:00:00","2019-06-25",460,52,31,155,3,701
"Sutton","16:00:00","2019-06-25",1153,16,19,183,16,1387
"Bexley","17:00:00","2019-06-25",1797,17,32,318,22,2186
"Bromley","17:00:00","2019-06-25",65,1,0,11,0,77
"Croydon","17:00:00","2019-06-25",502,23,1,98,9,633
"Ealing","17:00:00","2019-06-25",33,4,0,4,0,41
"Kingston upon Thames","17:00:00","2019-06-25",7799,168,25,1045,123,9160
"Lewisham","17:00:00","2019-06-25",415,12,6,82,2,517
"Newham","17:00:00","2019-06-25",220,6,0,29,0,255
"Southwark","17:00:00","2019-06-25",536,71,31,117,1,756
"Sutton","17:00:00","2019-06-25",1181,30,19,149,9,1388
"Bexley","18:00:00","2019-06-25",1569,21,29,282,26,1927
"Bromley","18:00:00","2019-06-25",67,0,0,11,0,78
"Croydon","18:00:00","2019-06-25",467,18,2,139,19,645
"Ealing","18:00:00","2019-06-25",33,5,0,6,0,44
"Kingston upon Thames","18:00:00","2019-06-25",7457,181,10,701,99,8448
"Lewisham","18:00:00","2019-06-25",482,10,11,48,0,551
"Newham","18:00:00","2019-06-25",194,3,0,19,1,217
"Southwark","18:00:00","2019-06-25",534,81,33,73,2,723
"Sutton","18:00:00","2019-06-25",1056,30,19,101,12,1218
"Barnet","07:00:00","2019-06-26",64,0,0,8,1,73
"Bexley","07:00:00","2019-06-26",16,0,0,7,0,23
"Camden","07:00:00","2019-06-26",240,61,49,200,24,574
"Enfield","07:00:00","2019-06-26",237,6,2,87,19,351
"Kensington and Chelsea","07:00:00","2019-06-26",106,6,0,44,4,160
"Lewisham","07:00:00","2019-06-26",372,9,2,90,2,475
"Waltham Forest","07:00:00","2019-06-26",87,4,0,12,0,103
"Barnet","08:00:00","2019-06-26",113,0,0,12,2,127
"Bexley","08:00:00","2019-06-26",17,1,0,4,0,22
"Camden","08:00:00","2019-06-26",263,49,59,173,20,564
"Enfield","08:00:00","2019-06-26",316,4,1,74,21,416
"Kensington and Chelsea","08:00:00","2019-06-26",158,4,0,40,7,209
"Lewisham","08:00:00","2019-06-26",684,6,2,95,3,790
"Waltham Forest","08:00:00","2019-06-26",235,3,0,12,0,250
"Barnet","09:00:00","2019-06-26",70,0,0,17,0,87
"Bexley","09:00:00","2019-06-26",13,1,1,2,0,17
"Camden","09:00:00","2019-06-26",261,41,66,111,14,493
"Enfield","09:00:00","2019-06-26",243,7,1,49,31,331
"Kensington and Chelsea","09:00:00","2019-06-26",102,4,0,47,3,156
"Lewisham","09:00:00","2019-06-26",435,7,0,75,8,525
"Waltham Forest","09:00:00","2019-06-26",94,0,0,31,0,125
"Barnet","10:00:00","2019-06-26",60,0,0,10,2,72
"Bexley","10:00:00","2019-06-26",7,0,0,4,2,13
"Camden","10:00:00","2019-06-26",267,28,59,139,14,507
"Enfield","10:00:00","2019-06-26",233,1,0,43,26,303
"Kensington and Chelsea","10:00:00","2019-06-26",107,5,0,45,5,162
"Lewisham","10:00:00","2019-06-26",295,6,0,58,5,364
"Waltham Forest","10:00:00","2019-06-26",62,2,0,18,3,85
"Barnet","11:00:00","2019-06-26",47,0,0,7,0,54
"Bexley","11:00:00","2019-06-26",16,0,0,7,0,23
"Camden","11:00:00","2019-06-26",267,25,53,128,18,491
"Enfield","11:00:00","2019-06-26",291,7,0,67,34,399
"Kensington and Chelsea","11:00:00","2019-06-26",111,4,0,49,6,170
"Lewisham","11:00:00","2019-06-26",296,4,0,65,7,372
"Waltham Forest","11:00:00","2019-06-26",75,1,0,16,1,93
"Barnet","12:00:00","2019-06-26",67,0,0,10,1,78
"Bexley","12:00:00","2019-06-26",8,0,0,3,0,11
"Camden","12:00:00","2019-06-26",299,67,49,122,15,552
"Enfield","12:00:00","2019-06-26",277,2,1,71,18,369
"Kensington and Chelsea","12:00:00","2019-06-26",113,9,1,50,6,179
"Lewisham","12:00:00","2019-06-26",334,9,0,58,11,412
"Waltham Forest","12:00:00","2019-06-26",53,2,0,14,0,69
"Barnet","13:00:00","2019-06-26",57,0,0,8,1,66
"Bexley","13:00:00","2019-06-26",15,0,2,0,1,18
"Camden","13:00:00","2019-06-26",265,51,50,128,9,503
"Enfield","13:00:00","2019-06-26",262,14,0,58,27,361
"Kensington and Chelsea","13:00:00","2019-06-26",99,10,0,45,5,159
"Lewisham","13:00:00","2019-06-26",342,7,0,68,6,423
"Waltham Forest","13:00:00","2019-06-26",59,0,0,19,0,78
"Barnet","14:00:00","2019-06-26",62,0,1,7,0,70
"Bexley","14:00:00","2019-06-26",21,0,1,4,0,26
"Camden","14:00:00","2019-06-26",276,65,47,128,16,532
"Enfield","14:00:00","2019-06-26",267,2,0,64,16,349
"Kensington and Chelsea","14:00:00","2019-06-26",114,15,0,34,1,164
"Lewisham","14:00:00","2019-06-26",397,6,0,85,2,490
"Waltham Forest","14:00:00","2019-06-26",77,3,0,8,0,88
"Barnet","15:00:00","2019-06-26",87,0,0,20,0,107
"Bexley","15:00:00","2019-06-26",23,1,0,5,0,29
"Camden","15:00:00","2019-06-26",346,46,39,98,8,537
"Enfield","15:00:00","2019-06-26",298,8,0,55,21,382
"Kensington and Chelsea","15:00:00","2019-06-26",147,13,0,41,3,204
"Lewisham","15:00:00","2019-06-26",427,5,2,95,8,537
"Waltham Forest","15:00:00","2019-06-26",146,1,0,18,0,165
"Barnet","16:00:00","2019-06-26",62,1,0,13,0,76
"Bexley","16:00:00","2019-06-26",20,2,2,5,0,29
"Camden","16:00:00","2019-06-26",335,70,46,117,5,573
"Enfield","16:00:00","2019-06-26",285,3,0,67,15,370
"Kensington and Chelsea","16:00:00","2019-06-26",174,21,0,53,0,248
"Lewisham","16:00:00","2019-06-26",496,9,2,101,5,613
"Waltham Forest","16:00:00","2019-06-26",99,2,0,17,0,118
"Barnet","17:00:00","2019-06-26",89,0,0,11,0,100
"Bexley","17:00:00","2019-06-26",20,0,0,1,0,21
"Camden","17:00:00","2019-06-26",324,74,47,76,3,524
"Enfield","17:00:00","2019-06-26",320,8,0,58,8,394
"Kensington and Chelsea","17:00:00","2019-06-26",184,23,0,56,1,264
"Lewisham","17:00:00","2019-06-26",526,13,0,76,1,616
"Waltham Forest","17:00:00","2019-06-26",103,1,0,24,0,128
"Barnet","18:00:00","2019-06-26",80,0,0,10,0,90
"Bexley","18:00:00","2019-06-26",28,0,0,6,1,35
"Camden","18:00:00","2019-06-26",360,67,42,65,3,537
"Enfield","18:00:00","2019-06-26",227,3,0,28,9,267
"Kensington and Chelsea","18:00:00","2019-06-26",213,17,0,27,1,258
"Lewisham","18:00:00","2019-06-26",462,10,0,46,0,518
"Waltham Forest","18:00:00","2019-06-26",109,3,0,9,0,121
"Brent","07:00:00","2019-06-27",34,1,0,11,1,47
"Ealing","07:00:00","2019-06-27",478,35,21,258,104,896
"Greenwich","07:00:00","2019-06-27",146,1,12,17,3,179
"Hillingdon","07:00:00","2019-06-27",12,0,0,1,2,15
"Merton","07:00:00","2019-06-27",144,5,0,32,0,181
"Sutton","07:00:00","2019-06-27",495,12,9,103,5,624
"Wandsworth","07:00:00","2019-06-27",808,62,1,289,15,1175
"Brent","08:00:00","2019-06-27",50,0,0,7,1,58
"Ealing","08:00:00","2019-06-27",584,29,23,250,70,956
"Greenwich","08:00:00","2019-06-27",243,1,10,37,11,302
"Hillingdon","08:00:00","2019-06-27",18,0,0,2,0,20
"Merton","08:00:00","2019-06-27",215,3,0,32,0,250
"Sutton","08:00:00","2019-06-27",487,15,9,64,6,581
"Wandsworth","08:00:00","2019-06-27",817,102,3,270,14,1206
"Brent","09:00:00","2019-06-27",24,0,0,7,0,31
"Ealing","09:00:00","2019-06-27",477,33,34,231,68,843
"Greenwich","09:00:00","2019-06-27",217,0,13,38,6,274
"Hillingdon","09:00:00","2019-06-27",6,0,0,0,0,6
"Merton","09:00:00","2019-06-27",159,5,0,22,0,186
"Sutton","09:00:00","2019-06-27",430,3,7,87,5,532
"Wandsworth","09:00:00","2019-06-27",759,61,2,255,6,1083
"Brent","10:00:00","2019-06-27",27,0,0,3,0,30
"Ealing","10:00:00","2019-06-27",542,37,25,235,69,908
"Greenwich","10:00:00","2019-06-27",184,2,10,37,5,238
"Hillingdon","10:00:00","2019-06-27",10,0,0,7,0,17
"Merton","10:00:00","2019-06-27",79,3,0,12,0,94
"Sutton","10:00:00","2019-06-27",382,1,7,55,5,450
"Wandsworth","10:00:00","2019-06-27",720,64,2,292,16,1094
"Brent","11:00:00","2019-06-27",29,0,0,3,0,32
"Ealing","11:00:00","2019-06-27",512,54,24,215,89,894
"Greenwich","11:00:00","2019-06-27",192,3,10,24,2,231
"Hillingdon","11:00:00","2019-06-27",7,0,0,5,0,12
"Kingston upon Thames","11:00:00","2019-06-27",7124,147,25,1692,483,9471
"Merton","11:00:00","2019-06-27",86,1,0,17,0,104
"Sutton","11:00:00","2019-06-27",419,5,7,81,9,521
"Wandsworth","11:00:00","2019-06-27",762,47,2,325,12,1148
"Brent","12:00:00","2019-06-27",25,0,0,4,0,29
"Ealing","12:00:00","2019-06-27",555,37,27,218,66,903
"Greenwich","12:00:00","2019-06-27",233,4,10,38,5,290
"Hillingdon","12:00:00","2019-06-27",11,0,0,3,0,14
"Kingston upon Thames","12:00:00","2019-06-27",7120,144,32,1766,502,9564
"Merton","12:00:00","2019-06-27",76,1,0,16,0,93
"Sutton","12:00:00","2019-06-27",468,10,10,71,4,563
"Wandsworth","12:00:00","2019-06-27",734,63,0,320,15,1132
"Brent","13:00:00","2019-06-27",36,0,0,3,0,39
"Ealing","13:00:00","2019-06-27",446,49,17,210,61,783
"Greenwich","13:00:00","2019-06-27",190,8,12,45,6,261
"Hillingdon","13:00:00","2019-06-27",9,0,0,1,0,10
"Merton","13:00:00","2019-06-27",97,3,0,18,4,122
"Sutton","13:00:00","2019-06-27",350,5,7,61,2,425
"Wandsworth","13:00:00","2019-06-27",799,56,0,316,14,1185
"Brent","14:00:00","2019-06-27",31,0,0,5,0,36
"Ealing","14:00:00","2019-06-27",552,46,28,208,52,886
"Greenwich","14:00:00","2019-06-27",218,6,11,41,5,281
"Hillingdon","14:00:00","2019-06-27",16,0,0,5,0,21
"Merton","14:00:00","2019-06-27",130,10,0,28,0,168
"Sutton","14:00:00","2019-06-27",407,4,8,81,2,502
"Wandsworth","14:00:00","2019-06-27",834,63,5,349,19,1270
"Brent","15:00:00","2019-06-27",55,0,0,8,1,64
"Ealing","15:00:00","2019-06-27",651,44,25,188,52,960
"Greenwich","15:00:00","2019-06-27",253,5,11,35,3,307
"Hillingdon","15:00:00","2019-06-27",13,0,0,2,0,15
"Merton","15:00:00","2019-06-27",140,3,0,24,0,167
"Sutton","15:00:00","2019-06-27",513,8,9,67,1,598
"Wandsworth","15:00:00","2019-06-27",932,64,0,302,9,1307
"Brent","16:00:00","2019-06-27",42,0,0,11,0,53
"Ealing","16:00:00","2019-06-27",672,45,24,187,44,972
"Greenwich","16:00:00","2019-06-27",281,3,8,34,1,327
"Hillingdon","16:00:00","2019-06-27",8,0,0,4,0,12
"Merton","16:00:00","2019-06-27",174,4,0,36,0,214
"Sutton","16:00:00","2019-06-27",574,10,6,77,1,668
"Wandsworth","16:00:00","2019-06-27",863,104,3,276,3,1249
"Brent","17:00:00","2019-06-27",49,0,0,12,0,61
"Ealing","17:00:00","2019-06-27",781,71,21,161,21,1055
"Greenwich","17:00:00","2019-06-27",252,11,10,29,1,303
"Hillingdon","17:00:00","2019-06-27",22,0,0,6,0,28
"Merton","17:00:00","2019-06-27",184,11,0,49,0,244
"Sutton","17:00:00","2019-06-27",561,11,10,75,1,658
"Wandsworth","17:00:00","2019-06-27",1018,147,2,227,1,1395
"Brent","18:00:00","2019-06-27",57,1,0,10,0,68
"Ealing","18:00:00","2019-06-27",750,44,31,103,10,938
"Greenwich","18:00:00","2019-06-27",268,5,9,17,0,299
"Hillingdon","18:00:00","2019-06-27",11,0,0,1,0,12
"Merton","18:00:00","2019-06-27",186,11,0,25,0,222
"Sutton","18:00:00","2019-06-27",504,8,7,36,1,556
"Wandsworth","18:00:00","2019-06-27",975,145,0,173,1,1294
"Bexley","07:00:00","2019-06-28",27,1,0,6,1,35
"Ealing","07:00:00","2019-06-28",957,24,1,182,3,1167
"Greenwich","07:00:00","2019-06-28",1697,40,80,444,63,2324
"Lewisham","07:00:00","2019-06-28",578,7,35,92,17,729
"Newham","07:00:00","2019-06-28",1313,17,75,259,39,1703
"Richmond upon Thames","07:00:00","2019-06-28",37,1,1,12,0,51
"Waltham Forest","07:00:00","2019-06-28",21,0,0,7,0,28
"Bexley","08:00:00","2019-06-28",47,0,0,4,0,51
"Ealing","08:00:00","2019-06-28",1056,14,1,134,6,1211
"Greenwich","08:00:00","2019-06-28",1670,41,81,363,68,2223
"Lewisham","08:00:00","2019-06-28",673,9,34,113,10,839
"Newham","08:00:00","2019-06-28",1826,13,61,260,33,2193
"Richmond upon Thames","08:00:00","2019-06-28",68,2,0,16,0,86
"Waltham Forest","08:00:00","2019-06-28",35,0,0,3,1,39
"Bexley","09:00:00","2019-06-28",48,0,0,14,1,63
"Ealing","09:00:00","2019-06-28",737,12,2,150,1,902
"Greenwich","09:00:00","2019-06-28",1523,20,78,350,66,2037
"Lewisham","09:00:00","2019-06-28",623,7,35,114,17,796
"Newham","09:00:00","2019-06-28",1339,18,80,311,48,1796
"Richmond upon Thames","09:00:00","2019-06-28",51,0,0,9,0,60
"Waltham Forest","09:00:00","2019-06-28",24,0,0,5,0,29
"Bexley","10:00:00","2019-06-28",35,0,0,4,2,41
"Ealing","10:00:00","2019-06-28",601,10,0,123,5,739
"Greenwich","10:00:00","2019-06-28",1291,24,79,421,65,1880
"Lewisham","10:00:00","2019-06-28",604,8,37,122,15,786
"Newham","10:00:00","2019-06-28",1569,29,74,248,46,1966
"Richmond upon Thames","10:00:00","2019-06-28",34,1,0,4,0,39
"Waltham Forest","10:00:00","2019-06-28",12,1,0,4,0,17
"Bexley","11:00:00","2019-06-28",27,0,0,6,0,33
"Ealing","11:00:00","2019-06-28",675,11,0,105,2,793
"Greenwich","11:00:00","2019-06-28",1381,26,66,395,69,1937
"Lewisham","11:00:00","2019-06-28",651,8,35,129,17,840
"Newham","11:00:00","2019-06-28",1664,29,92,229,37,2051
"Richmond upon Thames","11:00:00","2019-06-28",23,1,0,16,0,40
"Waltham Forest","11:00:00","2019-06-28",20,0,1,11,0,32
"Bexley","12:00:00","2019-06-28",41,1,0,6,0,48
"Ealing","12:00:00","2019-06-28",722,6,0,139,3,870
"Greenwich","12:00:00","2019-06-28",1551,39,70,386,66,2112
"Lewisham","12:00:00","2019-06-28",647,15,35,149,14,860
"Newham","12:00:00","2019-06-28",1550,31,86,282,27,1976
"Richmond upon Thames","12:00:00","2019-06-28",37,1,0,8,0,46
"Waltham Forest","12:00:00","2019-06-28",25,1,0,7,0,33
"Bexley","13:00:00","2019-06-28",28,0,0,7,0,35
"Ealing","13:00:00","2019-06-28",787,12,2,138,5,944
"Greenwich","13:00:00","2019-06-28",1530,31,72,373,64,2070
"Lewisham","13:00:00","2019-06-28",836,19,36,141,21,1053
"Newham","13:00:00","2019-06-28",1627,25,96,201,43,1992
"Richmond upon Thames","13:00:00","2019-06-28",39,7,0,12,1,59
"Waltham Forest","13:00:00","2019-06-28",32,0,0,4,0,36
"Bexley","14:00:00","2019-06-28",31,2,0,3,0,36
"Ealing","14:00:00","2019-06-28",881,8,0,149,2,1040
"Greenwich","14:00:00","2019-06-28",1697,40,76,380,44,2237
"Lewisham","14:00:00","2019-06-28",703,11,30,154,19,917
"Newham","14:00:00","2019-06-28",1639,30,90,208,28,1995
"Richmond upon Thames","14:00:00","2019-06-28",33,3,0,7,0,43
"Waltham Forest","14:00:00","2019-06-28",29,0,0,9,0,38
"Bexley","15:00:00","2019-06-28",53,1,0,10,0,64
"Ealing","15:00:00","2019-06-28",940,7,1,170,2,1120
"Greenwich","15:00:00","2019-06-28",1750,30,62,362,56,2260
"Lewisham","15:00:00","2019-06-28",843,16,36,153,12,1060
"Newham","15:00:00","2019-06-28",1648,45,81,175,39,1988
"Richmond upon Thames","15:00:00","2019-06-28",45,0,0,7,0,52
"Waltham Forest","15:00:00","2019-06-28",45,1,0,8,0,54
"Bexley","16:00:00","2019-06-28",38,2,0,7,0,47
"Ealing","16:00:00","2019-06-28",1009,24,0,154,3,1190
"Greenwich","16:00:00","2019-06-28",1921,70,69,383,74,2517
"Lewisham","16:00:00","2019-06-28",1025,12,45,141,14,1237
"Newham","16:00:00","2019-06-28",1991,40,83,202,27,2343
"Richmond upon Thames","16:00:00","2019-06-28",45,1,0,6,0,52
"Waltham Forest","16:00:00","2019-06-28",49,1,0,7,0,57
"Bexley","17:00:00","2019-06-28",42,2,0,7,0,51
"Ealing","17:00:00","2019-06-28",1019,17,2,136,0,1174
"Greenwich","17:00:00","2019-06-28",1594,60,70,314,80,2118
"Lewisham","17:00:00","2019-06-28",1075,31,34,135,7,1282
"Newham","17:00:00","2019-06-28",1862,31,77,193,17,2180
"Richmond upon Thames","17:00:00","2019-06-28",59,3,0,1,0,63
"Waltham Forest","17:00:00","2019-06-28",55,3,0,4,0,62
"Bexley","18:00:00","2019-06-28",38,0,0,5,0,43
"Ealing","18:00:00","2019-06-28",942,18,0,103,0,1063
"Greenwich","18:00:00","2019-06-28",1555,54,70,260,39,1978
"Lewisham","18:00:00","2019-06-28",1068,27,33,110,7,1245
"Newham","18:00:00","2019-06-28",1789,28,63,150,4,2034
"Richmond upon Thames","18:00:00","2019-06-28",55,3,0,8,0,66
"Waltham Forest","18:00:00","2019-06-28",44,3,0,2,0,49
"Barnet","07:00:00","2019-07-01",2585,103,47,779,142,3656
"Bromley","07:00:00","2019-07-01",181,1,13,39,3,237
"Croydon","07:00:00","2019-07-01",31,0,0,4,1,36
"Hillingdon","07:00:00","2019-07-01",244,2,13,38,3,300
"Lambeth","07:00:00","2019-07-01",364,28,103,132,13,640
"Lewisham","07:00:00","2019-07-01",54,0,0,5,0,59
"Redbridge","07:00:00","2019-07-01",881,5,10,124,1,1021
"Barnet","08:00:00","2019-07-01",2827,78,42,590,132,3669
"Bromley","08:00:00","2019-07-01",214,1,11,36,4,266
"Croydon","08:00:00","2019-07-01",60,0,0,7,1,68
"Hillingdon","08:00:00","2019-07-01",421,3,14,30,2,470
"Lambeth","08:00:00","2019-07-01",378,24,106,103,16,627
"Lewisham","08:00:00","2019-07-01",86,0,2,7,1,96
"Redbridge","08:00:00","2019-07-01",1063,8,10,119,5,1205
"Barnet","09:00:00","2019-07-01",2617,51,49,659,176,3552
"Bromley","09:00:00","2019-07-01",181,0,9,17,4,211
"Croydon","09:00:00","2019-07-01",38,0,1,4,0,43
"Hillingdon","09:00:00","2019-07-01",268,1,11,40,6,326
"Lambeth","09:00:00","2019-07-01",357,26,91,127,23,624
"Lewisham","09:00:00","2019-07-01",51,2,0,9,0,62
"Redbridge","09:00:00","2019-07-01",913,12,14,160,14,1113
"Barnet","10:00:00","2019-07-01",2485,35,46,586,196,3348
"Bromley","10:00:00","2019-07-01",147,0,11,22,2,182
"Croydon","10:00:00","2019-07-01",33,1,0,7,0,41
"Hillingdon","10:00:00","2019-07-01",232,0,13,32,1,278
"Lambeth","10:00:00","2019-07-01",314,25,81,102,23,545
"Lewisham","10:00:00","2019-07-01",48,1,0,18,0,67
"Redbridge","10:00:00","2019-07-01",803,6,10,135,16,970
"Barnet","11:00:00","2019-07-01",2602,34,36,593,230,3495
"Bromley","11:00:00","2019-07-01",137,1,11,21,4,174
"Croydon","11:00:00","2019-07-01",28,0,0,3,1,32
"Hillingdon","11:00:00","2019-07-01",248,1,11,28,5,293
"Lambeth","11:00:00","2019-07-01",397,19,80,134,20,650
"Lewisham","11:00:00","2019-07-01",54,1,0,17,0,72
"Redbridge","11:00:00","2019-07-01",792,7,12,127,16,954
"Barnet","12:00:00","2019-07-01",2575,49,37,682,195,3538
"Bromley","12:00:00","2019-07-01",149,3,10,28,7,197
"Croydon","12:00:00","2019-07-01",26,0,0,6,2,34
"Hillingdon","12:00:00","2019-07-01",338,1,14,30,8,391
"Lambeth","12:00:00","2019-07-01",401,22,85,111,12,631
"Lewisham","12:00:00","2019-07-01",53,1,0,15,0,69
"Redbridge","12:00:00","2019-07-01",851,9,10,107,11,988
"Barnet","13:00:00","2019-07-01",2484,52,37,586,152,3311
"Bromley","13:00:00","2019-07-01",150,0,9,18,3,180
"Croydon","13:00:00","2019-07-01",33,0,0,7,0,40
"Hillingdon","13:00:00","2019-07-01",287,1,11,31,2,332
"Lambeth","13:00:00","2019-07-01",415,30,87,131,13,676
"Lewisham","13:00:00","2019-07-01",58,4,0,10,0,72
"Redbridge","13:00:00","2019-07-01",761,12,11,133,12,929
"Barnet","14:00:00","2019-07-01",2785,41,33,644,147,3650
"Bromley","14:00:00","2019-07-01",168,3,14,19,0,204
"Croydon","14:00:00","2019-07-01",43,0,0,4,1,48
"Hillingdon","14:00:00","2019-07-01",256,2,12,38,2,310
"Lambeth","14:00:00","2019-07-01",476,34,71,112,13,706
"Lewisham","14:00:00","2019-07-01",57,4,0,14,2,77
"Redbridge","14:00:00","2019-07-01",745,3,12,119,8,887
"Barnet","15:00:00","2019-07-01",2868,58,35,549,105,3615
"Bromley","15:00:00","2019-07-01",174,3,9,18,1,205
"Croydon","15:00:00","2019-07-01",37,0,0,6,1,44
"Hillingdon","15:00:00","2019-07-01",374,7,12,27,0,420
"Lambeth","15:00:00","2019-07-01",529,18,87,158,14,806
"Lewisham","15:00:00","2019-07-01",101,6,1,19,1,128
"Redbridge","15:00:00","2019-07-01",1083,16,11,111,8,1229
"Barnet","16:00:00","2019-07-01",2973,86,52,704,96,3911
"Bromley","16:00:00","2019-07-01",171,2,12,13,2,200
"Croydon","16:00:00","2019-07-01",41,0,2,7,3,53
"Hillingdon","16:00:00","2019-07-01",319,3,12,33,3,370
"Lambeth","16:00:00","2019-07-01",570,41,89,151,7,858
"Lewisham","16:00:00","2019-07-01",66,2,1,9,0,78
"Redbridge","16:00:00","2019-07-01",1045,10,12,100,5,1172
"Barnet","17:00:00","2019-07-01",3320,96,37,688,58,4199
"Bromley","17:00:00","2019-07-01",172,1,12,24,1,210
"Croydon","17:00:00","2019-07-01",26,1,0,4,5,36
"Hillingdon","17:00:00","2019-07-01",340,3,13,33,2,391
"Lambeth","17:00:00","2019-07-01",589,68,79,124,2,862
"Lewisham","17:00:00","2019-07-01",67,4,0,7,0,78
"Redbridge","17:00:00","2019-07-01",1022,11,10,90,3,1136
"Barnet","18:00:00","2019-07-01",2960,87,33,537,49,3666
"Bromley","18:00:00","2019-07-01",135,3,8,16,0,162
"Croydon","18:00:00","2019-07-01",31,1,0,3,1,36
"Hillingdon","18:00:00","2019-07-01",338,3,13,26,1,381
"Lambeth","18:00:00","2019-07-01",657,70,78,91,1,897
"Lewisham","18:00:00","2019-07-01",71,4,0,8,0,83
"Redbridge","18:00:00","2019-07-01",943,9,10,82,1,1045
"Barnet","07:00:00","2019-07-02",3039,165,18,1314,372,4908
"Bromley","07:00:00","2019-07-02",165,4,0,36,0,205
"Camden","07:00:00","2019-07-02",422,54,15,219,43,753
"Croydon","07:00:00","2019-07-02",256,5,0,38,2,301
"Ealing","07:00:00","2019-07-02",5396,171,20,1380,499,7466
"Greenwich","07:00:00","2019-07-02",1537,86,53,470,124,2270
"Hillingdon","07:00:00","2019-07-02",272,7,0,47,2,328
"Newham","07:00:00","2019-07-02",4601,362,22,1766,549,7300
"Sutton","07:00:00","2019-07-02",17,0,0,2,1,20
"Tower Hamlets","07:00:00","2019-07-02",1991,422,52,1014,416,3895
"Waltham Forest","07:00:00","2019-07-02",942,22,16,338,45,1363
"Wandsworth","07:00:00","2019-07-02",330,19,0,156,3,508
"Barnet","08:00:00","2019-07-02",3560,114,25,1004,344,5047
"Bromley","08:00:00","2019-07-02",214,0,0,24,0,238
"Camden","08:00:00","2019-07-02",466,57,12,208,23,766
"Croydon","08:00:00","2019-07-02",332,4,0,37,2,375
"Ealing","08:00:00","2019-07-02",5380,119,23,1039,554,7115
"Greenwich","08:00:00","2019-07-02",1720,52,42,528,102,2444
"Hillingdon","08:00:00","2019-07-02",289,0,1,39,1,330
"Newham","08:00:00","2019-07-02",5056,266,19,1382,590,7313
"Sutton","08:00:00","2019-07-02",22,0,0,2,0,24
"Tower Hamlets","08:00:00","2019-07-02",2193,342,59,906,450,3950
"Waltham Forest","08:00:00","2019-07-02",883,15,10,246,53,1207
"Wandsworth","08:00:00","2019-07-02",332,13,1,119,4,469
"Barnet","09:00:00","2019-07-02",3045,73,41,990,431,4580
"Bromley","09:00:00","2019-07-02",135,0,2,20,1,158
"Camden","09:00:00","2019-07-02",458,48,15,177,20,718
"Croydon","09:00:00","2019-07-02",187,0,0,28,3,218
"Ealing","09:00:00","2019-07-02",4607,66,38,1078,648,6437
"Greenwich","09:00:00","2019-07-02",1458,36,57,507,112,2170
"Hillingdon","09:00:00","2019-07-02",344,2,2,37,2,387
"Newham","09:00:00","2019-07-02",4577,109,37,1445,763,6931
"Sutton","09:00:00","2019-07-02",15,1,0,1,0,17
"Tower Hamlets","09:00:00","2019-07-02",2088,197,40,928,481,3734
"Waltham Forest","09:00:00","2019-07-02",635,15,15,204,62,931
"Wandsworth","09:00:00","2019-07-02",301,18,0,130,11,460
"Barnet","10:00:00","2019-07-02",2943,57,18,1064,427,4509
"Bromley","10:00:00","2019-07-02",82,0,0,19,2,103
"Camden","10:00:00","2019-07-02",446,23,15,197,24,705
"Croydon","10:00:00","2019-07-02",103,6,0,22,4,135
"Ealing","10:00:00","2019-07-02",3993,67,41,1084,647,5832
"Greenwich","10:00:00","2019-07-02",1233,25,47,550,124,1979
"Hillingdon","10:00:00","2019-07-02",370,0,0,45,4,419
"Newham","10:00:00","2019-07-02",4226,94,22,1515,767,6624
"Sutton","10:00:00","2019-07-02",10,0,0,4,0,14
"Tower Hamlets","10:00:00","2019-07-02",2004,139,31,908,500,3582
"Waltham Forest","10:00:00","2019-07-02",509,10,11,189,70,789
"Wandsworth","10:00:00","2019-07-02",362,13,0,124,6,505
"Barnet","11:00:00","2019-07-02",2943,50,17,955,456,4421
"Bromley","11:00:00","2019-07-02",92,2,1,17,0,112
"Camden","11:00:00","2019-07-02",420,31,14,199,18,682
"Croydon","11:00:00","2019-07-02",112,5,0,27,3,147
"Ealing","11:00:00","2019-07-02",3948,63,25,1148,676,5860
"Greenwich","11:00:00","2019-07-02",1238,35,48,481,131,1933
"Hillingdon","11:00:00","2019-07-02",326,2,0,46,2,376
"Newham","11:00:00","2019-07-02",3798,74,10,1462,791,6135
"Sutton","11:00:00","2019-07-02",11,0,0,3,0,14
"Tower Hamlets","11:00:00","2019-07-02",1911,125,21,910,479,3446
"Waltham Forest","11:00:00","2019-07-02",455,14,10,161,72,712
"Wandsworth","11:00:00","2019-07-02",343,22,0,162,10,537
"Barnet","12:00:00","2019-07-02",3019,57,22,996,418,4512
"Bromley","12:00:00","2019-07-02",105,1,0,27,2,135
"Camden","12:00:00","2019-07-02",415,40,13,151,22,641
"Croydon","12:00:00","2019-07-02",116,1,0,24,1,142
"Ealing","12:00:00","2019-07-02",3839,50,28,1155,662,5734
"Greenwich","12:00:00","2019-07-02",1336,38,40,398,117,1929
"Hillingdon","12:00:00","2019-07-02",376,2,0,34,4,416
"Newham","12:00:00","2019-07-02",4162,68,7,1478,758,6473
"Sutton","12:00:00","2019-07-02",23,0,0,6,0,29
"Tower Hamlets","12:00:00","2019-07-02",2232,106,12,952,459,3761
"Waltham Forest","12:00:00","2019-07-02",517,10,12,165,65,769
"Wandsworth","12:00:00","2019-07-02",370,15,0,170,13,568
"Barnet","13:00:00","2019-07-02",3147,60,24,1069,457,4757
"Bromley","13:00:00","2019-07-02",82,0,3,27,1,113
"Camden","13:00:00","2019-07-02",430,41,13,152,24,660
"Croydon","13:00:00","2019-07-02",128,1,0,16,9,154
"Ealing","13:00:00","2019-07-02",3924,53,20,1204,669,5870
"Greenwich","13:00:00","2019-07-02",1319,37,42,431,124,1953
"Hillingdon","13:00:00","2019-07-02",329,0,0,37,3,369
"Newham","13:00:00","2019-07-02",4234,88,10,1451,792,6575
"Sutton","13:00:00","2019-07-02",17,0,0,3,0,20
"Tower Hamlets","13:00:00","2019-07-02",2135,123,11,1020,480,3769
"Waltham Forest","13:00:00","2019-07-02",552,14,11,148,47,772
"Wandsworth","13:00:00","2019-07-02",343,23,0,162,10,538
"Barnet","14:00:00","2019-07-02",3215,68,26,967,395,4671
"Bromley","14:00:00","2019-07-02",112,1,0,13,1,127
"Camden","14:00:00","2019-07-02",357,21,13,121,14,526
"Croydon","14:00:00","2019-07-02",148,2,0,21,3,174
"Ealing","14:00:00","2019-07-02",4280,52,27,1316,647,6322
"Greenwich","14:00:00","2019-07-02",1373,42,43,408,97,1963
"Hillingdon","14:00:00","2019-07-02",372,2,1,46,0,421
"Newham","14:00:00","2019-07-02",4735,130,36,1573,701,7175
"Sutton","14:00:00","2019-07-02",11,0,0,3,0,14
"Tower Hamlets","14:00:00","2019-07-02",2349,169,26,1075,459,4078
"Waltham Forest","14:00:00","2019-07-02",659,18,9,204,46,936
"Wandsworth","14:00:00","2019-07-02",384,21,0,151,8,564
"Barnet","15:00:00","2019-07-02",3605,83,36,1071,281,5076
"Bromley","15:00:00","2019-07-02",159,2,0,14,0,175
"Camden","15:00:00","2019-07-02",505,29,14,126,2,676
"Croydon","15:00:00","2019-07-02",216,6,0,28,3,253
"Ealing","15:00:00","2019-07-02",4980,107,32,1418,567,7104
"Greenwich","15:00:00","2019-07-02",1558,53,56,393,88,2148
"Hillingdon","15:00:00","2019-07-02",404,3,2,49,2,460
"Newham","15:00:00","2019-07-02",4957,163,12,1726,562,7420
"Sutton","15:00:00","2019-07-02",5,0,0,1,0,6
"Tower Hamlets","15:00:00","2019-07-02",2634,215,13,1140,350,4352
"Waltham Forest","15:00:00","2019-07-02",743,14,10,238,45,1050
"Wandsworth","15:00:00","2019-07-02",587,41,1,179,4,812
"Barnet","16:00:00","2019-07-02",3814,135,20,1129,281,5379
"Bromley","16:00:00","2019-07-02",172,0,0,17,2,191
"Camden","16:00:00","2019-07-02",488,38,12,131,5,674
"Croydon","16:00:00","2019-07-02",215,4,0,45,2,266
"Ealing","16:00:00","2019-07-02",6135,134,41,1445,417,8172
"Greenwich","16:00:00","2019-07-02",1614,63,49,371,68,2165
"Hillingdon","16:00:00","2019-07-02",373,5,0,54,0,432
"Newham","16:00:00","2019-07-02",5325,251,18,1507,304,7405
"Sutton","16:00:00","2019-07-02",6,0,0,0,0,6
"Tower Hamlets","16:00:00","2019-07-02",2684,301,39,1112,237,4373
"Waltham Forest","16:00:00","2019-07-02",970,17,9,260,39,1295
"Wandsworth","16:00:00","2019-07-02",454,56,1,177,1,689
"Barnet","17:00:00","2019-07-02",3748,145,23,795,115,4826
"Bromley","17:00:00","2019-07-02",177,2,0,16,0,195
"Camden","17:00:00","2019-07-02",445,36,12,68,3,564
"Croydon","17:00:00","2019-07-02",250,5,0,49,0,304
"Ealing","17:00:00","2019-07-02",6656,181,27,1179,301,8344
"Greenwich","17:00:00","2019-07-02",1562,65,47,368,44,2086
"Hillingdon","17:00:00","2019-07-02",391,5,0,32,0,428
"Newham","17:00:00","2019-07-02",5738,398,9,1174,209,7528
"Sutton","17:00:00","2019-07-02",19,0,0,5,0,24
"Tower Hamlets","17:00:00","2019-07-02",3125,475,61,872,146,4679
"Waltham Forest","17:00:00","2019-07-02",1131,29,16,186,15,1377
"Wandsworth","17:00:00","2019-07-02",498,64,0,122,2,686
"Barnet","18:00:00","2019-07-02",4405,119,21,728,129,5402
"Bromley","18:00:00","2019-07-02",121,2,0,12,0,135
"Camden","18:00:00","2019-07-02",562,58,17,62,3,702
"Croydon","18:00:00","2019-07-02",234,4,0,27,0,265
"Ealing","18:00:00","2019-07-02",6992,138,38,945,227,8340
"Greenwich","18:00:00","2019-07-02",1611,51,45,319,49,2075
"Hillingdon","18:00:00","2019-07-02",382,0,0,35,0,417
"Newham","18:00:00","2019-07-02",6105,315,18,884,199,7521
"Sutton","18:00:00","2019-07-02",5,0,0,2,0,7
"Tower Hamlets","18:00:00","2019-07-02",3407,430,41,654,142,4674
"Waltham Forest","18:00:00","2019-07-02",956,7,13,144,12,1132
"Wandsworth","18:00:00","2019-07-02",535,56,0,70,2,663
"Barking and Dagenham","07:00:00","2019-07-03",788,43,4,224,27,1086
"Barnet","07:00:00","2019-07-03",2245,35,15,413,58,2766
"Camden","07:00:00","2019-07-03",323,19,13,140,14,509
"Hackney","07:00:00","2019-07-03",455,53,118,233,47,906
"Havering","07:00:00","2019-07-03",197,2,0,50,3,252
"Newham","07:00:00","2019-07-03",5308,126,27,1581,659,7701
"Richmond upon Thames","07:00:00","2019-07-03",667,37,21,154,14,893
"Southwark","07:00:00","2019-07-03",10,0,0,8,1,19
"Waltham Forest","07:00:00","2019-07-03",827,22,27,236,56,1168
"Barking and Dagenham","08:00:00","2019-07-03",804,25,3,136,38,1006
"Barnet","08:00:00","2019-07-03",2235,28,20,321,56,2660
"Camden","08:00:00","2019-07-03",314,23,12,120,23,492
"Hackney","08:00:00","2019-07-03",461,55,100,226,65,907
"Havering","08:00:00","2019-07-03",339,9,0,42,3,393
"Newham","08:00:00","2019-07-03",5275,90,28,1244,616,7253
"Richmond upon Thames","08:00:00","2019-07-03",685,49,19,122,19,894
"Southwark","08:00:00","2019-07-03",12,0,0,13,1,26
"Waltham Forest","08:00:00","2019-07-03",721,12,26,212,68,1039
"Barking and Dagenham","09:00:00","2019-07-03",682,15,2,151,28,878
"Barnet","09:00:00","2019-07-03",1766,19,15,341,80,2221
"Camden","09:00:00","2019-07-03",429,33,15,117,30,624
"Hackney","09:00:00","2019-07-03",430,48,107,240,87,912
"Havering","09:00:00","2019-07-03",194,1,0,33,2,230
"Hounslow","09:00:00","2019-07-03",4230,76,111,730,318,5465
"Newham","09:00:00","2019-07-03",4575,61,28,1304,708,6676
"Richmond upon Thames","09:00:00","2019-07-03",623,30,19,131,27,830
"Southwark","09:00:00","2019-07-03",18,3,1,13,2,37
"Waltham Forest","09:00:00","2019-07-03",797,17,30,250,68,1162
"Barking and Dagenham","10:00:00","2019-07-03",630,9,1,167,28,835
"Barnet","10:00:00","2019-07-03",1552,8,7,302,74,1943
"Camden","10:00:00","2019-07-03",389,15,12,145,27,588
"Hackney","10:00:00","2019-07-03",484,40,104,213,89,930
"Havering","10:00:00","2019-07-03",154,0,0,25,8,187
"Hounslow","10:00:00","2019-07-03",4227,52,73,754,333,5439
"Newham","10:00:00","2019-07-03",4005,40,23,1310,884,6262
"Richmond upon Thames","10:00:00","2019-07-03",531,18,24,149,22,744
"Southwark","10:00:00","2019-07-03",14,0,0,11,1,26
"Waltham Forest","10:00:00","2019-07-03",730,14,27,263,79,1113
"Barking and Dagenham","11:00:00","2019-07-03",616,8,1,168,34,827
"Barnet","11:00:00","2019-07-03",1582,10,8,281,72,1953
"Camden","11:00:00","2019-07-03",360,12,10,165,18,565
"Hackney","11:00:00","2019-07-03",439,45,97,257,87,925
"Havering","11:00:00","2019-07-03",190,2,0,26,1,219
"Hounslow","11:00:00","2019-07-03",4205,29,66,779,305,5384
"Newham","11:00:00","2019-07-03",4043,37,11,1318,805,6214
"Richmond upon Thames","11:00:00","2019-07-03",507,21,21,153,33,735
"Southwark","11:00:00","2019-07-03",19,1,0,12,2,34
"Waltham Forest","11:00:00","2019-07-03",755,19,30,254,76,1134
"Barking and Dagenham","12:00:00","2019-07-03",627,5,0,176,23,831
"Barnet","12:00:00","2019-07-03",1487,17,10,286,52,1852
"Camden","12:00:00","2019-07-03",418,31,11,154,19,633
"Hackney","12:00:00","2019-07-03",443,51,84,235,60,873
"Havering","12:00:00","2019-07-03",182,1,0,30,3,216
"Hounslow","12:00:00","2019-07-03",4175,50,78,863,311,5477
"Newham","12:00:00","2019-07-03",4320,34,17,1309,797,6477
"Richmond upon Thames","12:00:00","2019-07-03",506,23,20,150,17,716
"Southwark","12:00:00","2019-07-03",11,3,0,10,1,25
"Waltham Forest","12:00:00","2019-07-03",780,18,29,241,72,1140
"Barking and Dagenham","13:00:00","2019-07-03",623,11,2,156,42,834
"Barnet","13:00:00","2019-07-03",1507,11,8,255,52,1833
"Camden","13:00:00","2019-07-03",431,42,13,160,22,668
"Hackney","13:00:00","2019-07-03",452,46,102,225,66,891
"Havering","13:00:00","2019-07-03",163,2,0,25,0,190
"Hounslow","13:00:00","2019-07-03",4328,41,63,857,332,5621
"Newham","13:00:00","2019-07-03",4524,47,15,1339,796,6721
"Richmond upon Thames","13:00:00","2019-07-03",488,29,18,132,15,682
"Southwark","13:00:00","2019-07-03",26,3,0,12,1,42
"Waltham Forest","13:00:00","2019-07-03",799,13,27,233,74,1146
"Barking and Dagenham","14:00:00","2019-07-03",705,15,4,141,18,883
"Barnet","14:00:00","2019-07-03",1650,13,9,289,67,2028
"Camden","14:00:00","2019-07-03",351,41,10,141,29,572
"Hackney","14:00:00","2019-07-03",455,53,82,200,55,845
"Havering","14:00:00","2019-07-03",205,2,0,46,3,256
"Hounslow","14:00:00","2019-07-03",4256,36,69,869,308,5538
"Newham","14:00:00","2019-07-03",4846,55,30,1394,762,7087
"Richmond upon Thames","14:00:00","2019-07-03",591,33,23,155,12,814
"Southwark","14:00:00","2019-07-03",17,9,0,11,0,37
"Waltham Forest","14:00:00","2019-07-03",837,16,25,215,69,1162
"Barking and Dagenham","15:00:00","2019-07-03",809,19,2,168,33,1031
"Barnet","15:00:00","2019-07-03",1605,22,18,353,95,2093
"Camden","15:00:00","2019-07-03",417,55,15,139,15,641
"Hackney","15:00:00","2019-07-03",545,74,96,212,36,963
"Havering","15:00:00","2019-07-03",266,1,0,34,1,302
"Hounslow","15:00:00","2019-07-03",4280,60,68,912,217,5537
"Newham","15:00:00","2019-07-03",5122,93,27,1480,622,7344
"Richmond upon Thames","15:00:00","2019-07-03",615,25,21,116,12,789
"Southwark","15:00:00","2019-07-03",19,1,0,6,1,27
"Waltham Forest","15:00:00","2019-07-03",838,30,27,185,68,1148
"Barking and Dagenham","16:00:00","2019-07-03",839,31,4,153,10,1037
"Barnet","16:00:00","2019-07-03",2104,24,19,291,44,2482
"Camden","16:00:00","2019-07-03",580,64,15,180,19,858
"Hackney","16:00:00","2019-07-03",591,80,108,200,29,1008
"Havering","16:00:00","2019-07-03",270,1,0,62,1,334
"Newham","16:00:00","2019-07-03",6098,124,20,1450,428,8120
"Richmond upon Thames","16:00:00","2019-07-03",692,33,19,134,9,887
"Southwark","16:00:00","2019-07-03",26,3,0,2,1,32
"Waltham Forest","16:00:00","2019-07-03",954,23,34,193,38,1242
"Barking and Dagenham","17:00:00","2019-07-03",805,27,1,132,13,978
"Barnet","17:00:00","2019-07-03",2474,28,12,351,21,2886
"Camden","17:00:00","2019-07-03",466,78,14,150,4,712
"Hackney","17:00:00","2019-07-03",694,95,93,171,16,1069
"Havering","17:00:00","2019-07-03",344,1,0,46,2,393
"Newham","17:00:00","2019-07-03",6238,148,15,1169,275,7845
"Richmond upon Thames","17:00:00","2019-07-03",806,44,21,101,2,974
"Southwark","17:00:00","2019-07-03",17,1,0,6,0,24
"Waltham Forest","17:00:00","2019-07-03",943,34,30,147,29,1183
"Barking and Dagenham","18:00:00","2019-07-03",870,33,2,90,10,1005
"Barnet","18:00:00","2019-07-03",2242,25,16,251,18,2552
"Camden","18:00:00","2019-07-03",751,88,10,125,3,977
"Hackney","18:00:00","2019-07-03",689,114,96,125,14,1038
"Havering","18:00:00","2019-07-03",304,2,0,27,0,333
"Hounslow","18:00:00","2019-07-03",4632,126,75,493,95,5421
"Newham","18:00:00","2019-07-03",6146,135,33,935,262,7511
"Richmond upon Thames","18:00:00","2019-07-03",727,41,19,94,6,887
"Southwark","18:00:00","2019-07-03",24,1,0,2,0,27
"Waltham Forest","18:00:00","2019-07-03",1065,27,29,124,28,1273
"Bexley","07:00:00","2019-07-04",894,21,10,230,31,1186
"Bromley","07:00:00","2019-07-04",885,6,8,259,15,1173
"Ealing","07:00:00","2019-07-04",5864,237,45,1583,597,8326
"Enfield","07:00:00","2019-07-04",2075,125,13,925,298,3436
"Greenwich","07:00:00","2019-07-04",57,1,12,4,0,74
"Harrow","07:00:00","2019-07-04",849,21,22,158,10,1060
"Hounslow","07:00:00","2019-07-04",3073,63,27,540,94,3797
"Kingston upon Thames","07:00:00","2019-07-04",102,2,0,17,0,121
"Lewisham","07:00:00","2019-07-04",598,5,16,129,4,752
"Redbridge","07:00:00","2019-07-04",25,2,0,4,0,31
"Bexley","08:00:00","2019-07-04",923,11,16,138,28,1116
"Bromley","08:00:00","2019-07-04",1077,11,5,189,22,1304
"Ealing","08:00:00","2019-07-04",5922,172,54,1360,665,8173
"Enfield","08:00:00","2019-07-04",2021,87,16,783,274,3181
"Greenwich","08:00:00","2019-07-04",110,2,13,16,1,142
"Harrow","08:00:00","2019-07-04",982,13,18,120,12,1145
"Hounslow","08:00:00","2019-07-04",3788,45,27,446,103,4409
"Kingston upon Thames","08:00:00","2019-07-04",143,0,0,15,0,158
"Lewisham","08:00:00","2019-07-04",783,10,18,125,4,940
"Redbridge","08:00:00","2019-07-04",19,0,0,3,0,22
"Bexley","09:00:00","2019-07-04",713,6,9,158,28,914
"Bromley","09:00:00","2019-07-04",709,6,8,100,13,836
"Ealing","09:00:00","2019-07-04",5115,112,74,1311,732,7344
"Enfield","09:00:00","2019-07-04",1892,44,10,791,251,2988
"Greenwich","09:00:00","2019-07-04",94,0,14,11,1,120
"Harrow","09:00:00","2019-07-04",805,17,20,128,23,993
"Hounslow","09:00:00","2019-07-04",2702,44,43,461,112,3362
"Kingston upon Thames","09:00:00","2019-07-04",112,7,0,11,1,131
"Lewisham","09:00:00","2019-07-04",612,8,15,105,16,756
"Redbridge","09:00:00","2019-07-04",18,0,0,6,0,24
"Bexley","10:00:00","2019-07-04",650,10,8,136,32,836
"Bromley","10:00:00","2019-07-04",508,7,6,79,19,619
"Ealing","10:00:00","2019-07-04",5199,90,58,1414,820,7581
"Enfield","10:00:00","2019-07-04",2035,44,19,761,302,3161
"Greenwich","10:00:00","2019-07-04",49,0,9,10,0,68
"Harrow","10:00:00","2019-07-04",698,8,16,142,22,886
"Hounslow","10:00:00","2019-07-04",1921,24,40,296,92,2373
"Kingston upon Thames","10:00:00","2019-07-04",71,3,0,20,0,94
"Lewisham","10:00:00","2019-07-04",435,7,14,104,11,571
"Redbridge","10:00:00","2019-07-04",18,0,0,3,1,22
"Bexley","11:00:00","2019-07-04",678,9,5,156,24,872
"Bromley","11:00:00","2019-07-04",494,11,5,84,19,613
"Ealing","11:00:00","2019-07-04",5333,82,49,1411,831,7706
"Enfield","11:00:00","2019-07-04",2046,34,11,816,334,3241
"Greenwich","11:00:00","2019-07-04",59,2,11,11,0,83
"Harrow","11:00:00","2019-07-04",785,15,23,146,10,979
"Hounslow","11:00:00","2019-07-04",2187,17,28,362,107,2701
"Kingston upon Thames","11:00:00","2019-07-04",80,1,0,20,1,102
"Lewisham","11:00:00","2019-07-04",483,10,9,117,7,626
"Redbridge","11:00:00","2019-07-04",21,0,0,4,0,25
"Bexley","12:00:00","2019-07-04",766,13,5,149,33,966
"Bromley","12:00:00","2019-07-04",492,6,8,104,15,625
"Ealing","12:00:00","2019-07-04",5404,67,47,1462,827,7807
"Enfield","12:00:00","2019-07-04",2128,34,13,909,301,3385
"Greenwich","12:00:00","2019-07-04",60,2,12,10,0,84
"Harrow","12:00:00","2019-07-04",811,20,29,123,18,1001
"Hounslow","12:00:00","2019-07-04",2470,38,26,376,96,3006
"Kingston upon Thames","12:00:00","2019-07-04",90,0,0,18,0,108
"Lewisham","12:00:00","2019-07-04",509,6,15,106,13,649
"Redbridge","12:00:00","2019-07-04",14,0,0,6,0,20
"Bexley","13:00:00","2019-07-04",788,9,8,151,29,985
"Bromley","13:00:00","2019-07-04",477,5,6,85,14,587
"Ealing","13:00:00","2019-07-04",5199,103,41,1471,805,7619
"Enfield","13:00:00","2019-07-04",2198,49,17,842,268,3374
"Greenwich","13:00:00","2019-07-04",46,3,9,11,2,71
"Harrow","13:00:00","2019-07-04",831,16,13,141,17,1018
"Hounslow","13:00:00","2019-07-04",2323,30,24,288,83,2748
"Kingston upon Thames","13:00:00","2019-07-04",83,1,0,11,0,95
"Lewisham","13:00:00","2019-07-04",505,12,10,105,4,636
"Redbridge","13:00:00","2019-07-04",14,0,0,3,0,17
"Bexley","14:00:00","2019-07-04",771,7,5,186,41,1010
"Bromley","14:00:00","2019-07-04",547,9,7,102,13,678
"Ealing","14:00:00","2019-07-04",6162,121,63,1496,785,8627
"Enfield","14:00:00","2019-07-04",2112,45,13,829,245,3244
"Greenwich","14:00:00","2019-07-04",84,1,12,22,0,119
"Harrow","14:00:00","2019-07-04",856,19,13,115,15,1018
"Hounslow","14:00:00","2019-07-04",2241,25,24,379,86,2755
"Kingston upon Thames","14:00:00","2019-07-04",88,0,0,18,0,106
"Lewisham","14:00:00","2019-07-04",511,7,16,118,1,653
"Redbridge","14:00:00","2019-07-04",29,1,0,6,1,37
"Bexley","15:00:00","2019-07-04",892,6,7,202,50,1157
"Bromley","15:00:00","2019-07-04",766,5,8,155,9,943
"Enfield","15:00:00","2019-07-04",1999,69,15,654,193,2930
"Greenwich","15:00:00","2019-07-04",92,3,10,13,1,119
"Harrow","15:00:00","2019-07-04",972,22,23,108,20,1145
"Hounslow","15:00:00","2019-07-04",2958,46,39,440,115,3598
"Kingston upon Thames","15:00:00","2019-07-04",132,4,1,15,0,152
"Lewisham","15:00:00","2019-07-04",648,21,21,84,9,783
"Redbridge","15:00:00","2019-07-04",33,0,0,9,0,42
"Bexley","16:00:00","2019-07-04",1049,19,7,255,46,1376
"Bromley","16:00:00","2019-07-04",832,11,5,203,12,1063
"Enfield","16:00:00","2019-07-04",2233,67,13,728,181,3222
"Greenwich","16:00:00","2019-07-04",86,1,12,19,0,118
"Harrow","16:00:00","2019-07-04",996,16,24,111,6,1153
"Hounslow","16:00:00","2019-07-04",3303,52,22,390,43,3810
"Kingston upon Thames","16:00:00","2019-07-04",152,5,0,17,1,175
"Lewisham","16:00:00","2019-07-04",709,21,18,118,4,870
"Redbridge","16:00:00","2019-07-04",35,0,0,7,0,42
"Bexley","17:00:00","2019-07-04",1241,22,7,219,38,1527
"Bromley","17:00:00","2019-07-04",961,19,8,145,2,1135
"Enfield","17:00:00","2019-07-04",2252,106,17,682,161,3218
"Greenwich","17:00:00","2019-07-04",82,7,12,5,0,106
"Harrow","17:00:00","2019-07-04",1021,30,13,110,4,1178
"Hounslow","17:00:00","2019-07-04",3464,73,21,431,41,4030
"Kingston upon Thames","17:00:00","2019-07-04",173,5,0,13,0,191
"Lewisham","17:00:00","2019-07-04",776,16,12,106,2,912
"Redbridge","17:00:00","2019-07-04",86,0,0,4,0,90
"Bexley","18:00:00","2019-07-04",1320,26,9,180,25,1560
"Bromley","18:00:00","2019-07-04",723,10,5,68,6,812
"Enfield","18:00:00","2019-07-04",2249,86,9,537,116,2997
"Greenwich","18:00:00","2019-07-04",74,5,8,6,0,93
"Harrow","18:00:00","2019-07-04",1037,44,18,79,1,1179
"Hounslow","18:00:00","2019-07-04",3375,60,21,315,31,3802
"Kingston upon Thames","18:00:00","2019-07-04",170,1,0,12,0,183
"Lewisham","18:00:00","2019-07-04",754,22,8,76,4,864
"Redbridge","18:00:00","2019-07-04",39,0,0,5,0,44
"Camden","07:00:00","2019-07-05",1261,129,80,670,120,2260
"Harrow","07:00:00","2019-07-05",179,1,2,13,0,195
"Hillingdon","07:00:00","2019-07-05",135,2,0,24,2,163
"Hounslow","07:00:00","2019-07-05",184,4,0,9,0,197
"Kensington and Chelsea","07:00:00","2019-07-05",204,8,2,55,10,279
"Kingston upon Thames","07:00:00","2019-07-05",6819,209,41,1793,350,9212
"Lambeth","07:00:00","2019-07-05",293,9,12,90,10,414
"Wandsworth","07:00:00","2019-07-05",369,24,6,129,0,528
"Camden","08:00:00","2019-07-05",1452,117,80,451,92,2192
"Harrow","08:00:00","2019-07-05",240,4,4,25,2,275
"Hillingdon","08:00:00","2019-07-05",297,1,1,23,2,324
"Hounslow","08:00:00","2019-07-05",229,2,0,13,0,244
"Kensington and Chelsea","08:00:00","2019-07-05",295,13,0,66,5,379
"Kingston upon Thames","08:00:00","2019-07-05",6545,187,45,1234,302,8313
"Lambeth","08:00:00","2019-07-05",414,5,11,75,8,513
"Wandsworth","08:00:00","2019-07-05",443,19,8,125,4,599
"Camden","09:00:00","2019-07-05",1633,91,101,435,92,2352
"Harrow","09:00:00","2019-07-05",175,0,0,19,4,198
"Hillingdon","09:00:00","2019-07-05",203,1,0,37,2,243
"Hounslow","09:00:00","2019-07-05",181,3,0,15,5,204
"Kensington and Chelsea","09:00:00","2019-07-05",239,11,1,68,6,325
"Kingston upon Thames","09:00:00","2019-07-05",5804,116,38,1132,333,7423
"Lambeth","09:00:00","2019-07-05",257,5,14,82,7,365
"Wandsworth","09:00:00","2019-07-05",445,16,11,107,8,587
"Camden","10:00:00","2019-07-05",1645,63,79,461,86,2334
"Harrow","10:00:00","2019-07-05",127,1,0,28,2,158
"Hillingdon","10:00:00","2019-07-05",163,0,0,28,2,193
"Hounslow","10:00:00","2019-07-05",152,5,0,17,5,179
"Kensington and Chelsea","10:00:00","2019-07-05",256,25,0,75,9,365
"Kingston upon Thames","10:00:00","2019-07-05",5645,103,37,1195,353,7333
"Lambeth","10:00:00","2019-07-05",193,4,23,69,4,293
"Wandsworth","10:00:00","2019-07-05",390,17,9,107,8,531
"Camden","11:00:00","2019-07-05",1715,52,78,573,84,2502
"Harrow","11:00:00","2019-07-05",135,0,0,16,2,153
"Hillingdon","11:00:00","2019-07-05",171,1,0,21,0,193
"Hounslow","11:00:00","2019-07-05",170,8,0,27,5,210
"Kensington and Chelsea","11:00:00","2019-07-05",275,28,0,80,7,390
"Kingston upon Thames","11:00:00","2019-07-05",5403,95,23,1104,333,6958
"Lambeth","11:00:00","2019-07-05",196,10,11,60,8,285
"Wandsworth","11:00:00","2019-07-05",425,10,7,137,6,585
"Camden","12:00:00","2019-07-05",1832,72,83,587,77,2651
"Harrow","12:00:00","2019-07-05",153,0,0,18,2,173
"Hillingdon","12:00:00","2019-07-05",155,1,0,21,0,177
"Hounslow","12:00:00","2019-07-05",233,2,0,26,1,262
"Kensington and Chelsea","12:00:00","2019-07-05",264,46,0,78,6,394
"Kingston upon Thames","12:00:00","2019-07-05",5525,99,25,1159,332,7140
"Lambeth","12:00:00","2019-07-05",217,7,9,57,5,295
"Wandsworth","12:00:00","2019-07-05",449,28,7,125,5,614
"Camden","13:00:00","2019-07-05",1780,77,76,508,90,2531
"Harrow","13:00:00","2019-07-05",167,0,0,21,2,190
"Hillingdon","13:00:00","2019-07-05",161,0,0,24,1,186
"Hounslow","13:00:00","2019-07-05",201,0,0,31,5,237
"Kensington and Chelsea","13:00:00","2019-07-05",271,36,0,85,6,398
"Kingston upon Thames","13:00:00","2019-07-05",5505,93,32,1254,332,7216
"Lambeth","13:00:00","2019-07-05",251,14,13,61,13,352
"Wandsworth","13:00:00","2019-07-05",456,28,9,167,6,666
"Camden","14:00:00","2019-07-05",1842,54,81,519,64,2560
"Harrow","14:00:00","2019-07-05",146,9,0,18,4,177
"Hillingdon","14:00:00","2019-07-05",175,2,0,26,1,204
"Hounslow","14:00:00","2019-07-05",195,5,0,31,4,235
"Kensington and Chelsea","14:00:00","2019-07-05",283,31,0,82,5,401
"Kingston upon Thames","14:00:00","2019-07-05",5896,116,41,1313,319,7685
"Lambeth","14:00:00","2019-07-05",272,11,17,81,5,386
"Wandsworth","14:00:00","2019-07-05",475,36,9,141,8,669
"Camden","15:00:00","2019-07-05",1858,63,93,501,88,2603
"Harrow","15:00:00","2019-07-05",145,1,1,14,0,161
"Hillingdon","15:00:00","2019-07-05",224,1,2,28,0,255
"Hounslow","15:00:00","2019-07-05",192,1,0,21,1,215
"Kensington and Chelsea","15:00:00","2019-07-05",301,24,0,83,5,413
"Kingston upon Thames","15:00:00","2019-07-05",6271,128,43,1391,259,8092
"Lambeth","15:00:00","2019-07-05",337,7,16,98,1,459
"Wandsworth","15:00:00","2019-07-05",481,27,10,126,3,647
"Camden","16:00:00","2019-07-05",2035,94,88,397,44,2658
"Harrow","16:00:00","2019-07-05",188,0,1,14,0,203
"Hillingdon","16:00:00","2019-07-05",195,2,0,29,0,226
"Hounslow","16:00:00","2019-07-05",289,12,0,11,0,312
"Kensington and Chelsea","16:00:00","2019-07-05",351,28,1,66,3,449
"Kingston upon Thames","16:00:00","2019-07-05",6586,183,34,1247,160,8210
"Lambeth","16:00:00","2019-07-05",357,18,10,89,8,482
"Wandsworth","16:00:00","2019-07-05",496,29,8,124,1,658
"Camden","17:00:00","2019-07-05",2023,69,85,373,26,2576
"Harrow","17:00:00","2019-07-05",134,1,0,11,0,146
"Hillingdon","17:00:00","2019-07-05",270,0,0,27,0,297
"Hounslow","17:00:00","2019-07-05",269,10,0,18,0,297
"Kensington and Chelsea","17:00:00","2019-07-05",353,44,1,54,2,454
"Kingston upon Thames","17:00:00","2019-07-05",7276,228,41,977,115,8637
"Lambeth","17:00:00","2019-07-05",429,20,14,79,3,545
"Wandsworth","17:00:00","2019-07-05",543,37,8,89,2,679
"Camden","18:00:00","2019-07-05",1903,99,62,330,37,2431
"Harrow","18:00:00","2019-07-05",179,0,1,3,1,184
"Hillingdon","18:00:00","2019-07-05",200,1,0,13,0,214
"Hounslow","18:00:00","2019-07-05",189,7,0,8,0,204
"Kensington and Chelsea","18:00:00","2019-07-05",361,41,0,24,6,432
"Kingston upon Thames","18:00:00","2019-07-05",7050,218,34,702,93,8097
"Lambeth","18:00:00","2019-07-05",397,16,12,49,0,474
"Wandsworth","18:00:00","2019-07-05",520,49,10,75,0,654
"Barnet","07:00:00","2019-07-08",39,4,0,3,0,46
"Bexley","07:00:00","2019-07-08",178,5,0,43,0,226
"Greenwich","07:00:00","2019-07-08",3157,366,20,1238,304,5085
"Haringey","07:00:00","2019-07-08",415,10,0,103,7,535
"Harrow","07:00:00","2019-07-08",892,18,25,189,19,1143
"Islington","07:00:00","2019-07-08",399,19,57,157,31,663
"Kingston upon Thames","07:00:00","2019-07-08",283,7,1,54,5,350
"Lewisham","07:00:00","2019-07-08",2,0,0,0,0,2
"Waltham Forest","07:00:00","2019-07-08",128,3,0,34,3,168
"Barnet","08:00:00","2019-07-08",59,0,1,2,0,62
"Bexley","08:00:00","2019-07-08",225,1,0,29,1,256
"Greenwich","08:00:00","2019-07-08",3293,325,24,960,290,4892
"Haringey","08:00:00","2019-07-08",553,28,0,111,5,697
"Harrow","08:00:00","2019-07-08",978,11,20,108,27,1144
"Islington","08:00:00","2019-07-08",428,13,57,153,49,700
"Kingston upon Thames","08:00:00","2019-07-08",551,12,2,49,10,624
"Lewisham","08:00:00","2019-07-08",9,0,2,1,0,12
"Waltham Forest","08:00:00","2019-07-08",138,2,2,23,2,167
"Barnet","09:00:00","2019-07-08",49,2,0,10,0,61
"Bexley","09:00:00","2019-07-08",217,1,0,32,0,250
"Greenwich","09:00:00","2019-07-08",2998,134,43,878,325,4378
"Haringey","09:00:00","2019-07-08",457,7,0,102,8,574
"Harrow","09:00:00","2019-07-08",737,12,26,151,35,961
"Islington","09:00:00","2019-07-08",434,14,51,193,29,721
"Kingston upon Thames","09:00:00","2019-07-08",491,8,2,59,6,566
"Lewisham","09:00:00","2019-07-08",5,0,0,0,0,5
"Waltham Forest","09:00:00","2019-07-08",91,0,0,19,6,116
"Barnet","10:00:00","2019-07-08",48,0,0,10,2,60
"Bexley","10:00:00","2019-07-08",65,0,0,10,0,75
"Greenwich","10:00:00","2019-07-08",2758,79,16,947,352,4152
"Haringey","10:00:00","2019-07-08",392,7,2,112,5,518
"Harrow","10:00:00","2019-07-08",711,12,23,164,24,934
"Islington","10:00:00","2019-07-08",436,18,58,203,55,770
"Kingston upon Thames","10:00:00","2019-07-08",368,11,0,56,5,440
"Lewisham","10:00:00","2019-07-08",4,0,0,2,0,6
"Waltham Forest","10:00:00","2019-07-08",90,2,0,18,3,113
"Barnet","11:00:00","2019-07-08",44,0,0,8,1,53
"Bexley","11:00:00","2019-07-08",72,1,0,13,1,87
"Greenwich","11:00:00","2019-07-08",2883,85,9,1015,389,4381
"Haringey","11:00:00","2019-07-08",390,16,0,113,4,523
"Harrow","11:00:00","2019-07-08",817,10,26,139,27,1019
"Islington","11:00:00","2019-07-08",426,25,48,232,32,763
"Kingston upon Thames","11:00:00","2019-07-08",346,11,0,57,12,426
"Lewisham","11:00:00","2019-07-08",4,0,0,1,0,5
"Waltham Forest","11:00:00","2019-07-08",82,3,0,27,3,115
"Barnet","12:00:00","2019-07-08",48,0,0,11,0,59
"Bexley","12:00:00","2019-07-08",92,0,0,11,1,104
"Greenwich","12:00:00","2019-07-08",3019,71,11,1027,345,4473
"Haringey","12:00:00","2019-07-08",347,16,1,96,9,469
"Harrow","12:00:00","2019-07-08",794,11,18,132,21,976
"Islington","12:00:00","2019-07-08",428,45,53,192,43,761
"Kingston upon Thames","12:00:00","2019-07-08",397,10,0,60,7,474
"Lewisham","12:00:00","2019-07-08",12,0,0,2,0,14
"Waltham Forest","12:00:00","2019-07-08",89,0,0,25,2,116
"Barnet","13:00:00","2019-07-08",39,3,0,8,0,50
"Bexley","13:00:00","2019-07-08",70,4,0,15,0,89
"Greenwich","13:00:00","2019-07-08",2978,81,8,1000,361,4428
"Haringey","13:00:00","2019-07-08",342,10,1,105,6,464
"Harrow","13:00:00","2019-07-08",830,21,24,134,17,1026
"Islington","13:00:00","2019-07-08",451,49,54,187,48,789
"Kingston upon Thames","13:00:00","2019-07-08",347,9,0,62,8,426
"Lewisham","13:00:00","2019-07-08",3,0,0,2,0,5
"Waltham Forest","13:00:00","2019-07-08",106,2,0,27,2,137
"Barnet","14:00:00","2019-07-08",40,2,0,3,0,45
"Bexley","14:00:00","2019-07-08",98,1,0,15,0,114
"Greenwich","14:00:00","2019-07-08",3250,95,20,1213,314,4892
"Haringey","14:00:00","2019-07-08",383,19,1,98,7,508
"Harrow","14:00:00","2019-07-08",820,15,21,138,15,1009
"Islington","14:00:00","2019-07-08",391,39,63,228,37,758
"Kingston upon Thames","14:00:00","2019-07-08",396,6,2,55,5,464
"Lewisham","14:00:00","2019-07-08",6,0,0,0,0,6
"Waltham Forest","14:00:00","2019-07-08",104,0,0,29,2,135
"Barnet","15:00:00","2019-07-08",54,1,0,10,0,65
"Bexley","15:00:00","2019-07-08",105,1,0,11,0,117
"Greenwich","15:00:00","2019-07-08",2927,102,19,1160,248,4456
"Haringey","15:00:00","2019-07-08",485,9,0,86,4,584
"Harrow","15:00:00","2019-07-08",888,15,24,157,14,1098
"Islington","15:00:00","2019-07-08",506,59,60,221,36,882
"Kingston upon Thames","15:00:00","2019-07-08",657,6,2,62,3,730
"Lewisham","15:00:00","2019-07-08",5,1,1,1,0,8
"Waltham Forest","15:00:00","2019-07-08",178,3,0,28,1,210
"Barnet","16:00:00","2019-07-08",74,3,0,11,0,88
"Bexley","16:00:00","2019-07-08",100,2,0,32,0,134
"Greenwich","16:00:00","2019-07-08",3482,251,10,1030,152,4925
"Haringey","16:00:00","2019-07-08",461,13,2,103,5,584
"Harrow","16:00:00","2019-07-08",965,13,26,108,11,1123
"Islington","16:00:00","2019-07-08",590,63,46,247,22,968
"Kingston upon Thames","16:00:00","2019-07-08",443,6,1,59,4,513
"Lewisham","16:00:00","2019-07-08",3,0,1,1,0,5
"Waltham Forest","16:00:00","2019-07-08",140,9,0,17,2,168
"Barnet","17:00:00","2019-07-08",58,4,0,5,0,67
"Bexley","17:00:00","2019-07-08",110,4,0,16,0,130
"Greenwich","17:00:00","2019-07-08",4203,356,36,1028,119,5742
"Haringey","17:00:00","2019-07-08",468,19,1,80,0,568
"Harrow","17:00:00","2019-07-08",919,24,16,131,2,1092
"Islington","17:00:00","2019-07-08",615,108,38,189,14,964
"Kingston upon Thames","17:00:00","2019-07-08",518,17,0,34,0,569
"Lewisham","17:00:00","2019-07-08",3,1,0,2,0,6
"Waltham Forest","17:00:00","2019-07-08",169,1,0,28,0,198
"Barnet","18:00:00","2019-07-08",52,0,0,3,0,55
"Bexley","18:00:00","2019-07-08",105,0,0,7,1,113
"Greenwich","18:00:00","2019-07-08",4323,385,64,751,110,5633
"Haringey","18:00:00","2019-07-08",499,5,0,69,0,573
"Harrow","18:00:00","2019-07-08",909,19,18,102,8,1056
"Islington","18:00:00","2019-07-08",700,120,58,194,12,1084
"Kingston upon Thames","18:00:00","2019-07-08",503,16,1,26,1,547
"Lewisham","18:00:00","2019-07-08",3,0,0,0,0,3
"Waltham Forest","18:00:00","2019-07-08",136,7,0,18,2,163
"Greenwich","07:00:00","2019-07-09",787,17,56,187,36,1083
"Haringey","07:00:00","2019-07-09",115,5,0,43,0,163
"Kingston upon Thames","07:00:00","2019-07-09",194,2,10,29,0,235
"Redbridge","07:00:00","2019-07-09",3458,152,45,857,71,4583
"Richmond upon Thames","07:00:00","2019-07-09",1614,94,33,417,79,2237
"Tower Hamlets","07:00:00","2019-07-09",4307,285,25,2073,431,7121
"Westminster","07:00:00","2019-07-09",1323,107,42,476,72,2020
"Greenwich","08:00:00","2019-07-09",1062,16,54,156,52,1340
"Haringey","08:00:00","2019-07-09",166,7,0,31,0,204
"Kingston upon Thames","08:00:00","2019-07-09",219,5,9,34,0,267
"Redbridge","08:00:00","2019-07-09",3811,105,54,650,80,4700
"Richmond upon Thames","08:00:00","2019-07-09",1556,95,36,275,71,2033
"Tower Hamlets","08:00:00","2019-07-09",4219,213,23,1447,418,6320
"Westminster","08:00:00","2019-07-09",1652,105,46,473,66,2342
"Greenwich","09:00:00","2019-07-09",920,15,57,166,45,1203
"Haringey","09:00:00","2019-07-09",178,5,0,24,2,209
"Kingston upon Thames","09:00:00","2019-07-09",129,1,11,24,3,168
"Redbridge","09:00:00","2019-07-09",3229,60,55,611,92,4047
"Richmond upon Thames","09:00:00","2019-07-09",1145,51,31,330,72,1629
"Tower Hamlets","09:00:00","2019-07-09",3759,104,29,1390,407,5689
"Westminster","09:00:00","2019-07-09",1583,99,61,425,65,2233
"Greenwich","10:00:00","2019-07-09",791,15,55,165,39,1065
"Haringey","10:00:00","2019-07-09",154,4,0,25,0,183
"Kingston upon Thames","10:00:00","2019-07-09",92,1,10,9,0,112
"Redbridge","10:00:00","2019-07-09",2685,36,51,560,95,3427
"Richmond upon Thames","10:00:00","2019-07-09",1322,29,40,322,108,1821
"Tower Hamlets","10:00:00","2019-07-09",3229,83,26,1291,443,5072
"Westminster","10:00:00","2019-07-09",1680,64,43,435,75,2297
"Greenwich","11:00:00","2019-07-09",883,9,56,191,54,1193
"Haringey","11:00:00","2019-07-09",169,6,1,23,1,200
"Kingston upon Thames","11:00:00","2019-07-09",86,2,10,22,2,122
"Redbridge","11:00:00","2019-07-09",2751,40,44,600,95,3530
"Richmond upon Thames","11:00:00","2019-07-09",1233,38,39,313,81,1704
"Tower Hamlets","11:00:00","2019-07-09",2884,81,10,1218,430,4623
"Westminster","11:00:00","2019-07-09",1751,88,51,539,79,2508
"Greenwich","12:00:00","2019-07-09",881,19,55,165,48,1168
"Haringey","12:00:00","2019-07-09",155,4,0,25,0,184
"Kingston upon Thames","12:00:00","2019-07-09",86,3,10,9,7,115
"Redbridge","12:00:00","2019-07-09",2990,47,47,537,98,3719
"Richmond upon Thames","12:00:00","2019-07-09",1305,31,35,351,74,1796
"Tower Hamlets","12:00:00","2019-07-09",3178,80,14,1145,448,4865
"Westminster","12:00:00","2019-07-09",1607,71,48,418,67,2211
"Greenwich","13:00:00","2019-07-09",960,14,57,199,42,1272
"Haringey","13:00:00","2019-07-09",146,5,0,28,0,179
"Kingston upon Thames","13:00:00","2019-07-09",85,4,10,14,5,118
"Redbridge","13:00:00","2019-07-09",3197,44,45,577,97,3960
"Richmond upon Thames","13:00:00","2019-07-09",1347,39,42,390,86,1904
"Tower Hamlets","13:00:00","2019-07-09",3306,101,27,1305,450,5189
"Westminster","13:00:00","2019-07-09",1652,110,45,415,54,2276
"Greenwich","14:00:00","2019-07-09",992,18,55,151,43,1259
"Haringey","14:00:00","2019-07-09",139,7,0,25,0,171
"Kingston upon Thames","14:00:00","2019-07-09",82,3,8,17,1,111
"Redbridge","14:00:00","2019-07-09",3422,68,47,579,85,4201
"Richmond upon Thames","14:00:00","2019-07-09",1383,38,35,321,61,1838
"Tower Hamlets","14:00:00","2019-07-09",3521,86,31,1355,432,5425
"Westminster","14:00:00","2019-07-09",1692,102,55,363,46,2258
"Greenwich","15:00:00","2019-07-09",952,15,55,172,28,1222
"Haringey","15:00:00","2019-07-09",170,0,1,28,0,199
"Kingston upon Thames","15:00:00","2019-07-09",132,1,11,17,1,162
"Redbridge","15:00:00","2019-07-09",3278,74,49,633,94,4128
"Richmond upon Thames","15:00:00","2019-07-09",1631,36,43,332,45,2087
"Tower Hamlets","15:00:00","2019-07-09",3437,132,22,1316,312,5219
"Westminster","15:00:00","2019-07-09",1840,125,42,309,38,2354
"Greenwich","16:00:00","2019-07-09",1070,30,52,164,15,1331
"Haringey","16:00:00","2019-07-09",170,10,0,30,0,210
"Kingston upon Thames","16:00:00","2019-07-09",114,3,9,17,1,144
"Redbridge","16:00:00","2019-07-09",3364,105,50,673,69,4261
"Richmond upon Thames","16:00:00","2019-07-09",1677,74,38,292,46,2127
"Tower Hamlets","16:00:00","2019-07-09",3969,176,15,1225,186,5571
"Westminster","16:00:00","2019-07-09",1876,135,53,314,25,2403
"Greenwich","17:00:00","2019-07-09",1159,18,50,147,11,1385
"Haringey","17:00:00","2019-07-09",162,9,0,22,0,193
"Kingston upon Thames","17:00:00","2019-07-09",159,7,9,22,1,198
"Redbridge","17:00:00","2019-07-09",3879,113,49,562,47,4650
"Richmond upon Thames","17:00:00","2019-07-09",1566,121,36,284,14,2021
"Tower Hamlets","17:00:00","2019-07-09",4196,260,19,959,136,5570
"Westminster","17:00:00","2019-07-09",2091,156,44,257,14,2562
"Greenwich","18:00:00","2019-07-09",1087,20,53,109,13,1282
"Haringey","18:00:00","2019-07-09",126,8,0,13,0,147
"Kingston upon Thames","18:00:00","2019-07-09",151,3,9,15,1,179
"Redbridge","18:00:00","2019-07-09",3933,78,51,487,32,4581
"Richmond upon Thames","18:00:00","2019-07-09",1632,83,29,243,16,2003
"Tower Hamlets","18:00:00","2019-07-09",4325,195,20,734,126,5400
"Westminster","18:00:00","2019-07-09",2045,174,44,167,14,2444
"Brent","07:00:00","2019-07-10",419,8,0,100,1,528
"Bromley","07:00:00","2019-07-10",620,19,54,244,29,966
"Croydon","07:00:00","2019-07-10",769,9,19,162,15,974
"Enfield","07:00:00","2019-07-10",789,3,20,125,6,943
"Havering","07:00:00","2019-07-10",335,7,0,65,4,411
"Lambeth","07:00:00","2019-07-10",375,37,53,114,12,591
"Richmond upon Thames","07:00:00","2019-07-10",356,17,56,130,10,569
"Waltham Forest","07:00:00","2019-07-10",70,0,0,16,0,86
"Westminster","07:00:00","2019-07-10",56,6,6,35,12,115
"Brent","08:00:00","2019-07-10",563,0,1,60,4,628
"Bromley","08:00:00","2019-07-10",707,19,45,217,40,1028
"Croydon","08:00:00","2019-07-10",1080,13,18,143,25,1279
"Enfield","08:00:00","2019-07-10",864,0,27,101,13,1005
"Havering","08:00:00","2019-07-10",341,0,1,49,4,395
"Lambeth","08:00:00","2019-07-10",399,23,30,101,12,565
"Richmond upon Thames","08:00:00","2019-07-10",423,24,55,104,11,617
"Waltham Forest","08:00:00","2019-07-10",125,1,0,25,0,151
"Westminster","08:00:00","2019-07-10",97,4,7,50,9,167
"Brent","09:00:00","2019-07-10",425,2,0,72,1,500
"Bromley","09:00:00","2019-07-10",689,8,51,172,26,946
"Croydon","09:00:00","2019-07-10",631,2,16,115,16,780
"Enfield","09:00:00","2019-07-10",671,6,26,124,10,837
"Havering","09:00:00","2019-07-10",289,0,0,42,4,335
"Lambeth","09:00:00","2019-07-10",332,14,34,121,16,517
"Richmond upon Thames","09:00:00","2019-07-10",360,16,61,94,7,538
"Waltham Forest","09:00:00","2019-07-10",66,0,0,14,0,80
"Westminster","09:00:00","2019-07-10",65,8,5,51,3,132
"Brent","10:00:00","2019-07-10",362,6,0,63,3,434
"Bromley","10:00:00","2019-07-10",646,14,46,202,35,943
"Croydon","10:00:00","2019-07-10",569,7,17,93,16,702
"Enfield","10:00:00","2019-07-10",580,6,25,103,15,729
"Havering","10:00:00","2019-07-10",262,0,0,39,3,304
"Lambeth","10:00:00","2019-07-10",338,12,36,88,13,487
"Richmond upon Thames","10:00:00","2019-07-10",300,13,55,104,6,478
"Waltham Forest","10:00:00","2019-07-10",57,1,0,9,0,67
"Westminster","10:00:00","2019-07-10",70,4,5,46,2,127
"Brent","11:00:00","2019-07-10",367,2,1,54,3,427
"Bromley","11:00:00","2019-07-10",683,9,49,177,19,937
"Croydon","11:00:00","2019-07-10",576,4,16,95,18,709
"Enfield","11:00:00","2019-07-10",702,4,21,88,9,824
"Havering","11:00:00","2019-07-10",270,5,0,40,5,320
"Lambeth","11:00:00","2019-07-10",349,19,27,106,12,513
"Richmond upon Thames","11:00:00","2019-07-10",326,21,56,94,11,508
"Waltham Forest","11:00:00","2019-07-10",80,0,0,8,1,89
"Westminster","11:00:00","2019-07-10",86,6,7,40,10,149
"Brent","12:00:00","2019-07-10",368,4,0,56,0,428
"Bromley","12:00:00","2019-07-10",612,11,44,191,26,884
"Croydon","12:00:00","2019-07-10",563,2,16,94,14,689
"Enfield","12:00:00","2019-07-10",555,4,27,95,11,692
"Havering","12:00:00","2019-07-10",298,0,0,43,1,342
"Lambeth","12:00:00","2019-07-10",363,20,23,130,11,547
"Richmond upon Thames","12:00:00","2019-07-10",358,25,58,76,3,520
"Waltham Forest","12:00:00","2019-07-10",67,0,0,6,1,74
"Westminster","12:00:00","2019-07-10",84,6,3,37,3,133
"Brent","13:00:00","2019-07-10",398,10,0,55,2,465
"Bromley","13:00:00","2019-07-10",621,18,53,199,29,920
"Croydon","13:00:00","2019-07-10",544,5,16,90,7,662
"Enfield","13:00:00","2019-07-10",572,5,23,124,10,734
"Havering","13:00:00","2019-07-10",255,2,0,46,3,306
"Lambeth","13:00:00","2019-07-10",421,14,29,122,13,599
"Richmond upon Thames","13:00:00","2019-07-10",329,28,55,76,7,495
"Waltham Forest","13:00:00","2019-07-10",58,0,0,15,0,73
"Westminster","13:00:00","2019-07-10",87,11,4,47,3,152
"Brent","14:00:00","2019-07-10",407,6,0,46,1,460
"Bromley","14:00:00","2019-07-10",770,19,43,188,15,1035
"Croydon","14:00:00","2019-07-10",619,5,15,102,18,759
"Enfield","14:00:00","2019-07-10",666,5,24,143,8,846
"Havering","14:00:00","2019-07-10",298,4,0,60,9,371
"Lambeth","14:00:00","2019-07-10",403,14,39,109,12,577
"Richmond upon Thames","14:00:00","2019-07-10",352,23,57,89,8,529
"Waltham Forest","14:00:00","2019-07-10",81,0,0,14,0,95
"Westminster","14:00:00","2019-07-10",82,6,6,43,6,143
"Brent","15:00:00","2019-07-10",434,7,0,39,2,482
"Bromley","15:00:00","2019-07-10",685,14,46,168,18,931
"Croydon","15:00:00","2019-07-10",789,8,19,142,14,972
"Enfield","15:00:00","2019-07-10",572,8,29,107,10,726
"Havering","15:00:00","2019-07-10",264,2,1,51,8,326
"Lambeth","15:00:00","2019-07-10",491,20,30,110,11,662
"Richmond upon Thames","15:00:00","2019-07-10",412,19,53,73,2,559
"Waltham Forest","15:00:00","2019-07-10",88,0,0,13,1,102
"Westminster","15:00:00","2019-07-10",101,5,5,41,5,157
"Brent","16:00:00","2019-07-10",493,7,0,64,0,564
"Bromley","16:00:00","2019-07-10",803,22,47,202,11,1085
"Croydon","16:00:00","2019-07-10",823,5,19,150,11,1008
"Enfield","16:00:00","2019-07-10",693,4,27,146,11,881
"Havering","16:00:00","2019-07-10",386,4,0,83,1,474
"Lambeth","16:00:00","2019-07-10",552,39,31,109,4,735
"Richmond upon Thames","16:00:00","2019-07-10",448,27,62,88,3,628
"Waltham Forest","16:00:00","2019-07-10",80,0,0,24,0,104
"Westminster","16:00:00","2019-07-10",111,9,5,43,1,169
"Brent","17:00:00","2019-07-10",541,11,0,67,1,620
"Bromley","17:00:00","2019-07-10",840,25,47,144,6,1062
"Croydon","17:00:00","2019-07-10",1025,19,16,112,7,1179
"Enfield","17:00:00","2019-07-10",770,9,21,121,2,923
"Havering","17:00:00","2019-07-10",456,2,0,66,1,525
"Lambeth","17:00:00","2019-07-10",538,28,32,90,1,689
"Richmond upon Thames","17:00:00","2019-07-10",488,29,54,53,0,624
"Waltham Forest","17:00:00","2019-07-10",118,0,0,14,0,132
"Westminster","17:00:00","2019-07-10",96,10,5,25,2,138
"Brent","18:00:00","2019-07-10",577,6,0,58,0,641
"Bromley","18:00:00","2019-07-10",1003,17,53,141,12,1226
"Croydon","18:00:00","2019-07-10",792,2,15,87,8,904
"Enfield","18:00:00","2019-07-10",588,4,25,106,2,725
"Havering","18:00:00","2019-07-10",352,10,0,21,1,384
"Lambeth","18:00:00","2019-07-10",560,40,35,65,4,704
"Richmond upon Thames","18:00:00","2019-07-10",441,36,53,44,0,574
"Waltham Forest","18:00:00","2019-07-10",111,2,0,12,0,125
"Westminster","18:00:00","2019-07-10",115,14,7,23,1,160
"Bromley","07:00:00","2019-07-11",56,0,0,14,0,70
"Greenwich","07:00:00","2019-07-11",154,0,0,28,0,182
"Harrow","07:00:00","2019-07-11",40,0,0,3,0,43
"Havering","07:00:00","2019-07-11",2344,18,34,493,109,2998
"Hillingdon","07:00:00","2019-07-11",15,0,0,2,0,17
"Islington","07:00:00","2019-07-11",298,37,54,126,37,552
"Lewisham","07:00:00","2019-07-11",292,2,0,22,3,319
"Westminster","07:00:00","2019-07-11",17,8,0,10,0,35
"Bromley","08:00:00","2019-07-11",85,2,0,10,1,98
"Greenwich","08:00:00","2019-07-11",189,5,1,24,3,222
"Harrow","08:00:00","2019-07-11",61,0,0,2,0,63
"Havering","08:00:00","2019-07-11",2578,12,25,424,105,3144
"Hillingdon","08:00:00","2019-07-11",25,0,0,2,0,27
"Islington","08:00:00","2019-07-11",313,58,44,147,43,605
"Lewisham","08:00:00","2019-07-11",361,2,0,21,3,387
"Westminster","08:00:00","2019-07-11",25,3,0,11,2,41
"Bromley","09:00:00","2019-07-11",44,0,0,10,0,54
"Greenwich","09:00:00","2019-07-11",133,1,2,11,1,148
"Harrow","09:00:00","2019-07-11",36,0,0,4,0,40
"Havering","09:00:00","2019-07-11",2220,21,19,385,118,2763
"Hillingdon","09:00:00","2019-07-11",20,1,0,2,0,23
"Hounslow","09:00:00","2019-07-11",3569,64,31,572,215,4451
"Islington","09:00:00","2019-07-11",303,35,42,115,27,522
"Lewisham","09:00:00","2019-07-11",331,2,0,19,4,356
"Westminster","09:00:00","2019-07-11",26,4,0,11,0,41
"Bromley","10:00:00","2019-07-11",51,0,0,11,0,62
"Greenwich","10:00:00","2019-07-11",89,0,0,15,1,105
"Harrow","10:00:00","2019-07-11",27,2,0,4,0,33
"Havering","10:00:00","2019-07-11",1843,13,24,364,105,2349
"Hillingdon","10:00:00","2019-07-11",14,0,0,5,0,19
"Hounslow","10:00:00","2019-07-11",2905,49,17,609,189,3769
"Islington","10:00:00","2019-07-11",249,26,40,146,44,505
"Lewisham","10:00:00","2019-07-11",342,5,0,30,3,380
"Westminster","10:00:00","2019-07-11",28,1,0,11,1,41
"Bromley","11:00:00","2019-07-11",41,0,0,11,2,54
"Greenwich","11:00:00","2019-07-11",80,2,0,8,5,95
"Harrow","11:00:00","2019-07-11",32,0,0,3,0,35
"Havering","11:00:00","2019-07-11",1762,12,20,386,97,2277
"Hillingdon","11:00:00","2019-07-11",13,1,0,3,0,17
"Hounslow","11:00:00","2019-07-11",2904,27,10,494,162,3597
"Islington","11:00:00","2019-07-11",279,26,40,114,44,503
"Lewisham","11:00:00","2019-07-11",310,5,0,36,1,352
"Westminster","11:00:00","2019-07-11",39,6,0,12,1,58
"Bromley","12:00:00","2019-07-11",55,1,0,9,0,65
"Greenwich","12:00:00","2019-07-11",84,5,0,9,2,100
"Harrow","12:00:00","2019-07-11",24,0,0,6,0,30
"Havering","12:00:00","2019-07-11",1931,16,12,367,95,2421
"Hillingdon","12:00:00","2019-07-11",22,0,0,5,0,27
"Hounslow","12:00:00","2019-07-11",2978,23,20,602,198,3821
"Islington","12:00:00","2019-07-11",227,34,38,97,23,419
"Lewisham","12:00:00","2019-07-11",330,9,0,42,1,382
"Westminster","12:00:00","2019-07-11",33,7,0,10,0,50
"Bromley","13:00:00","2019-07-11",61,2,0,11,1,75
"Greenwich","13:00:00","2019-07-11",102,3,0,12,0,117
"Harrow","13:00:00","2019-07-11",25,4,0,4,0,33
"Havering","13:00:00","2019-07-11",1917,18,16,327,85,2363
"Hillingdon","13:00:00","2019-07-11",9,0,0,1,0,10
"Hounslow","13:00:00","2019-07-11",2910,50,16,520,189,3685
"Islington","13:00:00","2019-07-11",242,40,43,89,20,434
"Lewisham","13:00:00","2019-07-11",352,5,0,42,6,405
"Westminster","13:00:00","2019-07-11",35,9,0,12,0,56
"Bromley","14:00:00","2019-07-11",41,0,0,8,0,49
"Greenwich","14:00:00","2019-07-11",85,3,0,9,1,98
"Harrow","14:00:00","2019-07-11",27,0,0,6,2,35
"Havering","14:00:00","2019-07-11",2003,20,20,397,99,2539
"Hillingdon","14:00:00","2019-07-11",21,0,0,1,0,22
"Hounslow","14:00:00","2019-07-11",2930,36,22,504,174,3666
"Islington","14:00:00","2019-07-11",258,39,49,83,19,448
"Lewisham","14:00:00","2019-07-11",411,6,0,33,3,453
"Westminster","14:00:00","2019-07-11",29,10,0,3,0,42
"Bromley","15:00:00","2019-07-11",52,0,0,10,1,63
"Greenwich","15:00:00","2019-07-11",131,1,1,9,0,142
"Harrow","15:00:00","2019-07-11",40,1,0,6,0,47
"Havering","15:00:00","2019-07-11",2210,23,25,446,76,2780
"Hillingdon","15:00:00","2019-07-11",13,0,0,4,0,17
"Hounslow","15:00:00","2019-07-11",3645,48,22,814,171,4700
"Islington","15:00:00","2019-07-11",261,38,43,83,16,441
"Lewisham","15:00:00","2019-07-11",436,5,0,48,2,491
"Westminster","15:00:00","2019-07-11",36,8,0,4,0,48
"Bromley","16:00:00","2019-07-11",73,3,0,18,0,94
"Greenwich","16:00:00","2019-07-11",180,8,0,7,0,195
"Harrow","16:00:00","2019-07-11",35,2,0,2,1,40
"Havering","16:00:00","2019-07-11",2104,26,26,408,54,2618
"Hillingdon","16:00:00","2019-07-11",21,1,0,3,0,25
"Islington","16:00:00","2019-07-11",331,39,44,48,10,472
"Lewisham","16:00:00","2019-07-11",418,5,0,52,4,479
"Westminster","16:00:00","2019-07-11",41,10,0,3,0,54
"Bromley","17:00:00","2019-07-11",84,0,0,9,0,93
"Greenwich","17:00:00","2019-07-11",200,3,0,17,1,221
"Harrow","17:00:00","2019-07-11",28,0,0,5,0,33
"Havering","17:00:00","2019-07-11",2396,22,22,329,44,2813
"Hillingdon","17:00:00","2019-07-11",34,0,0,7,0,41
"Islington","17:00:00","2019-07-11",328,51,42,49,7,477
"Lewisham","17:00:00","2019-07-11",430,11,0,50,1,492
"Westminster","17:00:00","2019-07-11",41,9,0,7,0,57
"Bromley","18:00:00","2019-07-11",92,2,0,11,0,105
"Greenwich","18:00:00","2019-07-11",111,3,0,12,0,126
"Harrow","18:00:00","2019-07-11",38,0,0,6,0,44
"Havering","18:00:00","2019-07-11",2272,9,21,275,27,2604
"Hillingdon","18:00:00","2019-07-11",19,0,0,1,0,20
"Hounslow","18:00:00","2019-07-11",4430,120,23,399,81,5053
"Islington","18:00:00","2019-07-11",429,34,39,27,4,533
"Lewisham","18:00:00","2019-07-11",355,1,0,30,1,387
"Westminster","18:00:00","2019-07-11",29,12,0,3,0,44
"Barnet","07:00:00","2019-07-12",853,28,91,202,14,1188
"Bromley","07:00:00","2019-07-12",74,0,0,17,0,91
"Camden","07:00:00","2019-07-12",75,0,0,8,0,83
"Croydon","07:00:00","2019-07-12",224,1,0,47,1,273
"Ealing","07:00:00","2019-07-12",52,2,0,10,1,65
"Enfield","07:00:00","2019-07-12",190,3,13,30,4,240
"Hillingdon","07:00:00","2019-07-12",22,0,3,4,3,32
"Sutton","07:00:00","2019-07-12",1000,19,44,205,21,1289
"Tower Hamlets","07:00:00","2019-07-12",4083,320,104,1883,457,6847
"Barnet","08:00:00","2019-07-12",1065,32,69,163,25,1354
"Bromley","08:00:00","2019-07-12",97,0,1,21,1,120
"Camden","08:00:00","2019-07-12",141,2,0,9,0,152
"Croydon","08:00:00","2019-07-12",387,0,0,43,2,432
"Ealing","08:00:00","2019-07-12",100,1,0,13,0,114
"Enfield","08:00:00","2019-07-12",284,1,10,36,1,332
"Hillingdon","08:00:00","2019-07-12",19,0,0,4,0,23
"Sutton","08:00:00","2019-07-12",1025,9,41,173,14,1262
"Tower Hamlets","08:00:00","2019-07-12",4428,232,92,1551,432,6735
"Barnet","09:00:00","2019-07-12",871,19,82,171,21,1164
"Bromley","09:00:00","2019-07-12",56,1,0,10,1,68
"Camden","09:00:00","2019-07-12",56,0,0,12,1,69
"Croydon","09:00:00","2019-07-12",341,7,0,78,3,429
"Ealing","09:00:00","2019-07-12",68,2,0,20,0,90
"Enfield","09:00:00","2019-07-12",202,2,18,26,2,250
"Hillingdon","09:00:00","2019-07-12",24,0,3,6,1,34
"Sutton","09:00:00","2019-07-12",901,15,42,161,21,1140
"Tower Hamlets","09:00:00","2019-07-12",4073,157,88,1410,475,6203
"Barnet","10:00:00","2019-07-12",783,17,76,172,30,1078
"Bromley","10:00:00","2019-07-12",58,0,0,8,1,67
"Camden","10:00:00","2019-07-12",51,2,0,17,1,71
"Croydon","10:00:00","2019-07-12",251,9,0,74,4,338
"Ealing","10:00:00","2019-07-12",58,4,0,17,1,80
"Enfield","10:00:00","2019-07-12",158,4,16,27,1,206
"Hillingdon","10:00:00","2019-07-12",22,0,1,5,1,29
"Sutton","10:00:00","2019-07-12",895,13,35,151,23,1117
"Tower Hamlets","10:00:00","2019-07-12",3722,146,68,1472,536,5944
"Barnet","11:00:00","2019-07-12",838,23,82,170,20,1133
"Bromley","11:00:00","2019-07-12",45,1,0,18,0,64
"Camden","11:00:00","2019-07-12",62,1,0,14,0,77
"Croydon","11:00:00","2019-07-12",283,4,0,60,5,352
"Ealing","11:00:00","2019-07-12",65,2,0,14,5,86
"Enfield","11:00:00","2019-07-12",162,3,12,26,1,204
"Hillingdon","11:00:00","2019-07-12",26,0,1,7,0,34
"Sutton","11:00:00","2019-07-12",885,14,45,142,12,1098
"Tower Hamlets","11:00:00","2019-07-12",3948,153,66,1452,431,6050
"Barnet","12:00:00","2019-07-12",737,24,73,148,18,1000
"Bromley","12:00:00","2019-07-12",44,2,0,7,2,55
"Camden","12:00:00","2019-07-12",50,1,0,14,0,65
"Croydon","12:00:00","2019-07-12",261,13,0,71,4,349
"Ealing","12:00:00","2019-07-12",79,4,0,13,0,96
"Enfield","12:00:00","2019-07-12",185,5,11,21,2,224
"Hillingdon","12:00:00","2019-07-12",24,0,0,7,0,31
"Sutton","12:00:00","2019-07-12",929,21,39,144,7,1140
"Tower Hamlets","12:00:00","2019-07-12",4059,161,54,1429,483,6186
"Barnet","13:00:00","2019-07-12",775,25,78,122,15,1015
"Bromley","13:00:00","2019-07-12",66,0,0,9,0,75
"Camden","13:00:00","2019-07-12",53,6,0,12,0,71
"Croydon","13:00:00","2019-07-12",345,8,0,82,2,437
"Ealing","13:00:00","2019-07-12",68,2,0,15,0,85
"Enfield","13:00:00","2019-07-12",182,7,16,25,3,233
"Hillingdon","13:00:00","2019-07-12",28,0,0,10,0,38
"Sutton","13:00:00","2019-07-12",906,19,34,160,13,1132
"Tower Hamlets","13:00:00","2019-07-12",4188,188,57,1326,491,6250
"Barnet","14:00:00","2019-07-12",817,27,81,172,21,1118
"Bromley","14:00:00","2019-07-12",64,1,0,10,0,75
"Camden","14:00:00","2019-07-12",57,2,0,10,0,69
"Croydon","14:00:00","2019-07-12",347,16,1,65,3,432
"Ealing","14:00:00","2019-07-12",84,6,0,13,0,103
"Enfield","14:00:00","2019-07-12",197,5,11,15,2,230
"Hillingdon","14:00:00","2019-07-12",29,0,0,3,0,32
"Sutton","14:00:00","2019-07-12",965,16,37,142,19,1179
"Tower Hamlets","14:00:00","2019-07-12",4362,193,66,1406,396,6423
"Barnet","15:00:00","2019-07-12",1021,26,84,156,9,1296
"Bromley","15:00:00","2019-07-12",79,0,0,16,1,96
"Camden","15:00:00","2019-07-12",82,0,0,11,0,93
"Croydon","15:00:00","2019-07-12",333,12,0,74,3,422
"Ealing","15:00:00","2019-07-12",129,3,0,9,0,141
"Enfield","15:00:00","2019-07-12",247,4,6,31,0,288
"Hillingdon","15:00:00","2019-07-12",30,0,0,12,0,42
"Sutton","15:00:00","2019-07-12",1054,21,34,163,16,1288
"Tower Hamlets","15:00:00","2019-07-12",4435,217,82,1309,316,6359
"Barnet","16:00:00","2019-07-12",1034,33,84,141,7,1299
"Bromley","16:00:00","2019-07-12",90,0,0,16,1,107
"Camden","16:00:00","2019-07-12",73,0,0,14,0,87
"Croydon","16:00:00","2019-07-12",446,21,0,107,2,576
"Ealing","16:00:00","2019-07-12",91,2,0,5,0,98
"Enfield","16:00:00","2019-07-12",272,6,8,18,0,304
"Hillingdon","16:00:00","2019-07-12",43,0,3,4,0,50
"Sutton","16:00:00","2019-07-12",1111,23,39,178,6,1357
"Tower Hamlets","16:00:00","2019-07-12",4666,241,71,1136,194,6308
"Barnet","17:00:00","2019-07-12",984,39,68,118,5,1214
"Bromley","17:00:00","2019-07-12",86,0,0,11,0,97
"Camden","17:00:00","2019-07-12",60,3,0,8,0,71
"Croydon","17:00:00","2019-07-12",431,30,0,72,1,534
"Ealing","17:00:00","2019-07-12",63,7,0,8,0,78
"Enfield","17:00:00","2019-07-12",253,7,10,24,1,295
"Hillingdon","17:00:00","2019-07-12",35,1,1,9,0,46
"Sutton","17:00:00","2019-07-12",1129,37,38,147,6,1357
"Tower Hamlets","17:00:00","2019-07-12",5162,360,90,985,169,6766
"Barnet","18:00:00","2019-07-12",969,38,68,77,1,1153
"Bromley","18:00:00","2019-07-12",81,2,0,12,0,95
"Camden","18:00:00","2019-07-12",54,5,0,3,1,63
"Croydon","18:00:00","2019-07-12",367,16,0,59,3,445
"Ealing","18:00:00","2019-07-12",92,5,0,9,0,106
"Enfield","18:00:00","2019-07-12",233,6,8,12,0,259
"Hillingdon","18:00:00","2019-07-12",33,0,1,5,0,39
"Sutton","18:00:00","2019-07-12",1140,34,42,97,0,1313
"Tower Hamlets","18:00:00","2019-07-12",5339,247,88,759,139,6572
"Barnet","07:00:00","2019-07-15",27,0,0,4,0,31
"Bromley","07:00:00","2019-07-15",81,2,0,11,1,95
"Haringey","07:00:00","2019-07-15",529,28,10,157,22,746
"Havering","07:00:00","2019-07-15",552,7,10,114,18,701
"Lewisham","07:00:00","2019-07-15",68,1,0,9,0,78
"Barnet","08:00:00","2019-07-15",41,2,0,7,0,50
"Bromley","08:00:00","2019-07-15",119,0,0,15,0,134
"Haringey","08:00:00","2019-07-15",796,32,11,164,30,1033
"Havering","08:00:00","2019-07-15",638,1,11,101,11,762
"Lewisham","08:00:00","2019-07-15",138,0,1,15,1,155
"Barnet","09:00:00","2019-07-15",41,1,0,4,0,46
"Bromley","09:00:00","2019-07-15",83,2,0,10,0,95
"Haringey","09:00:00","2019-07-15",654,21,14,173,25,887
"Havering","09:00:00","2019-07-15",469,1,9,65,5,549
"Lewisham","09:00:00","2019-07-15",137,0,0,13,0,150
"Barnet","10:00:00","2019-07-15",27,0,0,2,0,29
"Bromley","10:00:00","2019-07-15",62,0,0,11,1,74
"Haringey","10:00:00","2019-07-15",525,15,10,157,33,740
"Havering","10:00:00","2019-07-15",559,0,7,67,11,644
"Lewisham","10:00:00","2019-07-15",57,0,0,7,0,64
"Barnet","11:00:00","2019-07-15",32,1,0,4,0,37
"Bromley","11:00:00","2019-07-15",67,0,0,13,0,80
"Haringey","11:00:00","2019-07-15",567,21,9,183,36,816
"Havering","11:00:00","2019-07-15",519,5,6,90,4,624
"Lewisham","11:00:00","2019-07-15",34,0,0,13,0,47
"Barnet","12:00:00","2019-07-15",40,1,0,8,0,49
"Bromley","12:00:00","2019-07-15",66,1,0,9,0,76
"Haringey","12:00:00","2019-07-15",585,17,12,149,20,783
"Havering","12:00:00","2019-07-15",605,2,7,77,7,698
"Lewisham","12:00:00","2019-07-15",37,2,0,9,1,49
"Barnet","13:00:00","2019-07-15",42,1,0,4,0,47
"Bromley","13:00:00","2019-07-15",65,0,0,5,1,71
"Haringey","13:00:00","2019-07-15",591,27,9,169,34,830
"Havering","13:00:00","2019-07-15",543,3,9,74,2,631
"Lewisham","13:00:00","2019-07-15",27,0,0,7,0,34
"Barnet","14:00:00","2019-07-15",38,1,0,6,0,45
"Bromley","14:00:00","2019-07-15",54,0,0,8,0,62
"Haringey","14:00:00","2019-07-15",729,29,11,173,26,968
"Havering","14:00:00","2019-07-15",637,2,12,68,2,721
"Lewisham","14:00:00","2019-07-15",64,0,0,10,1,75
"Barnet","15:00:00","2019-07-15",24,1,0,7,0,32
"Bromley","15:00:00","2019-07-15",78,1,0,10,0,89
"Haringey","15:00:00","2019-07-15",840,22,18,138,31,1049
"Havering","15:00:00","2019-07-15",684,7,11,87,10,799
"Lewisham","15:00:00","2019-07-15",91,0,1,7,0,99
"Barnet","16:00:00","2019-07-15",44,2,0,6,0,52
"Bromley","16:00:00","2019-07-15",93,1,0,11,0,105
"Haringey","16:00:00","2019-07-15",691,38,11,153,17,910
"Havering","16:00:00","2019-07-15",693,6,9,92,3,803
"Lewisham","16:00:00","2019-07-15",52,0,0,6,1,59
"Barnet","17:00:00","2019-07-15",64,4,0,1,0,69
"Bromley","17:00:00","2019-07-15",70,1,0,8,0,79
"Haringey","17:00:00","2019-07-15",830,50,9,136,6,1031
"Havering","17:00:00","2019-07-15",704,7,12,93,1,817
"Lewisham","17:00:00","2019-07-15",81,0,0,4,0,85
"Barnet","18:00:00","2019-07-15",50,3,0,3,0,56
"Bromley","18:00:00","2019-07-15",96,2,0,9,0,107
"Haringey","18:00:00","2019-07-15",874,44,12,118,5,1053
"Havering","18:00:00","2019-07-15",660,2,8,42,0,712
"Lewisham","18:00:00","2019-07-15",72,0,0,4,0,76
"Bromley","07:00:00","2019-07-16",885,19,41,260,19,1224
"City of London","07:00:00","2019-07-16",88,37,19,94,25,263
"Richmond upon Thames","07:00:00","2019-07-16",120,10,77,40,14,261
"Tower Hamlets","07:00:00","2019-07-16",2,1,0,0,1,4
"Bromley","08:00:00","2019-07-16",867,11,43,179,15,1115
"City of London","08:00:00","2019-07-16",124,45,18,91,27,305
"Hillingdon","08:00:00","2019-07-16",6807,123,102,987,477,8496
"Richmond upon Thames","08:00:00","2019-07-16",137,10,74,42,13,276
"Tower Hamlets","08:00:00","2019-07-16",6,6,0,2,0,14
"Bromley","09:00:00","2019-07-16",808,10,42,178,28,1066
"City of London","09:00:00","2019-07-16",118,36,21,97,30,302
"Hillingdon","09:00:00","2019-07-16",6669,75,124,1181,629,8678
"Richmond upon Thames","09:00:00","2019-07-16",130,8,62,44,5,249
"Tower Hamlets","09:00:00","2019-07-16",8,5,0,0,0,13
"Bromley","10:00:00","2019-07-16",832,16,42,194,24,1108
"City of London","10:00:00","2019-07-16",140,21,25,120,19,325
"Hillingdon","10:00:00","2019-07-16",6441,38,88,1199,711,8477
"Richmond upon Thames","10:00:00","2019-07-16",167,11,74,58,9,319
"Tower Hamlets","10:00:00","2019-07-16",8,1,0,8,0,17
"Bromley","11:00:00","2019-07-16",826,14,40,193,22,1095
"City of London","11:00:00","2019-07-16",150,39,16,97,18,320
"Hillingdon","11:00:00","2019-07-16",6466,42,77,1289,716,8590
"Richmond upon Thames","11:00:00","2019-07-16",185,22,77,60,7,351
"Tower Hamlets","11:00:00","2019-07-16",10,6,0,7,2,25
"Bromley","12:00:00","2019-07-16",663,15,36,168,15,897
"City of London","12:00:00","2019-07-16",167,43,18,94,12,334
"Hillingdon","12:00:00","2019-07-16",6352,37,66,1301,704,8460
"Richmond upon Thames","12:00:00","2019-07-16",223,26,77,60,2,388
"Tower Hamlets","12:00:00","2019-07-16",4,11,0,3,0,18
"Bromley","13:00:00","2019-07-16",673,17,38,157,13,898
"City of London","13:00:00","2019-07-16",172,41,18,80,10,321
"Hillingdon","13:00:00","2019-07-16",6612,43,73,1328,665,8721
"Richmond upon Thames","13:00:00","2019-07-16",204,34,84,54,5,381
"Tower Hamlets","13:00:00","2019-07-16",9,8,0,4,0,21
"Bromley","14:00:00","2019-07-16",696,15,37,146,16,910
"City of London","14:00:00","2019-07-16",160,23,19,71,18,291
"Hillingdon","14:00:00","2019-07-16",6624,39,85,1436,684,8868
"Richmond upon Thames","14:00:00","2019-07-16",206,23,74,33,7,343
"Tower Hamlets","14:00:00","2019-07-16",15,7,0,8,0,30
"Bromley","15:00:00","2019-07-16",754,25,44,185,7,1015
"City of London","15:00:00","2019-07-16",151,28,16,75,9,279
"Hillingdon","15:00:00","2019-07-16",6767,65,79,1428,564,8903
"Richmond upon Thames","15:00:00","2019-07-16",202,32,81,53,7,375
"Tower Hamlets","15:00:00","2019-07-16",5,3,0,4,0,12
"Bromley","16:00:00","2019-07-16",1023,25,47,201,6,1302
"City of London","16:00:00","2019-07-16",168,46,20,49,12,295
"Richmond upon Thames","16:00:00","2019-07-16",244,36,77,30,2,389
"Tower Hamlets","16:00:00","2019-07-16",5,5,0,2,0,12
"Bromley","17:00:00","2019-07-16",903,26,37,136,4,1106
"City of London","17:00:00","2019-07-16",152,64,24,39,6,285
"Richmond upon Thames","17:00:00","2019-07-16",269,47,81,27,1,425
"Tower Hamlets","17:00:00","2019-07-16",14,9,0,1,0,24
"Bromley","18:00:00","2019-07-16",977,36,35,101,1,1150
"City of London","18:00:00","2019-07-16",173,70,22,21,1,287
"Richmond upon Thames","18:00:00","2019-07-16",249,31,77,18,0,375
"Tower Hamlets","18:00:00","2019-07-16",8,15,0,4,0,27
"Barnet","07:00:00","2019-07-17",2715,56,10,795,302,3878
"Bromley","07:00:00","2019-07-17",970,16,2,257,23,1268
"Havering","07:00:00","2019-07-17",249,6,9,61,10,335
"Kensington and Chelsea","07:00:00","2019-07-17",409,76,51,173,27,736
"Barnet","08:00:00","2019-07-17",2947,57,17,571,286,3878
"Bromley","08:00:00","2019-07-17",1073,13,9,226,38,1359
"Havering","08:00:00","2019-07-17",380,0,13,61,9,463
"Kensington and Chelsea","08:00:00","2019-07-17",459,67,56,240,22,844
"Barnet","09:00:00","2019-07-17",2541,46,37,581,370,3575
"Bromley","09:00:00","2019-07-17",925,5,0,167,36,1133
"Havering","09:00:00","2019-07-17",251,4,7,33,13,308
"Kensington and Chelsea","09:00:00","2019-07-17",415,62,48,175,26,726
"Barnet","10:00:00","2019-07-17",2150,23,13,623,342,3151
"Bromley","10:00:00","2019-07-17",958,10,3,179,47,1197
"Havering","10:00:00","2019-07-17",294,4,10,34,9,351
"Kensington and Chelsea","10:00:00","2019-07-17",404,52,50,181,22,709
"Barnet","11:00:00","2019-07-17",2301,23,13,641,345,3323
"Bromley","11:00:00","2019-07-17",897,7,2,177,41,1124
"Havering","11:00:00","2019-07-17",312,2,8,49,10,381
"Kensington and Chelsea","11:00:00","2019-07-17",365,52,47,188,17,669
"Barnet","12:00:00","2019-07-17",2298,21,18,689,356,3382
"Bromley","12:00:00","2019-07-17",846,5,3,178,29,1061
"Havering","12:00:00","2019-07-17",320,2,10,50,8,390
"Kensington and Chelsea","12:00:00","2019-07-17",428,65,44,143,27,707
"Barnet","13:00:00","2019-07-17",2355,26,16,741,346,3484
"Bromley","13:00:00","2019-07-17",936,6,0,193,22,1157
"Havering","13:00:00","2019-07-17",317,1,8,48,4,378
"Kensington and Chelsea","13:00:00","2019-07-17",447,92,42,165,13,759
"Barnet","14:00:00","2019-07-17",2628,40,30,845,353,3896
"Bromley","14:00:00","2019-07-17",970,10,5,195,19,1199
"Havering","14:00:00","2019-07-17",296,2,8,46,9,361
"Kensington and Chelsea","14:00:00","2019-07-17",481,95,46,147,27,796
"Barnet","15:00:00","2019-07-17",2910,45,22,1059,291,4327
"Bromley","15:00:00","2019-07-17",995,6,4,175,21,1201
"Havering","15:00:00","2019-07-17",329,2,11,48,8,398
"Kensington and Chelsea","15:00:00","2019-07-17",417,105,46,113,15,696
"Barnet","16:00:00","2019-07-17",3673,58,13,1121,238,5103
"Bromley","16:00:00","2019-07-17",961,8,4,229,11,1213
"Havering","16:00:00","2019-07-17",344,2,9,52,3,410
"Kensington and Chelsea","16:00:00","2019-07-17",477,105,39,124,6,751
"Barnet","17:00:00","2019-07-17",3920,86,30,835,151,5022
"Bromley","17:00:00","2019-07-17",962,9,2,194,13,1180
"Havering","17:00:00","2019-07-17",371,4,8,41,4,428
"Kensington and Chelsea","17:00:00","2019-07-17",542,125,48,104,7,826
"Barnet","18:00:00","2019-07-17",3542,88,15,553,126,4324
"Bromley","18:00:00","2019-07-17",820,8,0,138,8,974
"Havering","18:00:00","2019-07-17",265,2,8,33,2,310
"Kensington and Chelsea","18:00:00","2019-07-17",594,141,46,71,3,855
"Barking and Dagenham","07:00:00","2019-07-18",70,0,0,7,0,77
"Bromley","07:00:00","2019-07-18",227,1,2,43,2,275
"Ealing","07:00:00","2019-07-18",121,2,0,24,0,147
"Haringey","07:00:00","2019-07-18",34,1,0,4,0,39
"Havering","07:00:00","2019-07-18",25,0,0,11,0,36
"Hillingdon","07:00:00","2019-07-18",173,1,0,32,2,208
"Islington","07:00:00","2019-07-18",15,0,0,9,2,26
"Kingston upon Thames","07:00:00","2019-07-18",277,9,2,57,6,351
"Merton","07:00:00","2019-07-18",32,0,0,11,1,44
"Tower Hamlets","07:00:00","2019-07-18",208,62,9,210,44,533
"Waltham Forest","07:00:00","2019-07-18",23,1,0,2,0,26
"Barking and Dagenham","08:00:00","2019-07-18",58,0,0,3,0,61
"Bromley","08:00:00","2019-07-18",693,0,10,78,5,786
"Ealing","08:00:00","2019-07-18",183,5,0,18,0,206
"Haringey","08:00:00","2019-07-18",58,1,0,11,3,73
"Havering","08:00:00","2019-07-18",25,0,0,4,0,29
"Hillingdon","08:00:00","2019-07-18",242,1,0,42,1,286
"Islington","08:00:00","2019-07-18",23,1,0,8,0,32
"Kingston upon Thames","08:00:00","2019-07-18",429,14,2,51,7,503
"Merton","08:00:00","2019-07-18",87,1,0,6,0,94
"Tower Hamlets","08:00:00","2019-07-18",293,71,7,191,46,608
"Waltham Forest","08:00:00","2019-07-18",32,0,0,8,1,41
"Barking and Dagenham","09:00:00","2019-07-18",53,0,0,8,1,62
"Bromley","09:00:00","2019-07-18",375,0,3,48,5,431
"Ealing","09:00:00","2019-07-18",109,4,0,19,1,133
"Haringey","09:00:00","2019-07-18",47,1,0,6,1,55
"Havering","09:00:00","2019-07-18",39,0,0,11,2,52
"Hillingdon","09:00:00","2019-07-18",160,1,0,21,0,182
"Islington","09:00:00","2019-07-18",8,5,0,5,1,19
"Kingston upon Thames","09:00:00","2019-07-18",286,7,0,52,6,351
"Merton","09:00:00","2019-07-18",36,0,0,4,1,41
"Tower Hamlets","09:00:00","2019-07-18",224,53,5,186,35,503
"Waltham Forest","09:00:00","2019-07-18",17,0,0,1,0,18
"Barking and Dagenham","10:00:00","2019-07-18",53,0,0,8,0,61
"Bromley","10:00:00","2019-07-18",208,1,2,35,4,250
"Ealing","10:00:00","2019-07-18",85,1,0,16,1,103
"Haringey","10:00:00","2019-07-18",49,2,0,12,0,63
"Havering","10:00:00","2019-07-18",33,0,0,5,0,38
"Hillingdon","10:00:00","2019-07-18",93,4,0,23,1,121
"Islington","10:00:00","2019-07-18",19,1,0,17,0,37
"Kingston upon Thames","10:00:00","2019-07-18",248,6,1,74,8,337
"Merton","10:00:00","2019-07-18",24,0,0,4,4,32
"Tower Hamlets","10:00:00","2019-07-18",239,23,7,160,54,483
"Waltham Forest","10:00:00","2019-07-18",13,0,0,4,0,17
"Barking and Dagenham","11:00:00","2019-07-18",50,0,0,7,1,58
"Bromley","11:00:00","2019-07-18",180,0,2,31,2,215
"Ealing","11:00:00","2019-07-18",94,1,0,27,0,122
"Haringey","11:00:00","2019-07-18",51,1,0,17,1,70
"Havering","11:00:00","2019-07-18",42,0,0,7,0,49
"Hillingdon","11:00:00","2019-07-18",108,2,0,24,1,135
"Islington","11:00:00","2019-07-18",25,0,0,4,0,29
"Kingston upon Thames","11:00:00","2019-07-18",325,4,1,52,3,385
"Merton","11:00:00","2019-07-18",45,3,0,5,0,53
"Tower Hamlets","11:00:00","2019-07-18",241,44,2,162,46,495
"Waltham Forest","11:00:00","2019-07-18",21,0,0,4,0,25
"Barking and Dagenham","12:00:00","2019-07-18",63,0,0,5,0,68
"Bromley","12:00:00","2019-07-18",215,1,5,40,7,268
"Ealing","12:00:00","2019-07-18",72,2,0,19,0,93
"Haringey","12:00:00","2019-07-18",56,0,0,3,0,59
"Havering","12:00:00","2019-07-18",30,0,0,6,0,36
"Hillingdon","12:00:00","2019-07-18",111,3,0,16,0,130
"Islington","12:00:00","2019-07-18",20,4,0,7,0,31
"Kingston upon Thames","12:00:00","2019-07-18",213,10,0,53,2,278
"Merton","12:00:00","2019-07-18",25,0,0,11,3,39
"Tower Hamlets","12:00:00","2019-07-18",284,41,6,188,27,546
"Waltham Forest","12:00:00","2019-07-18",15,0,0,6,0,21
"Barking and Dagenham","13:00:00","2019-07-18",57,0,0,9,0,66
"Bromley","13:00:00","2019-07-18",195,2,3,40,2,242
"Ealing","13:00:00","2019-07-18",70,5,0,16,0,91
"Haringey","13:00:00","2019-07-18",30,0,0,10,0,40
"Havering","13:00:00","2019-07-18",45,0,0,7,1,53
"Hillingdon","13:00:00","2019-07-18",142,5,0,20,3,170
"Islington","13:00:00","2019-07-18",18,4,0,4,2,28
"Kingston upon Thames","13:00:00","2019-07-18",279,19,2,46,9,355
"Merton","13:00:00","2019-07-18",32,3,0,10,2,47
"Tower Hamlets","13:00:00","2019-07-18",248,53,2,169,35,507
"Waltham Forest","13:00:00","2019-07-18",19,0,0,2,0,21
"Barking and Dagenham","14:00:00","2019-07-18",59,0,0,3,0,62
"Bromley","14:00:00","2019-07-18",289,1,4,48,2,344
"Ealing","14:00:00","2019-07-18",94,4,0,16,0,114
"Haringey","14:00:00","2019-07-18",60,0,0,7,0,67
"Havering","14:00:00","2019-07-18",38,0,0,6,0,44
"Hillingdon","14:00:00","2019-07-18",160,6,0,24,1,191
"Islington","14:00:00","2019-07-18",8,1,0,3,0,12
"Kingston upon Thames","14:00:00","2019-07-18",247,6,2,45,6,306
"Merton","14:00:00","2019-07-18",45,3,0,11,0,59
"Tower Hamlets","14:00:00","2019-07-18",322,56,2,148,38,566
"Waltham Forest","14:00:00","2019-07-18",19,0,0,2,0,21
"Barking and Dagenham","15:00:00","2019-07-18",48,2,0,3,0,53
"Bromley","15:00:00","2019-07-18",324,3,2,40,3,372
"Ealing","15:00:00","2019-07-18",127,4,0,25,0,156
"Haringey","15:00:00","2019-07-18",50,1,0,13,0,64
"Havering","15:00:00","2019-07-18",40,0,0,4,0,44
"Hillingdon","15:00:00","2019-07-18",165,4,0,33,2,204
"Islington","15:00:00","2019-07-18",23,6,0,5,0,34
"Kingston upon Thames","15:00:00","2019-07-18",323,5,1,49,1,379
"Merton","15:00:00","2019-07-18",46,0,0,6,1,53
"Tower Hamlets","15:00:00","2019-07-18",296,40,1,196,19,552
"Waltham Forest","15:00:00","2019-07-18",27,0,0,6,0,33
"Barking and Dagenham","16:00:00","2019-07-18",68,0,0,5,0,73
"Bromley","16:00:00","2019-07-18",299,0,4,47,4,354
"Ealing","16:00:00","2019-07-18",102,3,0,25,0,130
"Haringey","16:00:00","2019-07-18",53,0,0,3,0,56
"Havering","16:00:00","2019-07-18",36,0,0,3,0,39
"Hillingdon","16:00:00","2019-07-18",211,5,0,25,0,241
"Islington","16:00:00","2019-07-18",31,2,0,3,2,38
"Kingston upon Thames","16:00:00","2019-07-18",347,15,0,50,1,413
"Merton","16:00:00","2019-07-18",41,0,0,6,0,47
"Tower Hamlets","16:00:00","2019-07-18",309,59,2,165,23,558
"Waltham Forest","16:00:00","2019-07-18",32,1,0,3,0,36
"Barking and Dagenham","17:00:00","2019-07-18",77,0,0,6,0,83
"Bromley","17:00:00","2019-07-18",408,1,2,34,3,448
"Ealing","17:00:00","2019-07-18",79,2,0,14,0,95
"Haringey","17:00:00","2019-07-18",45,2,0,2,0,49
"Havering","17:00:00","2019-07-18",29,0,0,1,0,30
"Hillingdon","17:00:00","2019-07-18",250,1,0,28,2,281
"Islington","17:00:00","2019-07-18",11,4,0,7,0,22
"Kingston upon Thames","17:00:00","2019-07-18",372,20,1,36,2,431
"Merton","17:00:00","2019-07-18",29,0,0,9,0,38
"Tower Hamlets","17:00:00","2019-07-18",380,86,1,124,12,603
"Waltham Forest","17:00:00","2019-07-18",29,0,0,2,0,31
"Barking and Dagenham","18:00:00","2019-07-18",86,0,0,4,0,90
"Bromley","18:00:00","2019-07-18",426,0,2,32,2,462
"Ealing","18:00:00","2019-07-18",130,6,0,12,0,148
"Haringey","18:00:00","2019-07-18",88,1,0,3,3,95
"Havering","18:00:00","2019-07-18",26,0,0,1,0,27
"Hillingdon","18:00:00","2019-07-18",156,7,0,21,3,187
"Islington","18:00:00","2019-07-18",28,3,0,2,0,33
"Kingston upon Thames","18:00:00","2019-07-18",330,20,1,19,0,370
"Merton","18:00:00","2019-07-18",45,0,0,7,0,52
"Tower Hamlets","18:00:00","2019-07-18",343,106,3,96,10,558
"Waltham Forest","18:00:00","2019-07-18",23,0,0,3,0,26
"Barking and Dagenham","07:00:00","2019-07-19",67,0,0,9,0,76
"Camden","07:00:00","2019-07-19",470,79,76,248,56,929
"Croydon","07:00:00","2019-07-19",116,2,11,21,3,153
"Ealing","07:00:00","2019-07-19",476,34,6,423,88,1027
"Haringey","07:00:00","2019-07-19",540,14,32,152,19,757
"Sutton","07:00:00","2019-07-19",77,0,0,11,0,88
"Barking and Dagenham","08:00:00","2019-07-19",82,0,0,9,2,93
"Camden","08:00:00","2019-07-19",459,114,78,278,63,992
"Croydon","08:00:00","2019-07-19",204,2,8,27,1,242
"Ealing","08:00:00","2019-07-19",513,35,9,364,77,998
"Haringey","08:00:00","2019-07-19",593,12,49,155,11,820
"Sutton","08:00:00","2019-07-19",173,0,0,14,3,190
"Barking and Dagenham","09:00:00","2019-07-19",52,0,2,15,1,70
"Camden","09:00:00","2019-07-19",535,72,72,272,53,1004
"Croydon","09:00:00","2019-07-19",106,1,12,27,1,147
"Ealing","09:00:00","2019-07-19",478,30,12,343,96,959
"Haringey","09:00:00","2019-07-19",673,27,37,148,21,906
"Sutton","09:00:00","2019-07-19",75,1,0,7,0,83
"Barking and Dagenham","10:00:00","2019-07-19",52,0,0,14,0,66
"Camden","10:00:00","2019-07-19",593,62,75,311,59,1100
"Croydon","10:00:00","2019-07-19",80,2,10,20,1,113
"Ealing","10:00:00","2019-07-19",486,36,8,302,79,911
"Haringey","10:00:00","2019-07-19",606,14,28,158,23,829
"Sutton","10:00:00","2019-07-19",68,0,0,5,0,73
"Barking and Dagenham","11:00:00","2019-07-19",66,0,0,11,0,77
"Camden","11:00:00","2019-07-19",647,61,67,307,56,1138
"Croydon","11:00:00","2019-07-19",84,1,11,30,0,126
"Ealing","11:00:00","2019-07-19",570,25,8,272,58,933
"Haringey","11:00:00","2019-07-19",514,12,27,138,18,709
"Sutton","11:00:00","2019-07-19",75,1,0,5,0,81
"Barking and Dagenham","12:00:00","2019-07-19",66,0,1,14,1,82
"Camden","12:00:00","2019-07-19",639,47,78,283,58,1105
"Croydon","12:00:00","2019-07-19",107,1,8,19,0,135
"Ealing","12:00:00","2019-07-19",647,27,3,265,74,1016
"Haringey","12:00:00","2019-07-19",625,21,28,178,12,864
"Sutton","12:00:00","2019-07-19",71,0,0,10,1,82
"Barking and Dagenham","13:00:00","2019-07-19",73,0,0,13,1,87
"Camden","13:00:00","2019-07-19",745,72,68,257,43,1185
"Croydon","13:00:00","2019-07-19",169,2,11,33,3,218
"Ealing","13:00:00","2019-07-19",650,37,7,270,58,1022
"Haringey","13:00:00","2019-07-19",705,30,31,143,7,916
"Sutton","13:00:00","2019-07-19",77,2,0,6,0,85
"Barking and Dagenham","14:00:00","2019-07-19",60,0,0,16,2,78
"Camden","14:00:00","2019-07-19",739,87,64,302,33,1225
"Croydon","14:00:00","2019-07-19",115,5,9,24,0,153
"Ealing","14:00:00","2019-07-19",696,46,6,275,56,1079
"Haringey","14:00:00","2019-07-19",755,23,31,178,13,1000
"Sutton","14:00:00","2019-07-19",118,0,0,7,0,125
"Barking and Dagenham","15:00:00","2019-07-19",68,0,0,6,0,74
"Camden","15:00:00","2019-07-19",658,74,78,305,51,1166
"Croydon","15:00:00","2019-07-19",144,7,13,17,0,181
"Ealing","15:00:00","2019-07-19",900,43,7,282,58,1290
"Haringey","15:00:00","2019-07-19",634,17,29,127,13,820
"Sutton","15:00:00","2019-07-19",63,0,0,9,0,72
"Barking and Dagenham","16:00:00","2019-07-19",69,0,1,15,0,85
"Camden","16:00:00","2019-07-19",743,103,79,249,21,1195
"Croydon","16:00:00","2019-07-19",118,6,12,24,2,162
"Ealing","16:00:00","2019-07-19",978,41,5,250,27,1301
"Haringey","16:00:00","2019-07-19",651,27,37,128,7,850
"Sutton","16:00:00","2019-07-19",60,4,0,5,0,69
"Barking and Dagenham","17:00:00","2019-07-19",75,0,0,5,0,80
"Camden","17:00:00","2019-07-19",877,109,66,187,18,1257
"Croydon","17:00:00","2019-07-19",146,5,9,15,1,176
"Ealing","17:00:00","2019-07-19",1126,69,5,194,20,1414
"Haringey","17:00:00","2019-07-19",740,46,46,97,5,934
"Sutton","17:00:00","2019-07-19",88,3,0,11,0,102
"Barking and Dagenham","18:00:00","2019-07-19",82,0,0,4,0,86
"Camden","18:00:00","2019-07-19",896,117,73,149,9,1244
"Croydon","18:00:00","2019-07-19",165,7,11,17,1,201
"Ealing","18:00:00","2019-07-19",926,45,7,143,15,1136
"Haringey","18:00:00","2019-07-19",765,67,48,85,4,969
"Sutton","18:00:00","2019-07-19",78,7,0,5,0,90
"Bexley","07:00:00","2019-09-04",10,0,0,4,0,14
"Camden","07:00:00","2019-09-04",74,22,19,94,19,228
"Croydon","07:00:00","2019-09-04",529,4,9,108,12,662
"Wandsworth","07:00:00","2019-09-04",606,34,24,247,19,930
"Bexley","08:00:00","2019-09-04",12,0,0,2,0,14
"Camden","08:00:00","2019-09-04",118,40,18,77,18,271
"Croydon","08:00:00","2019-09-04",560,7,6,84,7,664
"Wandsworth","08:00:00","2019-09-04",543,41,20,206,22,832
"Bexley","09:00:00","2019-09-04",13,0,0,2,0,15
"Camden","09:00:00","2019-09-04",134,37,29,57,26,283
"Croydon","09:00:00","2019-09-04",353,2,6,84,13,458
"Wandsworth","09:00:00","2019-09-04",491,24,22,199,13,749
"Bexley","10:00:00","2019-09-04",13,0,0,6,0,19
"Camden","10:00:00","2019-09-04",125,29,20,60,26,260
"Croydon","10:00:00","2019-09-04",297,4,6,69,9,385
"Wandsworth","10:00:00","2019-09-04",482,19,21,193,14,729
"Bexley","11:00:00","2019-09-04",16,0,0,9,1,26
"Camden","11:00:00","2019-09-04",144,38,15,67,22,286
"Croydon","11:00:00","2019-09-04",329,4,7,82,8,430
"Wandsworth","11:00:00","2019-09-04",387,17,21,182,21,628
"Bexley","12:00:00","2019-09-04",14,0,0,3,1,18
"Camden","12:00:00","2019-09-04",140,41,15,63,30,289
"Croydon","12:00:00","2019-09-04",380,4,6,67,7,464
"Wandsworth","12:00:00","2019-09-04",426,21,25,145,17,634
"Bexley","13:00:00","2019-09-04",15,0,0,3,1,19
"Camden","13:00:00","2019-09-04",139,31,16,68,16,270
"Croydon","13:00:00","2019-09-04",344,3,7,94,10,458
"Wandsworth","13:00:00","2019-09-04",483,31,22,151,21,708
"Bexley","14:00:00","2019-09-04",10,1,0,2,0,13
"Camden","14:00:00","2019-09-04",155,33,27,60,14,289
"Croydon","14:00:00","2019-09-04",402,4,6,92,4,508
"Wandsworth","14:00:00","2019-09-04",377,22,23,165,19,606
"Bexley","15:00:00","2019-09-04",18,2,0,1,0,21
"Camden","15:00:00","2019-09-04",217,28,18,49,16,328
"Croydon","15:00:00","2019-09-04",457,3,7,85,1,553
"Wandsworth","15:00:00","2019-09-04",504,29,22,157,8,720
"Bexley","16:00:00","2019-09-04",25,0,0,0,0,25
"Camden","16:00:00","2019-09-04",211,31,17,47,11,317
"Croydon","16:00:00","2019-09-04",501,2,8,104,4,619
"Wandsworth","16:00:00","2019-09-04",566,39,21,145,4,775
"Bexley","17:00:00","2019-09-04",16,0,0,0,0,16
"Camden","17:00:00","2019-09-04",242,36,17,28,3,326
"Croydon","17:00:00","2019-09-04",625,10,6,70,1,712
"Wandsworth","17:00:00","2019-09-04",530,49,22,142,3,746
"Bexley","18:00:00","2019-09-04",14,0,0,0,0,14
"Camden","18:00:00","2019-09-04",246,47,14,20,1,328
"Croydon","18:00:00","2019-09-04",562,6,7,58,0,633
"Wandsworth","18:00:00","2019-09-04",578,34,22,91,2,727
"Ealing","07:00:00","2019-09-05",4066,167,18,1432,507,6190
"Kingston upon Thames","07:00:00","2019-09-05",99,0,0,11,0,110
"Lambeth","07:00:00","2019-09-05",402,25,0,143,5,575
"Tower Hamlets","07:00:00","2019-09-05",1082,296,42,481,251,2152
"Westminster","07:00:00","2019-09-05",2006,334,137,819,272,3568
"Ealing","08:00:00","2019-09-05",4045,130,19,1103,462,5759
"Kingston upon Thames","08:00:00","2019-09-05",211,3,0,18,1,233
"Lambeth","08:00:00","2019-09-05",342,17,0,97,4,460
"Tower Hamlets","08:00:00","2019-09-05",1143,237,40,498,256,2174
"Westminster","08:00:00","2019-09-05",2065,415,136,693,298,3607
"Ealing","09:00:00","2019-09-05",3779,86,23,1107,581,5576
"Kingston upon Thames","09:00:00","2019-09-05",100,1,0,32,2,135
"Lambeth","09:00:00","2019-09-05",436,15,2,126,12,591
"Tower Hamlets","09:00:00","2019-09-05",1120,189,46,475,283,2113
"Westminster","09:00:00","2019-09-05",2340,300,140,672,266,3718
"Ealing","10:00:00","2019-09-05",3615,68,15,1221,648,5567
"Kingston upon Thames","10:00:00","2019-09-05",88,0,0,21,2,111
"Lambeth","10:00:00","2019-09-05",328,8,0,100,10,446
"Tower Hamlets","10:00:00","2019-09-05",1081,89,40,559,295,2064
"Westminster","10:00:00","2019-09-05",2285,163,126,693,310,3577
"Ealing","11:00:00","2019-09-05",3491,63,15,1156,611,5336
"Kingston upon Thames","11:00:00","2019-09-05",82,0,0,16,2,100
"Lambeth","11:00:00","2019-09-05",363,8,0,134,7,512
"Tower Hamlets","11:00:00","2019-09-05",1140,101,32,521,260,2054
"Westminster","11:00:00","2019-09-05",2196,200,126,718,279,3519
"Ealing","12:00:00","2019-09-05",3245,75,16,1147,590,5073
"Kingston upon Thames","12:00:00","2019-09-05",87,4,0,22,0,113
"Lambeth","12:00:00","2019-09-05",391,16,0,149,11,567
"Tower Hamlets","12:00:00","2019-09-05",1318,97,40,721,249,2425
"Westminster","12:00:00","2019-09-05",2210,198,123,728,255,3514
"Ealing","13:00:00","2019-09-05",3393,70,10,1081,569,5123
"Kingston upon Thames","13:00:00","2019-09-05",88,1,0,18,0,107
"Lambeth","13:00:00","2019-09-05",364,18,0,133,13,528
"Tower Hamlets","13:00:00","2019-09-05",1328,100,45,684,285,2442
"Westminster","13:00:00","2019-09-05",2348,175,122,679,252,3576
"Ealing","14:00:00","2019-09-05",3589,89,16,1156,515,5365
"Kingston upon Thames","14:00:00","2019-09-05",96,2,0,19,2,119
"Lambeth","14:00:00","2019-09-05",479,17,0,140,11,647
"Tower Hamlets","14:00:00","2019-09-05",1391,113,31,787,270,2592
"Westminster","14:00:00","2019-09-05",2503,217,124,678,210,3732
"Ealing","15:00:00","2019-09-05",3753,88,9,1123,431,5404
"Kingston upon Thames","15:00:00","2019-09-05",136,3,0,15,0,154
"Lambeth","15:00:00","2019-09-05",500,17,0,148,9,674
"Tower Hamlets","15:00:00","2019-09-05",1533,151,36,725,210,2655
"Westminster","15:00:00","2019-09-05",2570,224,122,682,159,3757
"Ealing","16:00:00","2019-09-05",4361,134,16,1183,333,6027
"Kingston upon Thames","16:00:00","2019-09-05",124,2,0,23,0,149
"Lambeth","16:00:00","2019-09-05",532,30,0,172,14,748
"Tower Hamlets","16:00:00","2019-09-05",1504,218,53,680,145,2600
"Westminster","16:00:00","2019-09-05",2582,307,142,652,113,3796
"Ealing","17:00:00","2019-09-05",4368,174,11,901,196,5650
"Kingston upon Thames","17:00:00","2019-09-05",164,1,0,16,0,181
"Lambeth","17:00:00","2019-09-05",635,38,0,151,4,828
"Tower Hamlets","17:00:00","2019-09-05",1902,353,62,610,93,3020
"Westminster","17:00:00","2019-09-05",2814,422,144,481,78,3939
"Ealing","18:00:00","2019-09-05",4670,151,19,747,191,5778
"Kingston upon Thames","18:00:00","2019-09-05",144,4,0,10,0,158
"Lambeth","18:00:00","2019-09-05",634,24,0,92,2,752
"Tower Hamlets","18:00:00","2019-09-05",2109,292,56,441,66,2964
"Westminster","18:00:00","2019-09-05",2974,464,126,292,60,3916
"Barnet","07:00:00","2019-09-06",614,8,11,65,5,703
"Bromley","07:00:00","2019-09-06",22,0,0,8,1,31
"City of London","07:00:00","2019-09-06",228,116,84,267,99,794
"Hillingdon","07:00:00","2019-09-06",4,0,0,0,0,4
"Hounslow","07:00:00","2019-09-06",631,11,109,121,25,897
"Kensington and Chelsea","07:00:00","2019-09-06",123,8,14,35,8,188
"Southwark","07:00:00","2019-09-06",460,46,21,164,10,701
"Barnet","08:00:00","2019-09-06",817,3,13,63,3,899
"Bromley","08:00:00","2019-09-06",30,3,0,3,0,36
"City of London","08:00:00","2019-09-06",227,100,75,269,73,744
"Hillingdon","08:00:00","2019-09-06",2,1,0,0,2,5
"Hounslow","08:00:00","2019-09-06",858,15,106,126,25,1130
"Kensington and Chelsea","08:00:00","2019-09-06",157,16,18,45,2,238
"Southwark","08:00:00","2019-09-06",494,26,25,119,6,670
"Barnet","09:00:00","2019-09-06",544,3,11,74,7,639
"Bromley","09:00:00","2019-09-06",24,0,0,5,0,29
"City of London","09:00:00","2019-09-06",277,76,90,285,63,791
"Hillingdon","09:00:00","2019-09-06",9,0,0,0,0,9
"Hounslow","09:00:00","2019-09-06",803,10,118,108,24,1063
"Kensington and Chelsea","09:00:00","2019-09-06",199,22,14,56,7,298
"Southwark","09:00:00","2019-09-06",456,14,27,95,5,597
"Barnet","10:00:00","2019-09-06",404,1,8,48,4,465
"Bromley","10:00:00","2019-09-06",19,0,0,2,1,22
"City of London","10:00:00","2019-09-06",246,43,82,273,77,721
"Hillingdon","10:00:00","2019-09-06",7,0,0,0,4,11
"Hounslow","10:00:00","2019-09-06",715,17,105,148,25,1010
"Kensington and Chelsea","10:00:00","2019-09-06",151,20,14,38,18,241
"Southwark","10:00:00","2019-09-06",390,13,24,117,9,553
"Barnet","11:00:00","2019-09-06",388,2,7,47,5,449
"Bromley","11:00:00","2019-09-06",24,0,0,3,2,29
"City of London","11:00:00","2019-09-06",382,63,79,294,76,894
"Hillingdon","11:00:00","2019-09-06",6,0,0,2,0,8
"Hounslow","11:00:00","2019-09-06",729,19,102,151,35,1036
"Kensington and Chelsea","11:00:00","2019-09-06",160,33,14,51,10,268
"Southwark","11:00:00","2019-09-06",364,14,17,107,7,509
"Barnet","12:00:00","2019-09-06",393,2,8,47,7,457
"Bromley","12:00:00","2019-09-06",20,0,0,2,0,22
"City of London","12:00:00","2019-09-06",350,82,76,264,79,851
"Hillingdon","12:00:00","2019-09-06",11,0,0,4,0,15
"Hounslow","12:00:00","2019-09-06",845,27,99,131,27,1129
"Kensington and Chelsea","12:00:00","2019-09-06",242,38,13,35,2,330
"Southwark","12:00:00","2019-09-06",372,21,26,119,9,547
"Barnet","13:00:00","2019-09-06",383,1,9,49,10,452
"Bromley","13:00:00","2019-09-06",20,0,0,6,0,26
"City of London","13:00:00","2019-09-06",330,45,73,278,76,802
"Hillingdon","13:00:00","2019-09-06",8,0,0,0,0,8
"Hounslow","13:00:00","2019-09-06",826,23,93,126,11,1079
"Kensington and Chelsea","13:00:00","2019-09-06",138,38,17,41,6,240
"Southwark","13:00:00","2019-09-06",341,15,19,99,10,484
"Barnet","14:00:00","2019-09-06",413,1,9,52,2,477
"Bromley","14:00:00","2019-09-06",28,0,0,3,0,31
"City of London","14:00:00","2019-09-06",445,52,75,306,59,937
"Hillingdon","14:00:00","2019-09-06",6,1,0,0,0,7
"Hounslow","14:00:00","2019-09-06",942,24,103,131,19,1219
"Kensington and Chelsea","14:00:00","2019-09-06",217,50,14,31,4,316
"Southwark","14:00:00","2019-09-06",490,21,18,118,1,648
"Barnet","15:00:00","2019-09-06",640,4,11,61,5,721
"Bromley","15:00:00","2019-09-06",25,0,0,4,0,29
"City of London","15:00:00","2019-09-06",378,76,72,227,63,816
"Hillingdon","15:00:00","2019-09-06",11,0,0,0,0,11
"Hounslow","15:00:00","2019-09-06",910,46,93,112,13,1174
"Kensington and Chelsea","15:00:00","2019-09-06",216,40,15,37,3,311
"Southwark","15:00:00","2019-09-06",531,14,19,104,2,670
"Barnet","16:00:00","2019-09-06",532,5,10,63,3,613
"Bromley","16:00:00","2019-09-06",30,0,0,2,0,32
"City of London","16:00:00","2019-09-06",460,88,84,202,45,879
"Hillingdon","16:00:00","2019-09-06",10,0,0,4,0,14
"Hounslow","16:00:00","2019-09-06",1037,41,107,124,8,1317
"Kensington and Chelsea","16:00:00","2019-09-06",148,23,18,26,3,218
"Southwark","16:00:00","2019-09-06",537,38,22,145,1,743
"Barnet","17:00:00","2019-09-06",506,3,9,45,0,563
"Bromley","17:00:00","2019-09-06",36,0,0,6,0,42
"City of London","17:00:00","2019-09-06",595,122,82,170,27,996
"Hillingdon","17:00:00","2019-09-06",6,0,0,1,0,7
"Hounslow","17:00:00","2019-09-06",953,37,107,99,3,1199
"Kensington and Chelsea","17:00:00","2019-09-06",191,39,16,18,0,264
"Southwark","17:00:00","2019-09-06",628,33,22,95,1,779
"Barnet","18:00:00","2019-09-06",481,4,13,27,2,527
"Bromley","18:00:00","2019-09-06",33,0,0,0,0,33
"City of London","18:00:00","2019-09-06",647,121,89,175,26,1058
"Hillingdon","18:00:00","2019-09-06",4,0,0,2,0,6
"Hounslow","18:00:00","2019-09-06",1027,42,105,75,0,1249
"Kensington and Chelsea","18:00:00","2019-09-06",247,56,16,13,1,333
"Southwark","18:00:00","2019-09-06",673,41,23,76,2,815
"Barnet","07:00:00","2019-09-09",74,2,0,12,2,90
"Bexley","07:00:00","2019-09-09",407,3,0,86,2,498
"Greenwich","07:00:00","2019-09-09",806,13,30,151,5,1005
"Harrow","07:00:00","2019-09-09",53,0,0,15,0,68
"Hillingdon","07:00:00","2019-09-09",1058,14,19,250,39,1380
"Hounslow","07:00:00","2019-09-09",47,0,0,15,0,62
"Lambeth","07:00:00","2019-09-09",183,8,0,68,2,261
"Newham","07:00:00","2019-09-09",495,16,13,184,26,734
"Westminster","07:00:00","2019-09-09",12,2,0,4,1,19
"Barnet","08:00:00","2019-09-09",251,2,0,15,1,269
"Bexley","08:00:00","2019-09-09",667,5,0,89,3,764
"Greenwich","08:00:00","2019-09-09",867,6,22,116,6,1017
"Harrow","08:00:00","2019-09-09",126,0,0,13,0,139
"Hillingdon","08:00:00","2019-09-09",1349,18,18,235,53,1673
"Hounslow","08:00:00","2019-09-09",55,1,2,4,1,63
"Lambeth","08:00:00","2019-09-09",269,10,2,58,6,345
"Newham","08:00:00","2019-09-09",757,13,14,182,37,1003
"Westminster","08:00:00","2019-09-09",17,0,2,4,2,25
"Barnet","09:00:00","2019-09-09",117,7,0,19,0,143
"Bexley","09:00:00","2019-09-09",453,2,0,75,0,530
"Greenwich","09:00:00","2019-09-09",709,5,26,150,14,904
"Harrow","09:00:00","2019-09-09",63,0,0,10,1,74
"Hillingdon","09:00:00","2019-09-09",1105,8,19,280,58,1470
"Hounslow","09:00:00","2019-09-09",32,0,0,4,1,37
"Lambeth","09:00:00","2019-09-09",208,9,1,72,2,292
"Newham","09:00:00","2019-09-09",537,14,14,190,46,801
"Westminster","09:00:00","2019-09-09",27,2,0,3,1,33
"Barnet","10:00:00","2019-09-09",119,5,0,20,1,145
"Bexley","10:00:00","2019-09-09",305,0,0,102,5,412
"Greenwich","10:00:00","2019-09-09",643,5,29,132,7,816
"Harrow","10:00:00","2019-09-09",51,0,0,16,0,67
"Hillingdon","10:00:00","2019-09-09",887,12,15,245,77,1236
"Hounslow","10:00:00","2019-09-09",16,0,0,5,1,22
"Lambeth","10:00:00","2019-09-09",178,9,0,58,7,252
"Newham","10:00:00","2019-09-09",436,9,11,168,48,672
"Westminster","10:00:00","2019-09-09",12,2,0,12,1,27
"Barnet","11:00:00","2019-09-09",109,4,0,17,1,131
"Bexley","11:00:00","2019-09-09",376,7,0,67,3,453
"Greenwich","11:00:00","2019-09-09",733,3,25,151,11,923
"Harrow","11:00:00","2019-09-09",52,0,0,9,0,61
"Hillingdon","11:00:00","2019-09-09",923,14,12,256,61,1266
"Hounslow","11:00:00","2019-09-09",27,1,0,7,2,37
"Lambeth","11:00:00","2019-09-09",166,10,0,57,3,236
"Newham","11:00:00","2019-09-09",463,16,19,167,46,711
"Westminster","11:00:00","2019-09-09",11,2,0,6,1,20
"Barnet","12:00:00","2019-09-09",125,6,0,27,1,159
"Bexley","12:00:00","2019-09-09",385,0,0,72,6,463
"Greenwich","12:00:00","2019-09-09",721,6,27,148,12,914
"Harrow","12:00:00","2019-09-09",45,0,0,7,0,52
"Hillingdon","12:00:00","2019-09-09",917,9,10,231,53,1220
"Hounslow","12:00:00","2019-09-09",31,2,0,6,0,39
"Lambeth","12:00:00","2019-09-09",176,7,0,68,3,254
"Newham","12:00:00","2019-09-09",491,16,12,166,34,719
"Westminster","12:00:00","2019-09-09",13,9,0,1,1,24
"Barnet","13:00:00","2019-09-09",160,3,0,23,0,186
"Bexley","13:00:00","2019-09-09",344,2,0,62,5,413
"Greenwich","13:00:00","2019-09-09",782,13,25,152,6,978
"Harrow","13:00:00","2019-09-09",69,1,0,17,0,87
"Hillingdon","13:00:00","2019-09-09",1021,21,14,246,56,1358
"Hounslow","13:00:00","2019-09-09",36,2,0,4,0,42
"Lambeth","13:00:00","2019-09-09",161,7,0,64,5,237
"Newham","13:00:00","2019-09-09",525,20,14,145,35,739
"Westminster","13:00:00","2019-09-09",18,4,0,4,0,26
"Barnet","14:00:00","2019-09-09",160,5,0,13,3,181
"Bexley","14:00:00","2019-09-09",503,1,0,90,2,596
"Greenwich","14:00:00","2019-09-09",841,9,30,157,16,1053
"Harrow","14:00:00","2019-09-09",82,2,0,5,0,89
"Hillingdon","14:00:00","2019-09-09",1066,11,16,229,49,1371
"Hounslow","14:00:00","2019-09-09",30,0,0,3,1,34
"Lambeth","14:00:00","2019-09-09",186,9,2,52,3,252
"Newham","14:00:00","2019-09-09",477,13,11,159,38,698
"Westminster","14:00:00","2019-09-09",11,4,0,6,0,21
"Barnet","15:00:00","2019-09-09",213,4,0,17,2,236
"Bexley","15:00:00","2019-09-09",697,1,0,89,1,788
"Greenwich","15:00:00","2019-09-09",848,9,44,153,6,1060
"Harrow","15:00:00","2019-09-09",95,1,0,8,0,104
"Hillingdon","15:00:00","2019-09-09",1231,18,17,226,47,1539
"Hounslow","15:00:00","2019-09-09",50,0,1,9,3,63
"Lambeth","15:00:00","2019-09-09",239,8,0,67,2,316
"Newham","15:00:00","2019-09-09",651,13,15,152,21,852
"Westminster","15:00:00","2019-09-09",26,1,0,6,1,34
"Barnet","16:00:00","2019-09-09",171,2,0,22,0,195
"Bexley","16:00:00","2019-09-09",495,6,0,94,1,596
"Greenwich","16:00:00","2019-09-09",994,18,32,131,2,1177
"Harrow","16:00:00","2019-09-09",61,0,0,7,0,68
"Hillingdon","16:00:00","2019-09-09",1269,26,17,245,36,1593
"Hounslow","16:00:00","2019-09-09",41,1,1,12,0,55
"Lambeth","16:00:00","2019-09-09",228,32,0,51,1,312
"Newham","16:00:00","2019-09-09",669,21,12,132,16,850
"Westminster","16:00:00","2019-09-09",30,2,1,3,0,36
"Barnet","17:00:00","2019-09-09",190,1,0,23,0,214
"Bexley","17:00:00","2019-09-09",710,0,0,87,0,797
"Greenwich","17:00:00","2019-09-09",999,15,28,129,3,1174
"Harrow","17:00:00","2019-09-09",70,0,0,9,1,80
"Hillingdon","17:00:00","2019-09-09",1383,37,16,216,22,1674
"Hounslow","17:00:00","2019-09-09",70,2,0,8,0,80
"Lambeth","17:00:00","2019-09-09",254,19,0,64,1,338
"Newham","17:00:00","2019-09-09",722,20,12,107,5,866
"Westminster","17:00:00","2019-09-09",23,2,0,3,0,28
"Barnet","18:00:00","2019-09-09",168,2,0,12,0,182
"Bexley","18:00:00","2019-09-09",604,6,0,79,0,689
"Greenwich","18:00:00","2019-09-09",1044,16,25,76,3,1164
"Harrow","18:00:00","2019-09-09",76,1,0,10,0,87
"Hillingdon","18:00:00","2019-09-09",1399,28,8,191,19,1645
"Hounslow","18:00:00","2019-09-09",61,1,0,3,0,65
"Lambeth","18:00:00","2019-09-09",227,27,0,44,1,299
"Newham","18:00:00","2019-09-09",670,23,15,103,5,816
"Westminster","18:00:00","2019-09-09",18,3,0,1,0,22
"Hackney","07:00:00","2019-09-10",352,28,29,134,22,565
"Havering","07:00:00","2019-09-10",86,0,0,29,3,118
"Hillingdon","07:00:00","2019-09-10",2986,50,31,487,195,3749
"Hounslow","07:00:00","2019-09-10",648,23,7,125,12,815
"Sutton","07:00:00","2019-09-10",105,2,0,20,0,127
"Westminster","07:00:00","2019-09-10",1227,235,189,484,114,2249
"Hackney","08:00:00","2019-09-10",505,38,22,122,28,715
"Havering","08:00:00","2019-09-10",197,2,0,13,1,213
"Hillingdon","08:00:00","2019-09-10",2999,55,33,392,190,3669
"Hounslow","08:00:00","2019-09-10",703,9,10,93,13,828
"Sutton","08:00:00","2019-09-10",128,1,0,15,1,145
"Westminster","08:00:00","2019-09-10",1329,358,204,467,101,2459
"Hackney","09:00:00","2019-09-10",401,41,19,144,22,627
"Havering","09:00:00","2019-09-10",115,0,0,7,0,122
"Hillingdon","09:00:00","2019-09-10",2006,16,27,384,188,2621
"Hounslow","09:00:00","2019-09-10",601,8,8,75,13,705
"Sutton","09:00:00","2019-09-10",87,0,0,17,1,105
"Westminster","09:00:00","2019-09-10",1353,233,216,444,87,2333
"Hackney","10:00:00","2019-09-10",345,35,20,162,26,588
"Havering","10:00:00","2019-09-10",97,0,0,21,0,118
"Hillingdon","10:00:00","2019-09-10",1310,15,28,341,195,1889
"Hounslow","10:00:00","2019-09-10",514,6,9,89,16,634
"Sutton","10:00:00","2019-09-10",64,1,0,12,1,78
"Westminster","10:00:00","2019-09-10",1386,136,214,437,108,2281
"Hackney","11:00:00","2019-09-10",349,25,18,144,24,560
"Havering","11:00:00","2019-09-10",68,0,0,12,1,81
"Hillingdon","11:00:00","2019-09-10",1420,20,23,335,191,1989
"Hounslow","11:00:00","2019-09-10",504,7,7,92,15,625
"Sutton","11:00:00","2019-09-10",67,1,0,21,4,93
"Westminster","11:00:00","2019-09-10",1431,107,209,445,92,2284
"Hackney","12:00:00","2019-09-10",311,27,21,130,19,508
"Havering","12:00:00","2019-09-10",72,0,0,19,2,93
"Hillingdon","12:00:00","2019-09-10",1813,16,26,329,177,2361
"Hounslow","12:00:00","2019-09-10",577,13,8,103,12,713
"Sutton","12:00:00","2019-09-10",69,0,0,17,1,87
"Westminster","12:00:00","2019-09-10",1546,107,222,425,74,2374
"Hackney","13:00:00","2019-09-10",334,25,19,127,19,524
"Havering","13:00:00","2019-09-10",83,0,0,19,1,103
"Hillingdon","13:00:00","2019-09-10",2113,19,27,337,169,2665
"Hounslow","13:00:00","2019-09-10",637,11,7,111,7,773
"Sutton","13:00:00","2019-09-10",84,2,0,15,1,102
"Westminster","13:00:00","2019-09-10",1554,117,220,406,64,2361
"Hackney","14:00:00","2019-09-10",405,37,23,164,29,658
"Havering","14:00:00","2019-09-10",115,0,0,17,0,132
"Hillingdon","14:00:00","2019-09-10",2284,30,35,359,171,2879
"Hounslow","14:00:00","2019-09-10",683,9,9,81,10,792
"Sutton","14:00:00","2019-09-10",91,3,0,26,0,120
"Westminster","14:00:00","2019-09-10",1591,125,198,383,78,2375
"Hackney","15:00:00","2019-09-10",434,35,23,106,24,622
"Havering","15:00:00","2019-09-10",165,1,0,22,1,189
"Hillingdon","15:00:00","2019-09-10",2361,33,31,372,158,2955
"Hounslow","15:00:00","2019-09-10",679,19,7,87,7,799
"Sutton","15:00:00","2019-09-10",137,0,0,19,4,160
"Westminster","15:00:00","2019-09-10",1704,149,205,339,46,2443
"Hackney","16:00:00","2019-09-10",496,46,25,109,13,689
"Havering","16:00:00","2019-09-10",101,0,0,26,2,129
"Hillingdon","16:00:00","2019-09-10",2740,41,33,417,121,3352
"Hounslow","16:00:00","2019-09-10",844,12,10,90,2,958
"Sutton","16:00:00","2019-09-10",109,4,0,23,3,139
"Westminster","16:00:00","2019-09-10",1836,155,201,290,40,2522
"Hackney","17:00:00","2019-09-10",510,72,19,92,6,699
"Havering","17:00:00","2019-09-10",124,1,0,22,1,148
"Hillingdon","17:00:00","2019-09-10",3159,58,31,317,123,3688
"Hounslow","17:00:00","2019-09-10",770,20,6,96,0,892
"Sutton","17:00:00","2019-09-10",122,6,0,22,5,155
"Westminster","17:00:00","2019-09-10",1829,237,204,201,46,2517
"Hackney","18:00:00","2019-09-10",521,71,18,50,5,665
"Havering","18:00:00","2019-09-10",112,1,0,15,0,128
"Hillingdon","18:00:00","2019-09-10",2940,59,33,297,111,3440
"Hounslow","18:00:00","2019-09-10",783,14,8,81,2,888
"Sutton","18:00:00","2019-09-10",140,6,0,15,2,163
"Westminster","18:00:00","2019-09-10",2035,253,175,191,23,2677
"Barking and Dagenham","07:00:00","2019-09-11",4206,226,63,1550,807,6852
"Barnet","07:00:00","2019-09-11",58,0,1,4,6,69
"Bromley","07:00:00","2019-09-11",8,0,0,5,0,13
"Croydon","07:00:00","2019-09-11",641,19,18,153,7,838
"Hackney","07:00:00","2019-09-11",32,0,0,10,1,43
"Haringey","07:00:00","2019-09-11",571,33,30,262,63,959
"Islington","07:00:00","2019-09-11",14,3,0,0,4,21
"Waltham Forest","07:00:00","2019-09-11",601,10,19,150,17,797
"Wandsworth","07:00:00","2019-09-11",465,37,13,212,6,733
"Westminster","07:00:00","2019-09-11",1960,317,88,854,298,3517
"Barking and Dagenham","08:00:00","2019-09-11",4366,168,51,1299,882,6766
"Barnet","08:00:00","2019-09-11",145,2,0,5,0,152
"Bromley","08:00:00","2019-09-11",13,0,0,3,0,16
"Croydon","08:00:00","2019-09-11",906,22,20,139,20,1107
"Hackney","08:00:00","2019-09-11",45,1,0,12,1,59
"Haringey","08:00:00","2019-09-11",494,25,37,194,45,795
"Islington","08:00:00","2019-09-11",20,1,0,3,0,24
"Waltham Forest","08:00:00","2019-09-11",967,12,27,137,17,1160
"Wandsworth","08:00:00","2019-09-11",409,35,17,177,9,647
"Westminster","08:00:00","2019-09-11",2163,391,109,745,294,3702
"Barking and Dagenham","09:00:00","2019-09-11",3756,71,49,1241,1038,6155
"Barnet","09:00:00","2019-09-11",67,0,1,10,3,81
"Bromley","09:00:00","2019-09-11",7,0,0,1,0,8
"Croydon","09:00:00","2019-09-11",527,15,18,103,17,680
"Hackney","09:00:00","2019-09-11",22,1,0,12,2,37
"Haringey","09:00:00","2019-09-11",474,28,35,199,61,797
"Islington","09:00:00","2019-09-11",12,1,0,6,0,19
"Waltham Forest","09:00:00","2019-09-11",825,7,21,164,20,1037
"Wandsworth","09:00:00","2019-09-11",351,30,13,181,9,584
"Westminster","09:00:00","2019-09-11",2184,313,108,732,267,3604
"Barking and Dagenham","10:00:00","2019-09-11",3404,44,52,1218,1190,5908
"Barnet","10:00:00","2019-09-11",47,0,1,8,5,61
"Bromley","10:00:00","2019-09-11",5,0,0,2,0,7
"Croydon","10:00:00","2019-09-11",432,13,16,115,6,582
"Hackney","10:00:00","2019-09-11",24,1,0,9,0,34
"Haringey","10:00:00","2019-09-11",414,27,32,191,54,718
"Islington","10:00:00","2019-09-11",6,2,0,3,0,11
"Waltham Forest","10:00:00","2019-09-11",526,3,23,118,19,689
"Wandsworth","10:00:00","2019-09-11",359,20,12,209,16,616
"Westminster","10:00:00","2019-09-11",2119,175,99,662,313,3368
"Barking and Dagenham","11:00:00","2019-09-11",3486,41,39,1203,1163,5932
"Barnet","11:00:00","2019-09-11",48,0,1,10,1,60
"Bromley","11:00:00","2019-09-11",16,0,0,1,1,18
"Croydon","11:00:00","2019-09-11",562,16,16,97,16,707
"Hackney","11:00:00","2019-09-11",26,2,0,8,2,38
"Haringey","11:00:00","2019-09-11",545,21,39,203,33,841
"Islington","11:00:00","2019-09-11",6,3,0,9,0,18
"Waltham Forest","11:00:00","2019-09-11",583,2,22,105,9,721
"Wandsworth","11:00:00","2019-09-11",337,17,9,200,20,583
"Westminster","11:00:00","2019-09-11",2335,167,92,686,261,3541
"Barking and Dagenham","12:00:00","2019-09-11",3794,41,38,1330,1175,6378
"Barnet","12:00:00","2019-09-11",32,0,1,10,3,46
"Bromley","12:00:00","2019-09-11",13,0,0,3,0,16
"Croydon","12:00:00","2019-09-11",465,19,21,103,24,632
"Hackney","12:00:00","2019-09-11",27,5,0,5,0,37
"Haringey","12:00:00","2019-09-11",471,33,32,163,45,744
"Islington","12:00:00","2019-09-11",15,5,0,5,2,27
"Waltham Forest","12:00:00","2019-09-11",588,8,21,104,9,730
"Wandsworth","12:00:00","2019-09-11",356,22,15,167,23,583
"Westminster","12:00:00","2019-09-11",2323,192,92,699,244,3550
"Barking and Dagenham","13:00:00","2019-09-11",4269,62,45,1470,1168,7014
"Barnet","13:00:00","2019-09-11",74,2,1,6,2,85
"Bromley","13:00:00","2019-09-11",7,0,0,0,0,7
"Croydon","13:00:00","2019-09-11",470,14,15,93,8,600
"Hackney","13:00:00","2019-09-11",25,3,0,1,0,29
"Haringey","13:00:00","2019-09-11",533,43,27,159,47,809
"Islington","13:00:00","2019-09-11",6,0,0,3,0,9
"Waltham Forest","13:00:00","2019-09-11",641,5,24,108,3,781
"Wandsworth","13:00:00","2019-09-11",335,24,12,192,18,581
"Westminster","13:00:00","2019-09-11",2302,170,94,700,263,3529
"Barking and Dagenham","14:00:00","2019-09-11",4637,82,52,1486,1041,7298
"Barnet","14:00:00","2019-09-11",66,2,1,6,1,76
"Bromley","14:00:00","2019-09-11",9,0,0,0,0,9
"Croydon","14:00:00","2019-09-11",563,13,19,101,12,708
"Hackney","14:00:00","2019-09-11",21,3,0,7,0,31
"Haringey","14:00:00","2019-09-11",551,39,37,162,35,824
"Islington","14:00:00","2019-09-11",18,4,0,9,0,31
"Waltham Forest","14:00:00","2019-09-11",745,9,22,97,9,882
"Wandsworth","14:00:00","2019-09-11",366,25,12,190,11,604
"Westminster","14:00:00","2019-09-11",2419,191,101,730,201,3642
"Barking and Dagenham","15:00:00","2019-09-11",4814,95,35,1659,853,7456
"Barnet","15:00:00","2019-09-11",126,2,0,12,1,141
"Bromley","15:00:00","2019-09-11",14,0,0,3,0,17
"Croydon","15:00:00","2019-09-11",692,13,15,102,14,836
"Hackney","15:00:00","2019-09-11",35,2,0,5,0,42
"Haringey","15:00:00","2019-09-11",633,42,30,200,36,941
"Islington","15:00:00","2019-09-11",18,12,0,6,0,36
"Waltham Forest","15:00:00","2019-09-11",909,9,22,139,8,1087
"Wandsworth","15:00:00","2019-09-11",398,30,11,196,15,650
"Westminster","15:00:00","2019-09-11",2602,218,89,728,175,3812
"Barking and Dagenham","16:00:00","2019-09-11",5523,183,48,1553,556,7863
"Barnet","16:00:00","2019-09-11",110,0,0,3,1,114
"Bromley","16:00:00","2019-09-11",11,0,0,3,0,14
"Croydon","16:00:00","2019-09-11",667,24,19,136,7,853
"Hackney","16:00:00","2019-09-11",33,4,0,3,1,41
"Haringey","16:00:00","2019-09-11",527,31,29,168,17,772
"Islington","16:00:00","2019-09-11",12,6,0,4,0,22
"Waltham Forest","16:00:00","2019-09-11",1042,12,19,134,3,1210
"Wandsworth","16:00:00","2019-09-11",471,22,12,159,11,675
"Westminster","16:00:00","2019-09-11",2638,275,100,654,134,3801
"Barking and Dagenham","17:00:00","2019-09-11",6303,264,53,1290,350,8260
"Barnet","17:00:00","2019-09-11",97,3,0,8,0,108
"Bromley","17:00:00","2019-09-11",12,0,0,1,0,13
"Croydon","17:00:00","2019-09-11",714,29,17,122,4,886
"Hackney","17:00:00","2019-09-11",36,4,0,3,0,43
"Haringey","17:00:00","2019-09-11",582,68,31,131,13,825
"Islington","17:00:00","2019-09-11",10,3,0,3,0,16
"Waltham Forest","17:00:00","2019-09-11",1133,12,17,129,7,1298
"Wandsworth","17:00:00","2019-09-11",476,42,11,139,3,671
"Westminster","17:00:00","2019-09-11",2736,405,107,557,92,3897
"Barking and Dagenham","18:00:00","2019-09-11",6299,241,56,1065,327,7988
"Barnet","18:00:00","2019-09-11",69,1,0,0,0,70
"Bromley","18:00:00","2019-09-11",10,0,0,0,0,10
"Croydon","18:00:00","2019-09-11",776,30,24,107,1,938
"Hackney","18:00:00","2019-09-11",35,7,0,5,0,47
"Haringey","18:00:00","2019-09-11",583,53,24,66,14,740
"Islington","18:00:00","2019-09-11",9,7,0,1,1,18
"Waltham Forest","18:00:00","2019-09-11",1157,16,21,104,3,1301
"Wandsworth","18:00:00","2019-09-11",490,40,15,78,2,625
"Westminster","18:00:00","2019-09-11",3047,432,109,359,82,4029
"Barnet","07:00:00","2019-09-12",624,9,47,182,12,874
"Brent","07:00:00","2019-09-12",38,0,0,7,0,45
"Croydon","07:00:00","2019-09-12",4,0,0,2,0,6
"Enfield","07:00:00","2019-09-12",60,1,0,10,0,71
"Lewisham","07:00:00","2019-09-12",754,16,43,271,14,1098
"Richmond upon Thames","07:00:00","2019-09-12",253,9,11,73,5,351
"Westminster","07:00:00","2019-09-12",338,90,95,258,44,825
"Barnet","08:00:00","2019-09-12",765,10,33,130,13,951
"Brent","08:00:00","2019-09-12",98,2,0,11,0,111
"Croydon","08:00:00","2019-09-12",15,0,0,2,0,17
"Enfield","08:00:00","2019-09-12",155,0,0,8,2,165
"Lewisham","08:00:00","2019-09-12",979,20,25,242,19,1285
"Richmond upon Thames","08:00:00","2019-09-12",236,9,11,68,6,330
"Westminster","08:00:00","2019-09-12",410,94,102,235,39,880
"Barnet","09:00:00","2019-09-12",622,11,38,100,7,778
"Brent","09:00:00","2019-09-12",57,0,1,13,1,72
"Croydon","09:00:00","2019-09-12",9,0,0,2,0,11
"Enfield","09:00:00","2019-09-12",50,0,0,8,3,61
"Lewisham","09:00:00","2019-09-12",887,18,50,241,25,1221
"Richmond upon Thames","09:00:00","2019-09-12",229,6,13,54,4,306
"Westminster","09:00:00","2019-09-12",391,82,101,193,36,803
"Barnet","10:00:00","2019-09-12",681,8,36,133,12,870
"Brent","10:00:00","2019-09-12",30,1,0,16,0,47
"Croydon","10:00:00","2019-09-12",6,0,0,1,0,7
"Enfield","10:00:00","2019-09-12",34,0,0,14,0,48
"Lewisham","10:00:00","2019-09-12",692,21,37,267,27,1044
"Richmond upon Thames","10:00:00","2019-09-12",225,7,13,65,12,322
"Westminster","10:00:00","2019-09-12",455,65,96,193,40,849
"Barnet","11:00:00","2019-09-12",591,9,33,108,11,752
"Brent","11:00:00","2019-09-12",39,3,0,11,1,54
"Croydon","11:00:00","2019-09-12",4,0,0,2,1,7
"Enfield","11:00:00","2019-09-12",54,0,0,11,0,65
"Lewisham","11:00:00","2019-09-12",719,25,35,246,25,1050
"Richmond upon Thames","11:00:00","2019-09-12",215,5,10,49,6,285
"Westminster","11:00:00","2019-09-12",459,79,98,177,31,844
"Barnet","12:00:00","2019-09-12",655,18,33,110,7,823
"Brent","12:00:00","2019-09-12",40,3,0,11,0,54
"Croydon","12:00:00","2019-09-12",2,0,0,2,0,4
"Enfield","12:00:00","2019-09-12",49,2,0,2,1,54
"Lewisham","12:00:00","2019-09-12",760,38,30,219,18,1065
"Richmond upon Thames","12:00:00","2019-09-12",251,4,14,68,4,341
"Westminster","12:00:00","2019-09-12",462,76,88,161,17,804
"Barnet","13:00:00","2019-09-12",635,14,28,98,12,787
"Brent","13:00:00","2019-09-12",38,0,0,10,0,48
"Croydon","13:00:00","2019-09-12",6,0,0,2,0,8
"Enfield","13:00:00","2019-09-12",57,0,0,13,0,70
"Lewisham","13:00:00","2019-09-12",826,25,32,236,20,1139
"Richmond upon Thames","13:00:00","2019-09-12",268,8,10,72,8,366
"Westminster","13:00:00","2019-09-12",489,69,94,148,21,821
"Barnet","14:00:00","2019-09-12",591,13,32,101,12,749
"Brent","14:00:00","2019-09-12",41,3,0,7,0,51
"Croydon","14:00:00","2019-09-12",7,1,0,2,0,10
"Enfield","14:00:00","2019-09-12",64,1,0,10,0,75
"Lewisham","14:00:00","2019-09-12",821,28,30,257,15,1151
"Richmond upon Thames","14:00:00","2019-09-12",203,5,14,56,3,281
"Westminster","14:00:00","2019-09-12",456,64,100,153,24,797
"Barnet","15:00:00","2019-09-12",710,19,38,84,8,859
"Brent","15:00:00","2019-09-12",84,3,0,9,1,97
"Croydon","15:00:00","2019-09-12",8,0,0,2,0,10
"Enfield","15:00:00","2019-09-12",101,0,0,8,0,109
"Lewisham","15:00:00","2019-09-12",935,25,36,249,6,1251
"Richmond upon Thames","15:00:00","2019-09-12",226,5,14,46,4,295
"Westminster","15:00:00","2019-09-12",495,67,92,152,17,823
"Barnet","16:00:00","2019-09-12",765,25,40,92,7,929
"Brent","16:00:00","2019-09-12",58,0,0,6,0,64
"Croydon","16:00:00","2019-09-12",14,0,0,3,0,17
"Enfield","16:00:00","2019-09-12",93,2,0,13,1,109
"Lewisham","16:00:00","2019-09-12",897,27,42,222,5,1193
"Richmond upon Thames","16:00:00","2019-09-12",240,4,13,65,5,327
"Westminster","16:00:00","2019-09-12",528,53,93,101,19,794
"Barnet","17:00:00","2019-09-12",898,25,34,126,2,1085
"Brent","17:00:00","2019-09-12",58,5,0,5,0,68
"Croydon","17:00:00","2019-09-12",12,0,0,1,0,13
"Enfield","17:00:00","2019-09-12",74,2,0,7,0,83
"Lewisham","17:00:00","2019-09-12",921,41,39,150,1,1152
"Richmond upon Thames","17:00:00","2019-09-12",206,7,9,48,0,270
"Westminster","17:00:00","2019-09-12",562,69,96,95,15,837
"Barnet","18:00:00","2019-09-12",884,17,36,100,2,1039
"Brent","18:00:00","2019-09-12",69,2,0,9,0,80
"Croydon","18:00:00","2019-09-12",4,0,0,0,0,4
"Enfield","18:00:00","2019-09-12",65,2,0,4,0,71
"Lewisham","18:00:00","2019-09-12",943,42,32,142,1,1160
"Richmond upon Thames","18:00:00","2019-09-12",210,14,10,37,2,273
"Westminster","18:00:00","2019-09-12",655,81,99,89,15,939
"Barnet","07:00:00","2019-09-13",688,10,30,116,12,856
"Bromley","07:00:00","2019-09-13",514,16,2,158,3,693
"Enfield","07:00:00","2019-09-13",2853,143,116,1033,293,4438
"Redbridge","07:00:00","2019-09-13",414,3,11,72,6,506
"Southwark","07:00:00","2019-09-13",603,30,11,296,53,993
"Tower Hamlets","07:00:00","2019-09-13",602,160,19,417,129,1327
"Waltham Forest","07:00:00","2019-09-13",106,0,0,10,6,122
"Barnet","08:00:00","2019-09-13",710,5,19,103,14,851
"Bromley","08:00:00","2019-09-13",644,7,1,131,5,788
"Enfield","08:00:00","2019-09-13",3141,91,104,862,305,4503
"Redbridge","08:00:00","2019-09-13",533,4,11,62,2,612
"Southwark","08:00:00","2019-09-13",591,18,17,236,38,900
"Tower Hamlets","08:00:00","2019-09-13",604,217,23,357,114,1315
"Waltham Forest","08:00:00","2019-09-13",255,1,0,9,1,266
"Barnet","09:00:00","2019-09-13",566,5,25,135,21,752
"Bromley","09:00:00","2019-09-13",352,9,0,101,6,468
"Enfield","09:00:00","2019-09-13",3120,45,113,948,357,4583
"Redbridge","09:00:00","2019-09-13",357,2,15,72,8,454
"Southwark","09:00:00","2019-09-13",518,21,14,274,38,865
"Tower Hamlets","09:00:00","2019-09-13",549,157,20,383,105,1214
"Waltham Forest","09:00:00","2019-09-13",119,1,0,12,4,136
"Barnet","10:00:00","2019-09-13",503,8,23,141,15,690
"Bromley","10:00:00","2019-09-13",287,9,0,68,3,367
"Enfield","10:00:00","2019-09-13",2838,59,114,1027,405,4443
"Redbridge","10:00:00","2019-09-13",296,2,10,70,9,387
"Southwark","10:00:00","2019-09-13",527,16,11,256,62,872
"Tower Hamlets","10:00:00","2019-09-13",588,115,20,372,119,1214
"Waltham Forest","10:00:00","2019-09-13",114,1,0,17,1,133
"Barnet","11:00:00","2019-09-13",557,5,22,101,20,705
"Bromley","11:00:00","2019-09-13",277,4,1,69,4,355
"Enfield","11:00:00","2019-09-13",2889,46,111,1055,317,4418
"Redbridge","11:00:00","2019-09-13",301,1,13,63,6,384
"Southwark","11:00:00","2019-09-13",520,19,16,215,60,830
"Tower Hamlets","11:00:00","2019-09-13",603,112,18,342,119,1194
"Waltham Forest","11:00:00","2019-09-13",95,3,0,11,3,112
"Barnet","12:00:00","2019-09-13",592,6,20,126,10,754
"Bromley","12:00:00","2019-09-13",249,10,0,53,1,313
"Enfield","12:00:00","2019-09-13",2984,58,105,1017,289,4453
"Redbridge","12:00:00","2019-09-13",332,2,9,66,6,415
"Southwark","12:00:00","2019-09-13",597,31,12,265,47,952
"Tower Hamlets","12:00:00","2019-09-13",579,125,25,375,85,1189
"Waltham Forest","12:00:00","2019-09-13",96,0,0,18,0,114
"Barnet","13:00:00","2019-09-13",637,11,21,102,17,788
"Bromley","13:00:00","2019-09-13",321,9,0,58,4,392
"Enfield","13:00:00","2019-09-13",2907,81,115,992,327,4422
"Redbridge","13:00:00","2019-09-13",342,7,10,58,5,422
"Southwark","13:00:00","2019-09-13",581,37,13,276,36,943
"Tower Hamlets","13:00:00","2019-09-13",678,160,18,371,104,1331
"Waltham Forest","13:00:00","2019-09-13",107,0,0,12,2,121
"Barnet","14:00:00","2019-09-13",728,3,20,121,12,884
"Bromley","14:00:00","2019-09-13",346,6,1,75,3,431
"Enfield","14:00:00","2019-09-13",2887,58,110,931,275,4261
"Redbridge","14:00:00","2019-09-13",424,3,10,51,4,492
"Southwark","14:00:00","2019-09-13",665,29,13,259,37,1003
"Tower Hamlets","14:00:00","2019-09-13",702,153,21,322,108,1306
"Waltham Forest","14:00:00","2019-09-13",132,4,0,21,2,159
"Barnet","15:00:00","2019-09-13",679,7,26,106,11,829
"Bromley","15:00:00","2019-09-13",412,12,0,83,2,509
"Enfield","15:00:00","2019-09-13",3237,62,105,962,156,4522
"Redbridge","15:00:00","2019-09-13",471,2,7,56,4,540
"Southwark","15:00:00","2019-09-13",609,31,12,311,16,979
"Tower Hamlets","15:00:00","2019-09-13",721,132,17,318,91,1279
"Waltham Forest","15:00:00","2019-09-13",226,3,0,21,4,254
"Barnet","16:00:00","2019-09-13",799,13,20,121,4,957
"Bromley","16:00:00","2019-09-13",507,11,3,107,3,631
"Enfield","16:00:00","2019-09-13",3098,86,108,749,183,4224
"Redbridge","16:00:00","2019-09-13",360,4,8,53,4,429
"Southwark","16:00:00","2019-09-13",670,40,11,269,26,1016
"Tower Hamlets","16:00:00","2019-09-13",842,197,20,319,64,1442
"Waltham Forest","16:00:00","2019-09-13",119,5,0,18,0,142
"Barnet","17:00:00","2019-09-13",826,12,21,114,0,973
"Bromley","17:00:00","2019-09-13",522,10,2,84,2,620
"Enfield","17:00:00","2019-09-13",3119,97,109,773,165,4263
"Redbridge","17:00:00","2019-09-13",316,3,7,46,0,372
"Southwark","17:00:00","2019-09-13",712,60,16,226,3,1017
"Tower Hamlets","17:00:00","2019-09-13",1037,222,23,212,56,1550
"Waltham Forest","17:00:00","2019-09-13",159,8,0,13,0,180
"Barnet","18:00:00","2019-09-13",701,17,21,82,1,822
"Bromley","18:00:00","2019-09-13",533,11,1,48,0,593
"Enfield","18:00:00","2019-09-13",3032,106,105,591,111,3945
"Redbridge","18:00:00","2019-09-13",365,9,10,42,2,428
"Southwark","18:00:00","2019-09-13",740,60,9,170,11,990
"Tower Hamlets","18:00:00","2019-09-13",1111,230,17,168,35,1561
"Waltham Forest","18:00:00","2019-09-13",80,5,0,8,0,93
"Brent","07:00:00","2019-09-16",94,2,0,18,0,114
"Haringey","07:00:00","2019-09-16",28,0,0,13,0,41
"Sutton","07:00:00","2019-09-16",8,0,0,0,0,8
"Waltham Forest","07:00:00","2019-09-16",9,0,0,1,0,10
"Westminster","07:00:00","2019-09-16",440,81,69,242,34,866
"Brent","08:00:00","2019-09-16",135,5,0,10,0,150
"Haringey","08:00:00","2019-09-16",37,2,0,6,0,45
"Sutton","08:00:00","2019-09-16",8,0,0,1,0,9
"Waltham Forest","08:00:00","2019-09-16",22,0,0,4,0,26
"Westminster","08:00:00","2019-09-16",363,69,58,201,34,725
"Bexley","09:00:00","2019-09-16",4398,79,49,1224,478,6228
"Brent","09:00:00","2019-09-16",85,1,0,10,1,97
"Haringey","09:00:00","2019-09-16",51,1,0,14,0,66
"Sutton","09:00:00","2019-09-16",8,1,0,2,0,11
"Waltham Forest","09:00:00","2019-09-16",14,1,0,3,0,18
"Westminster","09:00:00","2019-09-16",428,59,65,201,36,789
"Bexley","10:00:00","2019-09-16",3768,47,49,1073,464,5401
"Brent","10:00:00","2019-09-16",70,3,0,14,2,89
"Haringey","10:00:00","2019-09-16",31,1,0,8,2,42
"Sutton","10:00:00","2019-09-16",13,0,0,1,0,14
"Waltham Forest","10:00:00","2019-09-16",15,0,0,9,0,24
"Westminster","10:00:00","2019-09-16",486,38,71,180,63,838
"Bexley","11:00:00","2019-09-16",3856,38,21,1105,491,5511
"Brent","11:00:00","2019-09-16",59,2,0,18,1,80
"Haringey","11:00:00","2019-09-16",34,2,0,7,1,44
"Sutton","11:00:00","2019-09-16",11,0,0,4,0,15
"Waltham Forest","11:00:00","2019-09-16",17,0,0,5,0,22
"Westminster","11:00:00","2019-09-16",462,41,69,215,59,846
"Bexley","12:00:00","2019-09-16",3947,61,14,1153,459,5634
"Brent","12:00:00","2019-09-16",55,2,0,15,0,72
"Haringey","12:00:00","2019-09-16",30,2,0,13,0,45
"Sutton","12:00:00","2019-09-16",14,0,0,0,0,14
"Waltham Forest","12:00:00","2019-09-16",18,3,0,0,0,21
"Westminster","12:00:00","2019-09-16",486,43,66,170,40,805
"Bexley","13:00:00","2019-09-16",4171,58,23,1200,490,5942
"Brent","13:00:00","2019-09-16",90,1,0,16,1,108
"Haringey","13:00:00","2019-09-16",33,1,0,9,0,43
"Sutton","13:00:00","2019-09-16",8,0,0,1,0,9
"Waltham Forest","13:00:00","2019-09-16",12,1,0,3,0,16
"Westminster","13:00:00","2019-09-16",456,52,65,174,36,783
"Brent","14:00:00","2019-09-16",92,4,0,11,1,108
"Haringey","14:00:00","2019-09-16",33,1,0,11,0,45
"Sutton","14:00:00","2019-09-16",5,0,0,0,0,5
"Waltham Forest","14:00:00","2019-09-16",17,2,0,8,0,27
"Westminster","14:00:00","2019-09-16",470,47,68,196,46,827
"Brent","15:00:00","2019-09-16",85,2,0,10,1,98
"Haringey","15:00:00","2019-09-16",45,11,0,12,0,68
"Sutton","15:00:00","2019-09-16",13,0,0,0,0,13
"Waltham Forest","15:00:00","2019-09-16",12,2,0,4,0,18
"Westminster","15:00:00","2019-09-16",452,43,68,185,34,782
"Brent","16:00:00","2019-09-16",97,4,0,12,0,113
"Haringey","16:00:00","2019-09-16",47,4,0,13,0,64
"Sutton","16:00:00","2019-09-16",7,0,0,1,0,8
"Waltham Forest","16:00:00","2019-09-16",15,0,0,3,0,18
"Westminster","16:00:00","2019-09-16",424,66,70,161,24,745
"Brent","17:00:00","2019-09-16",98,4,0,19,0,121
"Haringey","17:00:00","2019-09-16",35,3,0,11,2,51
"Sutton","17:00:00","2019-09-16",5,0,0,0,0,5
"Waltham Forest","17:00:00","2019-09-16",14,0,0,4,0,18
"Westminster","17:00:00","2019-09-16",470,81,73,126,14,764
"Brent","18:00:00","2019-09-16",109,4,0,11,1,125
"Haringey","18:00:00","2019-09-16",42,4,0,3,0,49
"Sutton","18:00:00","2019-09-16",6,0,0,0,0,6
"Waltham Forest","18:00:00","2019-09-16",23,2,0,2,0,27
"Westminster","18:00:00","2019-09-16",531,91,64,67,10,763
"Bromley","07:00:00","2019-09-17",42,1,2,18,0,63
"Camden","07:00:00","2019-09-17",173,12,27,97,21,330
"City of London","07:00:00","2019-09-17",764,301,41,607,222,1935
"Croydon","07:00:00","2019-09-17",938,33,52,252,13,1288
"Enfield","07:00:00","2019-09-17",1524,22,54,374,30,2004
"Harrow","07:00:00","2019-09-17",40,0,0,3,0,43
"Hillingdon","07:00:00","2019-09-17",697,15,23,111,27,873
"Bromley","08:00:00","2019-09-17",56,0,2,20,0,78
"Camden","08:00:00","2019-09-17",229,14,24,97,22,386
"City of London","08:00:00","2019-09-17",847,287,64,552,204,1954
"Croydon","08:00:00","2019-09-17",1130,34,45,206,18,1433
"Enfield","08:00:00","2019-09-17",1901,18,68,329,41,2357
"Harrow","08:00:00","2019-09-17",60,0,0,7,0,67
"Hillingdon","08:00:00","2019-09-17",869,9,18,120,23,1039
"Bromley","09:00:00","2019-09-17",35,0,2,9,2,48
"Camden","09:00:00","2019-09-17",234,20,31,83,19,387
"City of London","09:00:00","2019-09-17",875,163,61,532,242,1873
"Croydon","09:00:00","2019-09-17",879,18,39,184,20,1140
"Enfield","09:00:00","2019-09-17",1398,13,71,316,56,1854
"Harrow","09:00:00","2019-09-17",33,0,0,2,0,35
"Hillingdon","09:00:00","2019-09-17",510,7,19,103,22,661
"Wandsworth","09:00:00","2019-09-17",2966,172,43,662,160,4003
"Bromley","10:00:00","2019-09-17",38,0,2,13,0,53
"Camden","10:00:00","2019-09-17",263,23,27,101,18,432
"City of London","10:00:00","2019-09-17",983,115,65,610,235,2008
"Croydon","10:00:00","2019-09-17",704,15,41,220,29,1009
"Enfield","10:00:00","2019-09-17",1073,11,72,274,62,1492
"Harrow","10:00:00","2019-09-17",27,0,0,3,0,30
"Hillingdon","10:00:00","2019-09-17",320,12,16,77,27,452
"Wandsworth","10:00:00","2019-09-17",2950,119,35,723,192,4019
"Bromley","11:00:00","2019-09-17",28,0,1,16,0,45
"Camden","11:00:00","2019-09-17",220,33,27,105,13,398
"City of London","11:00:00","2019-09-17",951,89,59,441,203,1743
"Croydon","11:00:00","2019-09-17",681,18,35,182,14,930
"Enfield","11:00:00","2019-09-17",984,11,68,265,59,1387
"Harrow","11:00:00","2019-09-17",24,0,0,7,0,31
"Hillingdon","11:00:00","2019-09-17",357,12,17,81,19,486
"Wandsworth","11:00:00","2019-09-17",2818,84,39,702,227,3870
"Bromley","12:00:00","2019-09-17",42,1,2,18,1,64
"Camden","12:00:00","2019-09-17",239,44,21,93,14,411
"City of London","12:00:00","2019-09-17",895,95,59,424,220,1693
"Croydon","12:00:00","2019-09-17",675,26,36,169,29,935
"Enfield","12:00:00","2019-09-17",1101,20,66,337,48,1572
"Harrow","12:00:00","2019-09-17",31,0,0,2,0,33
"Hillingdon","12:00:00","2019-09-17",408,7,17,61,18,511
"Wandsworth","12:00:00","2019-09-17",2833,88,32,745,184,3882
"Bromley","13:00:00","2019-09-17",32,0,2,18,2,54
"Camden","13:00:00","2019-09-17",232,39,27,106,19,423
"City of London","13:00:00","2019-09-17",928,104,51,478,209,1770
"Croydon","13:00:00","2019-09-17",767,27,37,210,23,1064
"Enfield","13:00:00","2019-09-17",1112,18,65,294,40,1529
"Harrow","13:00:00","2019-09-17",35,0,0,1,0,36
"Hillingdon","13:00:00","2019-09-17",476,9,18,55,10,568
"Wandsworth","13:00:00","2019-09-17",2767,83,33,728,166,3777
"Bromley","14:00:00","2019-09-17",52,0,2,16,0,70
"Camden","14:00:00","2019-09-17",271,63,27,107,13,481
"City of London","14:00:00","2019-09-17",892,100,64,413,185,1654
"Croydon","14:00:00","2019-09-17",851,24,38,218,21,1152
"Enfield","14:00:00","2019-09-17",1225,18,66,266,49,1624
"Harrow","14:00:00","2019-09-17",32,0,0,3,0,35
"Hillingdon","14:00:00","2019-09-17",567,5,24,83,15,694
"Wandsworth","14:00:00","2019-09-17",3056,88,41,876,158,4219
"Bromley","15:00:00","2019-09-17",50,0,2,13,1,66
"Camden","15:00:00","2019-09-17",275,35,25,124,12,471
"City of London","15:00:00","2019-09-17",1035,141,68,414,166,1824
"Croydon","15:00:00","2019-09-17",994,23,40,183,16,1256
"Enfield","15:00:00","2019-09-17",1408,15,80,322,40,1865
"Harrow","15:00:00","2019-09-17",34,1,0,4,0,39
"Hillingdon","15:00:00","2019-09-17",578,9,19,96,15,717
"Bromley","16:00:00","2019-09-17",45,1,2,14,2,64
"Camden","16:00:00","2019-09-17",314,49,27,116,11,517
"City of London","16:00:00","2019-09-17",860,207,70,465,104,1706
"Croydon","16:00:00","2019-09-17",1181,48,35,270,11,1545
"Enfield","16:00:00","2019-09-17",1509,28,72,332,25,1966
"Harrow","16:00:00","2019-09-17",34,0,0,2,0,36
"Hillingdon","16:00:00","2019-09-17",724,13,17,154,18,926
"Bromley","17:00:00","2019-09-17",56,1,2,19,1,79
"Camden","17:00:00","2019-09-17",353,61,27,83,9,533
"City of London","17:00:00","2019-09-17",1002,272,102,318,93,1787
"Croydon","17:00:00","2019-09-17",1174,49,40,227,4,1494
"Enfield","17:00:00","2019-09-17",1467,28,61,295,20,1871
"Harrow","17:00:00","2019-09-17",41,0,0,4,0,45
"Hillingdon","17:00:00","2019-09-17",925,15,15,116,12,1083
"Bromley","18:00:00","2019-09-17",45,3,2,9,0,59
"Camden","18:00:00","2019-09-17",349,76,23,49,4,501
"City of London","18:00:00","2019-09-17",1476,209,74,251,67,2077
"Croydon","18:00:00","2019-09-17",1250,60,41,180,3,1534
"Enfield","18:00:00","2019-09-17",1414,31,78,204,25,1752
"Harrow","18:00:00","2019-09-17",51,0,0,3,0,54
"Hillingdon","18:00:00","2019-09-17",739,17,18,84,5,863
"Barnet","07:00:00","2019-09-18",117,3,0,17,0,137
"Bromley","07:00:00","2019-09-18",212,4,0,31,3,250
"City of London","07:00:00","2019-09-18",574,125,23,393,64,1179
"Croydon","07:00:00","2019-09-18",171,3,3,25,0,202
"Hillingdon","07:00:00","2019-09-18",857,9,6,145,6,1023
"Kensington and Chelsea","07:00:00","2019-09-18",2334,179,35,572,113,3233
"Kingston upon Thames","07:00:00","2019-09-18",545,11,2,94,1,653
"Lewisham","07:00:00","2019-09-18",524,4,24,176,14,742
"Newham","07:00:00","2019-09-18",4965,466,73,2017,612,8133
"Westminster","07:00:00","2019-09-18",2121,309,56,797,280,3563
"Barnet","08:00:00","2019-09-18",186,3,0,17,1,207
"Bromley","08:00:00","2019-09-18",280,0,0,25,1,306
"City of London","08:00:00","2019-09-18",382,116,26,301,49,874
"Croydon","08:00:00","2019-09-18",212,5,4,24,0,245
"Hillingdon","08:00:00","2019-09-18",836,12,8,105,6,967
"Kensington and Chelsea","08:00:00","2019-09-18",2230,195,66,488,99,3078
"Kingston upon Thames","08:00:00","2019-09-18",781,19,4,82,8,894
"Lewisham","08:00:00","2019-09-18",610,16,24,161,23,834
"Newham","08:00:00","2019-09-18",5602,370,70,1706,680,8428
"Redbridge","08:00:00","2019-09-18",6998,116,38,1786,711,9649
"Westminster","08:00:00","2019-09-18",2125,361,55,709,270,3520
"Barnet","09:00:00","2019-09-18",89,0,0,7,1,97
"Bromley","09:00:00","2019-09-18",180,1,0,13,0,194
"City of London","09:00:00","2019-09-18",339,69,28,349,57,842
"Croydon","09:00:00","2019-09-18",111,0,3,19,0,133
"Hillingdon","09:00:00","2019-09-18",658,12,6,112,16,804
"Kensington and Chelsea","09:00:00","2019-09-18",2252,126,65,504,109,3056
"Kingston upon Thames","09:00:00","2019-09-18",476,2,8,75,7,568
"Lewisham","09:00:00","2019-09-18",667,7,26,191,19,910
"Newham","09:00:00","2019-09-18",4837,231,66,1698,747,7579
"Redbridge","09:00:00","2019-09-18",6177,67,26,1795,718,8783
"Westminster","09:00:00","2019-09-18",2182,267,68,687,292,3496
"Barnet","10:00:00","2019-09-18",79,2,0,12,3,96
"Bromley","10:00:00","2019-09-18",143,0,0,11,2,156
"City of London","10:00:00","2019-09-18",485,64,28,361,66,1004
"Croydon","10:00:00","2019-09-18",97,0,5,15,4,121
"Hillingdon","10:00:00","2019-09-18",665,12,10,113,12,812
"Kensington and Chelsea","10:00:00","2019-09-18",2194,79,57,466,94,2890
"Kingston upon Thames","10:00:00","2019-09-18",389,6,6,77,9,487
"Lewisham","10:00:00","2019-09-18",562,7,26,186,23,804
"Newham","10:00:00","2019-09-18",4195,142,66,1599,763,6765
"Redbridge","10:00:00","2019-09-18",5315,46,27,1757,718,7863
"Westminster","10:00:00","2019-09-18",2158,154,55,706,284,3357
"Barnet","11:00:00","2019-09-18",81,2,0,18,1,102
"Bromley","11:00:00","2019-09-18",140,1,0,18,0,159
"City of London","11:00:00","2019-09-18",482,81,29,402,67,1061
"Croydon","11:00:00","2019-09-18",87,3,4,16,1,111
"Hillingdon","11:00:00","2019-09-18",664,10,5,93,11,783
"Kensington and Chelsea","11:00:00","2019-09-18",2152,63,40,439,104,2798
"Kingston upon Thames","11:00:00","2019-09-18",325,3,10,71,9,418
"Lewisham","11:00:00","2019-09-18",473,10,26,124,13,646
"Newham","11:00:00","2019-09-18",3867,158,74,1586,783,6468
"Redbridge","11:00:00","2019-09-18",5324,55,25,1906,762,8072
"Westminster","11:00:00","2019-09-18",2186,167,52,664,305,3374
"Barnet","12:00:00","2019-09-18",93,5,1,10,0,109
"Bromley","12:00:00","2019-09-18",139,4,0,17,3,163
"City of London","12:00:00","2019-09-18",447,107,30,395,59,1038
"Croydon","12:00:00","2019-09-18",101,0,4,26,4,135
"Hillingdon","12:00:00","2019-09-18",648,7,6,99,14,774
"Kensington and Chelsea","12:00:00","2019-09-18",2226,82,45,516,86,2955
"Kingston upon Thames","12:00:00","2019-09-18",347,4,3,77,3,434
"Lewisham","12:00:00","2019-09-18",542,8,25,117,14,706
"Newham","12:00:00","2019-09-18",4342,186,63,1541,710,6842
"Redbridge","12:00:00","2019-09-18",5518,60,23,1840,788,8229
"Westminster","12:00:00","2019-09-18",2339,162,60,728,285,3574
"Barnet","13:00:00","2019-09-18",92,4,1,16,2,115
"Bromley","13:00:00","2019-09-18",133,2,0,21,1,157
"City of London","13:00:00","2019-09-18",510,69,32,343,54,1008
"Croydon","13:00:00","2019-09-18",92,0,4,17,1,114
"Hillingdon","13:00:00","2019-09-18",667,5,6,105,17,800
"Kensington and Chelsea","13:00:00","2019-09-18",2251,95,45,416,84,2891
"Kingston upon Thames","13:00:00","2019-09-18",378,5,5,62,6,456
"Lewisham","13:00:00","2019-09-18",526,13,27,110,13,689
"Newham","13:00:00","2019-09-18",4568,195,62,1620,741,7186
"Redbridge","13:00:00","2019-09-18",5999,57,21,1816,763,8656
"Westminster","13:00:00","2019-09-18",2472,169,63,750,294,3748
"Barnet","14:00:00","2019-09-18",112,1,0,22,0,135
"Bromley","14:00:00","2019-09-18",160,1,0,22,0,183
"City of London","14:00:00","2019-09-18",550,63,34,326,51,1024
"Croydon","14:00:00","2019-09-18",136,0,4,24,0,164
"Hillingdon","14:00:00","2019-09-18",680,7,8,99,5,799
"Kensington and Chelsea","14:00:00","2019-09-18",2317,80,47,426,84,2954
"Kingston upon Thames","14:00:00","2019-09-18",539,9,13,77,5,643
"Lewisham","14:00:00","2019-09-18",560,11,27,119,8,725
"Newham","14:00:00","2019-09-18",4921,218,69,1701,676,7585
"Redbridge","14:00:00","2019-09-18",6482,78,37,2050,721,9368
"Westminster","14:00:00","2019-09-18",2405,207,67,721,251,3651
"Barnet","15:00:00","2019-09-18",132,5,2,26,0,165
"Bromley","15:00:00","2019-09-18",221,1,0,34,1,257
"City of London","15:00:00","2019-09-18",518,74,26,314,49,981
"Croydon","15:00:00","2019-09-18",175,3,4,30,0,212
"Hillingdon","15:00:00","2019-09-18",736,8,12,105,10,871
"Kensington and Chelsea","15:00:00","2019-09-18",2271,117,50,431,67,2936
"Kingston upon Thames","15:00:00","2019-09-18",651,9,11,105,11,787
"Lewisham","15:00:00","2019-09-18",591,7,26,105,7,736
"Newham","15:00:00","2019-09-18",5315,256,60,1861,564,8056
"Redbridge","15:00:00","2019-09-18",7056,95,26,2002,584,9763
"Westminster","15:00:00","2019-09-18",2581,226,71,722,188,3788
"Barnet","16:00:00","2019-09-18",155,6,0,20,0,181
"Bromley","16:00:00","2019-09-18",224,2,0,35,1,262
"City of London","16:00:00","2019-09-18",613,98,27,257,33,1028
"Croydon","16:00:00","2019-09-18",141,4,4,21,1,171
"Hillingdon","16:00:00","2019-09-18",760,11,7,104,6,888
"Kensington and Chelsea","16:00:00","2019-09-18",2440,106,48,332,62,2988
"Kingston upon Thames","16:00:00","2019-09-18",676,9,5,105,5,800
"Lewisham","16:00:00","2019-09-18",634,11,28,129,5,807
"Newham","16:00:00","2019-09-18",5608,381,72,1761,352,8174
"Westminster","16:00:00","2019-09-18",2681,284,73,735,155,3928
"Barnet","17:00:00","2019-09-18",164,1,1,20,1,187
"Bromley","17:00:00","2019-09-18",233,5,0,32,2,272
"City of London","17:00:00","2019-09-18",583,157,29,250,18,1037
"Croydon","17:00:00","2019-09-18",217,0,4,20,0,241
"Hillingdon","17:00:00","2019-09-18",865,12,6,87,1,971
"Kensington and Chelsea","17:00:00","2019-09-18",2569,196,52,276,40,3133
"Kingston upon Thames","17:00:00","2019-09-18",709,12,2,91,2,816
"Lewisham","17:00:00","2019-09-18",666,16,25,97,2,806
"Newham","17:00:00","2019-09-18",5926,571,65,1242,221,8025
"Westminster","17:00:00","2019-09-18",2816,437,75,583,116,4027
"Barnet","18:00:00","2019-09-18",170,4,0,17,0,191
"Bromley","18:00:00","2019-09-18",182,3,0,24,2,211
"City of London","18:00:00","2019-09-18",854,135,35,199,9,1232
"Croydon","18:00:00","2019-09-18",155,4,4,14,0,177
"Hillingdon","18:00:00","2019-09-18",829,10,6,70,1,916
"Kensington and Chelsea","18:00:00","2019-09-18",2571,183,60,270,50,3134
"Kingston upon Thames","18:00:00","2019-09-18",689,7,2,95,0,793
"Lewisham","18:00:00","2019-09-18",857,15,27,94,1,994
"Newham","18:00:00","2019-09-18",7113,437,58,1132,206,8946
"Westminster","18:00:00","2019-09-18",3080,449,80,416,93,4118
"Camden","07:00:00","2019-09-19",273,42,26,189,31,561
"Enfield","07:00:00","2019-09-19",1204,14,69,260,31,1578
"Haringey","07:00:00","2019-09-19",587,2,10,194,20,813
"Havering","07:00:00","2019-09-19",677,8,22,130,23,860
"Hounslow","07:00:00","2019-09-19",474,16,11,91,3,595
"Lewisham","07:00:00","2019-09-19",16,0,0,1,0,17
"Newham","07:00:00","2019-09-19",142,2,19,35,3,201
"Camden","08:00:00","2019-09-19",295,88,25,213,33,654
"Enfield","08:00:00","2019-09-19",1394,18,58,204,33,1707
"Haringey","08:00:00","2019-09-19",802,7,11,239,12,1071
"Havering","08:00:00","2019-09-19",941,2,18,122,28,1111
"Hounslow","08:00:00","2019-09-19",644,9,12,81,14,760
"Lewisham","08:00:00","2019-09-19",33,0,1,5,0,39
"Newham","08:00:00","2019-09-19",229,2,19,41,4,295
"Camden","09:00:00","2019-09-19",324,69,28,172,32,625
"Enfield","09:00:00","2019-09-19",1255,13,58,247,30,1603
"Haringey","09:00:00","2019-09-19",690,8,9,190,18,915
"Havering","09:00:00","2019-09-19",615,3,25,101,26,770
"Hounslow","09:00:00","2019-09-19",403,15,14,76,5,513
"Lewisham","09:00:00","2019-09-19",18,0,0,3,2,23
"Newham","09:00:00","2019-09-19",195,9,22,54,6,286
"Camden","10:00:00","2019-09-19",295,54,24,151,24,548
"Enfield","10:00:00","2019-09-19",1028,9,49,189,26,1301
"Haringey","10:00:00","2019-09-19",672,8,9,184,20,893
"Havering","10:00:00","2019-09-19",507,8,20,98,19,652
"Hounslow","10:00:00","2019-09-19",357,10,11,70,4,452
"Lewisham","10:00:00","2019-09-19",21,0,0,4,1,26
"Newham","10:00:00","2019-09-19",197,6,19,44,0,266
"Camden","11:00:00","2019-09-19",294,84,23,147,24,572
"Enfield","11:00:00","2019-09-19",1151,22,54,209,22,1458
"Haringey","11:00:00","2019-09-19",608,11,11,179,23,832
"Havering","11:00:00","2019-09-19",506,2,24,107,21,660
"Hounslow","11:00:00","2019-09-19",313,12,10,71,6,412
"Lewisham","11:00:00","2019-09-19",24,0,0,4,0,28
"Newham","11:00:00","2019-09-19",175,13,22,29,6,245
"Camden","12:00:00","2019-09-19",324,63,21,115,21,544
"Enfield","12:00:00","2019-09-19",1212,27,48,183,21,1491
"Haringey","12:00:00","2019-09-19",609,23,11,200,16,859
"Havering","12:00:00","2019-09-19",573,3,18,131,21,746
"Hounslow","12:00:00","2019-09-19",366,14,14,64,3,461
"Lewisham","12:00:00","2019-09-19",21,1,0,7,0,29
"Newham","12:00:00","2019-09-19",210,17,21,39,3,290
"Camden","13:00:00","2019-09-19",340,78,32,141,31,622
"Enfield","13:00:00","2019-09-19",1158,31,48,184,18,1439
"Haringey","13:00:00","2019-09-19",646,32,12,190,9,889
"Havering","13:00:00","2019-09-19",582,4,21,111,31,749
"Hounslow","13:00:00","2019-09-19",358,18,14,80,3,473
"Lewisham","13:00:00","2019-09-19",17,1,0,0,0,18
"Newham","13:00:00","2019-09-19",220,11,22,43,3,299
"Camden","14:00:00","2019-09-19",366,85,21,114,16,602
"Enfield","14:00:00","2019-09-19",1323,23,49,197,8,1600
"Haringey","14:00:00","2019-09-19",675,30,9,186,10,910
"Havering","14:00:00","2019-09-19",654,6,23,126,22,831
"Hounslow","14:00:00","2019-09-19",358,20,10,63,3,454
"Lewisham","14:00:00","2019-09-19",24,0,0,4,0,28
"Newham","14:00:00","2019-09-19",246,11,20,28,4,309
"Camden","15:00:00","2019-09-19",448,63,34,93,8,646
"Enfield","15:00:00","2019-09-19",1349,31,48,194,13,1635
"Haringey","15:00:00","2019-09-19",871,25,9,226,12,1143
"Havering","15:00:00","2019-09-19",774,4,18,133,24,953
"Hounslow","15:00:00","2019-09-19",495,15,17,73,6,606
"Lewisham","15:00:00","2019-09-19",28,1,2,2,1,34
"Newham","15:00:00","2019-09-19",264,12,19,34,2,331
"Camden","16:00:00","2019-09-19",464,103,34,81,13,695
"Enfield","16:00:00","2019-09-19",1364,37,65,204,11,1681
"Haringey","16:00:00","2019-09-19",905,34,11,183,8,1141
"Havering","16:00:00","2019-09-19",849,8,24,167,13,1061
"Hounslow","16:00:00","2019-09-19",686,20,19,111,4,840
"Lewisham","16:00:00","2019-09-19",28,4,1,5,0,38
"Newham","16:00:00","2019-09-19",289,17,21,29,3,359
"Camden","17:00:00","2019-09-19",524,101,25,63,4,717
"Enfield","17:00:00","2019-09-19",1417,35,47,164,6,1669
"Haringey","17:00:00","2019-09-19",913,40,12,202,5,1172
"Havering","17:00:00","2019-09-19",945,9,17,103,11,1085
"Hounslow","17:00:00","2019-09-19",699,23,18,84,5,829
"Lewisham","17:00:00","2019-09-19",32,2,0,3,0,37
"Newham","17:00:00","2019-09-19",318,9,17,41,3,388
"Camden","18:00:00","2019-09-19",567,99,24,56,10,756
"Enfield","18:00:00","2019-09-19",1388,42,43,159,6,1638
"Haringey","18:00:00","2019-09-19",1060,27,11,172,2,1272
"Havering","18:00:00","2019-09-19",757,8,19,91,7,882
"Hounslow","18:00:00","2019-09-19",660,30,16,59,0,765
"Lewisham","18:00:00","2019-09-19",42,3,0,6,0,51
"Newham","18:00:00","2019-09-19",300,5,19,34,1,359
"Barking and Dagenham","07:00:00","2019-09-20",962,27,44,156,18,1207
"Barnet","07:00:00","2019-09-20",990,10,37,210,25,1272
"Bexley","07:00:00","2019-09-20",325,4,1,60,9,399
"Camden","07:00:00","2019-09-20",23,4,0,17,4,48
"Croydon","07:00:00","2019-09-20",474,13,3,158,29,677
"Hillingdon","07:00:00","2019-09-20",49,0,0,4,0,53
"Hounslow","07:00:00","2019-09-20",1960,108,5,572,107,2752
"Islington","07:00:00","2019-09-20",5,8,0,7,2,22
"Wandsworth","07:00:00","2019-09-20",1464,249,174,433,49,2369
"Westminster","07:00:00","2019-09-20",2117,301,120,906,277,3721
"Barking and Dagenham","08:00:00","2019-09-20",1116,14,33,129,28,1320
"Barnet","08:00:00","2019-09-20",1105,11,25,144,19,1304
"Bexley","08:00:00","2019-09-20",553,2,6,88,7,656
"Camden","08:00:00","2019-09-20",48,3,0,28,9,88
"Croydon","08:00:00","2019-09-20",518,17,1,127,29,692
"Hillingdon","08:00:00","2019-09-20",70,0,0,4,0,74
"Hounslow","08:00:00","2019-09-20",1846,93,11,484,125,2559
"Islington","08:00:00","2019-09-20",4,9,0,12,1,26
"Wandsworth","08:00:00","2019-09-20",1590,221,171,363,53,2398
"Westminster","08:00:00","2019-09-20",2390,371,109,786,278,3934
"Barking and Dagenham","09:00:00","2019-09-20",875,14,41,155,34,1119
"Barnet","09:00:00","2019-09-20",1054,8,31,162,22,1277
"Bexley","09:00:00","2019-09-20",378,2,3,58,3,444
"Camden","09:00:00","2019-09-20",82,12,2,51,9,156
"Croydon","09:00:00","2019-09-20",500,7,2,132,36,677
"Hillingdon","09:00:00","2019-09-20",19,0,0,4,1,24
"Hounslow","09:00:00","2019-09-20",1746,62,6,504,160,2478
"Islington","09:00:00","2019-09-20",5,8,0,5,3,21
"Wandsworth","09:00:00","2019-09-20",1482,155,176,404,69,2286
"Westminster","09:00:00","2019-09-20",2334,286,132,648,290,3690
"Barking and Dagenham","10:00:00","2019-09-20",850,4,33,153,29,1069
"Barnet","10:00:00","2019-09-20",773,8,30,151,21,983
"Bexley","10:00:00","2019-09-20",281,0,0,69,14,364
"Camden","10:00:00","2019-09-20",93,13,0,45,11,162
"Croydon","10:00:00","2019-09-20",515,9,4,149,37,714
"Hillingdon","10:00:00","2019-09-20",17,1,0,5,0,23
"Hounslow","10:00:00","2019-09-20",1745,57,5,597,162,2566
"Islington","10:00:00","2019-09-20",6,3,0,13,2,24
"Wandsworth","10:00:00","2019-09-20",1426,86,153,397,61,2123
"Westminster","10:00:00","2019-09-20",2381,167,108,616,249,3521
"Barking and Dagenham","11:00:00","2019-09-20",773,16,42,119,29,979
"Barnet","11:00:00","2019-09-20",794,18,29,151,18,1010
"Bexley","11:00:00","2019-09-20",327,0,0,77,9,413
"Camden","11:00:00","2019-09-20",94,6,0,47,6,153
"Croydon","11:00:00","2019-09-20",518,13,1,137,32,701
"Hillingdon","11:00:00","2019-09-20",18,0,0,5,0,23
"Hounslow","11:00:00","2019-09-20",1623,69,5,525,131,2353
"Islington","11:00:00","2019-09-20",5,1,0,9,1,16
"Wandsworth","11:00:00","2019-09-20",1395,102,180,441,78,2196
"Westminster","11:00:00","2019-09-20",2123,141,85,658,257,3264
"Barking and Dagenham","12:00:00","2019-09-20",843,8,41,140,15,1047
"Barnet","12:00:00","2019-09-20",837,9,23,148,19,1036
"Bexley","12:00:00","2019-09-20",315,5,0,66,7,393
"Camden","12:00:00","2019-09-20",96,19,1,36,5,157
"Croydon","12:00:00","2019-09-20",480,19,1,114,26,640
"Hillingdon","12:00:00","2019-09-20",31,0,0,3,1,35
"Hounslow","12:00:00","2019-09-20",1720,73,5,580,153,2531
"Islington","12:00:00","2019-09-20",6,5,0,10,5,26
"Wandsworth","12:00:00","2019-09-20",1379,132,157,417,61,2146
"Westminster","12:00:00","2019-09-20",2299,143,90,669,219,3420
"Barking and Dagenham","13:00:00","2019-09-20",872,9,40,146,22,1089
"Barnet","13:00:00","2019-09-20",882,25,27,135,15,1084
"Bexley","13:00:00","2019-09-20",316,2,0,84,7,409
"Camden","13:00:00","2019-09-20",87,16,1,42,5,151
"Croydon","13:00:00","2019-09-20",540,19,4,130,32,725
"Hillingdon","13:00:00","2019-09-20",35,3,0,4,1,43
"Hounslow","13:00:00","2019-09-20",1714,59,4,498,138,2413
"Islington","13:00:00","2019-09-20",3,8,0,3,3,17
"Wandsworth","13:00:00","2019-09-20",1398,141,158,341,63,2101
"Westminster","13:00:00","2019-09-20",2410,155,103,632,217,3517
"Barking and Dagenham","14:00:00","2019-09-20",911,8,46,132,23,1120
"Barnet","14:00:00","2019-09-20",1041,18,27,136,22,1244
"Bexley","14:00:00","2019-09-20",373,3,0,72,6,454
"Camden","14:00:00","2019-09-20",81,21,1,41,3,147
"Croydon","14:00:00","2019-09-20",554,18,5,125,13,715
"Hillingdon","14:00:00","2019-09-20",21,2,0,5,0,28
"Hounslow","14:00:00","2019-09-20",1730,74,10,472,127,2413
"Islington","14:00:00","2019-09-20",7,2,0,6,1,16
"Wandsworth","14:00:00","2019-09-20",1523,140,171,407,49,2290
"Westminster","14:00:00","2019-09-20",2468,209,113,606,213,3609
"Barking and Dagenham","15:00:00","2019-09-20",995,17,41,97,15,1165
"Barnet","15:00:00","2019-09-20",1126,11,35,134,17,1323
"Bexley","15:00:00","2019-09-20",469,5,2,90,6,572
"Camden","15:00:00","2019-09-20",95,15,1,35,3,149
"Croydon","15:00:00","2019-09-20",471,24,8,126,12,641
"Hillingdon","15:00:00","2019-09-20",23,0,0,6,0,29
"Hounslow","15:00:00","2019-09-20",1736,79,10,449,108,2382
"Islington","15:00:00","2019-09-20",13,1,0,10,0,24
"Wandsworth","15:00:00","2019-09-20",1555,163,156,360,42,2276
"Westminster","15:00:00","2019-09-20",2627,250,91,681,146,3795
"Barking and Dagenham","16:00:00","2019-09-20",1090,16,38,125,8,1277
"Barnet","16:00:00","2019-09-20",1183,25,27,140,9,1384
"Bexley","16:00:00","2019-09-20",460,8,1,93,2,564
"Camden","16:00:00","2019-09-20",107,13,3,37,2,162
"Croydon","16:00:00","2019-09-20",526,27,1,123,14,691
"Hillingdon","16:00:00","2019-09-20",32,0,0,2,0,34
"Hounslow","16:00:00","2019-09-20",1709,83,14,397,70,2273
"Islington","16:00:00","2019-09-20",10,5,0,5,0,20
"Wandsworth","16:00:00","2019-09-20",1605,151,154,294,39,2243
"Westminster","16:00:00","2019-09-20",2693,282,112,455,108,3650
"Barking and Dagenham","17:00:00","2019-09-20",1071,22,46,100,16,1255
"Barnet","17:00:00","2019-09-20",1222,42,23,143,6,1436
"Bexley","17:00:00","2019-09-20",421,7,1,67,3,499
"Camden","17:00:00","2019-09-20",116,19,0,31,1,167
"Croydon","17:00:00","2019-09-20",563,29,2,72,10,676
"Hillingdon","17:00:00","2019-09-20",18,1,0,3,0,22
"Hounslow","17:00:00","2019-09-20",1691,120,8,287,57,2163
"Islington","17:00:00","2019-09-20",17,2,0,0,1,20
"Wandsworth","17:00:00","2019-09-20",1573,248,188,287,25,2321
"Westminster","17:00:00","2019-09-20",2734,395,122,400,81,3732
"Barking and Dagenham","18:00:00","2019-09-20",1125,20,33,101,10,1289
"Barnet","18:00:00","2019-09-20",1289,49,30,114,5,1487
"Bexley","18:00:00","2019-09-20",400,4,0,34,0,438
"Camden","18:00:00","2019-09-20",121,8,0,25,1,155
"Croydon","18:00:00","2019-09-20",600,29,0,72,8,709
"Hillingdon","18:00:00","2019-09-20",30,5,0,4,1,40
"Hounslow","18:00:00","2019-09-20",1734,98,6,270,52,2160
"Islington","18:00:00","2019-09-20",19,3,0,2,0,24
"Wandsworth","18:00:00","2019-09-20",1847,272,166,290,19,2594
"Westminster","18:00:00","2019-09-20",3118,373,108,289,74,3962
"Barnet","07:00:00","2019-09-23",68,1,0,10,1,80
"Brent","07:00:00","2019-09-23",4902,171,31,1508,543,7155
"Bromley","07:00:00","2019-09-23",224,4,0,30,1,259
"Enfield","07:00:00","2019-09-23",736,12,15,236,47,1046
"Greenwich","07:00:00","2019-09-23",71,2,0,10,0,83
"Haringey","07:00:00","2019-09-23",23,0,1,10,0,34
"Havering","07:00:00","2019-09-23",1420,17,58,313,14,1822
"Hillingdon","07:00:00","2019-09-23",185,1,0,36,0,222
"Islington","07:00:00","2019-09-23",43,3,0,33,8,87
"Lewisham","07:00:00","2019-09-23",368,8,1,126,2,505
"Richmond upon Thames","07:00:00","2019-09-23",106,1,0,8,0,115
"Barnet","08:00:00","2019-09-23",124,5,0,12,1,142
"Brent","08:00:00","2019-09-23",4643,127,30,1197,534,6531
"Bromley","08:00:00","2019-09-23",214,0,0,24,1,239
"Enfield","08:00:00","2019-09-23",805,6,13,200,43,1067
"Greenwich","08:00:00","2019-09-23",115,1,0,12,0,128
"Haringey","08:00:00","2019-09-23",35,1,0,11,2,49
"Havering","08:00:00","2019-09-23",1616,10,57,271,14,1968
"Hillingdon","08:00:00","2019-09-23",307,0,0,34,3,344
"Islington","08:00:00","2019-09-23",81,7,2,39,12,141
"Lewisham","08:00:00","2019-09-23",464,11,3,104,2,584
"Richmond upon Thames","08:00:00","2019-09-23",145,2,0,12,1,160
"Barnet","09:00:00","2019-09-23",71,0,0,9,2,82
"Brent","09:00:00","2019-09-23",4328,89,30,1374,614,6435
"Bromley","09:00:00","2019-09-23",133,2,0,32,1,168
"Enfield","09:00:00","2019-09-23",646,4,12,192,40,894
"Greenwich","09:00:00","2019-09-23",63,1,0,11,0,75
"Haringey","09:00:00","2019-09-23",69,1,0,18,1,89
"Havering","09:00:00","2019-09-23",1303,6,56,307,15,1687
"Hillingdon","09:00:00","2019-09-23",158,1,0,34,2,195
"Islington","09:00:00","2019-09-23",111,6,0,56,5,178
"Lewisham","09:00:00","2019-09-23",382,6,1,101,2,492
"Richmond upon Thames","09:00:00","2019-09-23",89,1,0,8,0,98
"Barnet","10:00:00","2019-09-23",56,0,0,13,2,71
"Brent","10:00:00","2019-09-23",3994,65,25,1348,693,6125
"Bromley","10:00:00","2019-09-23",129,1,0,23,0,153
"Enfield","10:00:00","2019-09-23",601,9,16,213,38,877
"Greenwich","10:00:00","2019-09-23",61,1,0,11,0,73
"Haringey","10:00:00","2019-09-23",73,0,0,25,1,99
"Havering","10:00:00","2019-09-23",1081,6,55,209,9,1360
"Hillingdon","10:00:00","2019-09-23",113,0,0,31,0,144
"Islington","10:00:00","2019-09-23",92,7,0,51,8,158
"Lewisham","10:00:00","2019-09-23",332,2,0,85,4,423
"Richmond upon Thames","10:00:00","2019-09-23",52,0,0,13,0,65
"Barnet","11:00:00","2019-09-23",61,2,0,12,1,76
"Brent","11:00:00","2019-09-23",4238,64,21,1441,763,6527
"Bromley","11:00:00","2019-09-23",118,4,0,30,1,153
"Enfield","11:00:00","2019-09-23",590,9,14,180,35,828
"Greenwich","11:00:00","2019-09-23",54,1,0,4,1,60
"Haringey","11:00:00","2019-09-23",54,1,0,19,3,77
"Havering","11:00:00","2019-09-23",1198,6,52,240,19,1515
"Hillingdon","11:00:00","2019-09-23",117,0,0,20,1,138
"Islington","11:00:00","2019-09-23",94,9,0,74,11,188
"Lewisham","11:00:00","2019-09-23",312,8,1,81,1,403
"Richmond upon Thames","11:00:00","2019-09-23",53,2,0,8,0,63
"Barnet","12:00:00","2019-09-23",79,0,0,12,0,91
"Brent","12:00:00","2019-09-23",3929,75,17,1403,714,6138
"Bromley","12:00:00","2019-09-23",139,0,0,38,1,178
"Enfield","12:00:00","2019-09-23",567,10,14,213,38,842
"Greenwich","12:00:00","2019-09-23",52,2,0,5,0,59
"Haringey","12:00:00","2019-09-23",57,4,0,24,1,86
"Havering","12:00:00","2019-09-23",1164,6,54,256,21,1501
"Hillingdon","12:00:00","2019-09-23",139,1,0,22,0,162
"Islington","12:00:00","2019-09-23",66,26,0,50,4,146
"Lewisham","12:00:00","2019-09-23",377,12,0,82,5,476
"Richmond upon Thames","12:00:00","2019-09-23",70,3,0,13,1,87
"Barnet","13:00:00","2019-09-23",71,1,0,17,5,94
"Brent","13:00:00","2019-09-23",4260,81,25,1402,748,6516
"Bromley","13:00:00","2019-09-23",137,2,0,29,0,168
"Enfield","13:00:00","2019-09-23",514,13,11,162,39,739
"Greenwich","13:00:00","2019-09-23",48,3,0,3,1,55
"Haringey","13:00:00","2019-09-23",59,2,0,25,1,87
"Havering","13:00:00","2019-09-23",1178,13,56,233,24,1504
"Hillingdon","13:00:00","2019-09-23",108,2,0,22,0,132
"Islington","13:00:00","2019-09-23",60,14,0,35,6,115
"Lewisham","13:00:00","2019-09-23",353,14,0,74,4,445
"Richmond upon Thames","13:00:00","2019-09-23",53,0,0,10,0,63
"Barnet","14:00:00","2019-09-23",77,1,1,13,0,92
"Brent","14:00:00","2019-09-23",4723,92,17,1398,631,6861
"Bromley","14:00:00","2019-09-23",150,1,0,30,0,181
"Enfield","14:00:00","2019-09-23",690,7,11,167,32,907
"Greenwich","14:00:00","2019-09-23",50,1,0,2,0,53
"Haringey","14:00:00","2019-09-23",71,7,0,19,1,98
"Havering","14:00:00","2019-09-23",1404,9,59,302,21,1795
"Hillingdon","14:00:00","2019-09-23",153,3,0,28,6,190
"Islington","14:00:00","2019-09-23",65,14,0,38,5,122
"Lewisham","14:00:00","2019-09-23",418,9,2,76,8,513
"Richmond upon Thames","14:00:00","2019-09-23",89,1,0,7,1,98
"Barnet","15:00:00","2019-09-23",85,1,0,13,0,99
"Brent","15:00:00","2019-09-23",4706,93,19,1431,468,6717
"Bromley","15:00:00","2019-09-23",252,1,0,37,0,290
"Enfield","15:00:00","2019-09-23",745,17,14,200,50,1026
"Greenwich","15:00:00","2019-09-23",68,4,0,5,1,78
"Haringey","15:00:00","2019-09-23",83,3,0,16,2,104
"Havering","15:00:00","2019-09-23",1305,4,65,287,20,1681
"Hillingdon","15:00:00","2019-09-23",217,2,0,39,1,259
"Islington","15:00:00","2019-09-23",100,12,0,53,4,169
"Lewisham","15:00:00","2019-09-23",451,8,2,97,3,561
"Richmond upon Thames","15:00:00","2019-09-23",140,0,0,8,0,148
"Barnet","16:00:00","2019-09-23",84,1,0,18,0,103
"Brent","16:00:00","2019-09-23",5004,144,17,1281,365,6811
"Bromley","16:00:00","2019-09-23",314,5,0,43,0,362
"Enfield","16:00:00","2019-09-23",722,18,13,195,33,981
"Greenwich","16:00:00","2019-09-23",62,0,0,5,0,67
"Haringey","16:00:00","2019-09-23",79,4,0,17,1,101
"Havering","16:00:00","2019-09-23",1503,13,68,323,14,1921
"Hillingdon","16:00:00","2019-09-23",233,1,0,35,0,269
"Islington","16:00:00","2019-09-23",95,11,0,36,5,147
"Lewisham","16:00:00","2019-09-23",512,19,1,98,0,630
"Richmond upon Thames","16:00:00","2019-09-23",130,0,0,8,0,138
"Barnet","17:00:00","2019-09-23",99,1,0,17,0,117
"Brent","17:00:00","2019-09-23",4951,163,17,1059,215,6405
"Bromley","17:00:00","2019-09-23",302,4,0,39,0,345
"Enfield","17:00:00","2019-09-23",753,19,14,179,23,988
"Greenwich","17:00:00","2019-09-23",65,3,0,8,0,76
"Haringey","17:00:00","2019-09-23",94,3,0,18,1,116
"Havering","17:00:00","2019-09-23",1824,10,53,295,10,2192
"Hillingdon","17:00:00","2019-09-23",228,6,0,19,0,253
"Islington","17:00:00","2019-09-23",94,32,0,21,4,151
"Lewisham","17:00:00","2019-09-23",496,8,0,75,0,579
"Richmond upon Thames","17:00:00","2019-09-23",105,2,0,7,0,114
"Barnet","18:00:00","2019-09-23",86,4,0,10,0,100
"Brent","18:00:00","2019-09-23",5496,139,21,824,247,6727
"Bromley","18:00:00","2019-09-23",219,2,0,24,0,245
"Enfield","18:00:00","2019-09-23",613,14,12,135,12,786
"Greenwich","18:00:00","2019-09-23",50,1,0,4,0,55
"Haringey","18:00:00","2019-09-23",85,5,0,10,0,100
"Havering","18:00:00","2019-09-23",1649,10,54,237,7,1957
"Hillingdon","18:00:00","2019-09-23",201,3,0,27,0,231
"Islington","18:00:00","2019-09-23",98,32,0,21,3,154
"Lewisham","18:00:00","2019-09-23",506,12,0,55,1,574
"Richmond upon Thames","18:00:00","2019-09-23",91,4,0,12,0,107
"Hammersmith and Fulham","07:00:00","2019-09-24",709,42,19,218,24,1012
"Hillingdon","07:00:00","2019-09-24",1268,9,41,233,23,1574
"Kingston upon Thames","07:00:00","2019-09-24",815,9,7,146,17,994
"Lambeth","07:00:00","2019-09-24",335,21,4,129,10,499
"Lewisham","07:00:00","2019-09-24",210,2,0,47,2,261
"Redbridge","07:00:00","2019-09-24",590,14,0,111,5,720
"Southwark","07:00:00","2019-09-24",20,2,0,5,0,27
"Tower Hamlets","07:00:00","2019-09-24",170,5,0,56,3,234
"Westminster","07:00:00","2019-09-24",492,75,6,316,79,968
"Hammersmith and Fulham","08:00:00","2019-09-24",625,37,15,168,23,868
"Hillingdon","08:00:00","2019-09-24",1558,11,50,211,27,1857
"Kingston upon Thames","08:00:00","2019-09-24",859,5,4,130,20,1018
"Lambeth","08:00:00","2019-09-24",434,33,3,113,6,589
"Lewisham","08:00:00","2019-09-24",220,2,0,47,0,269
"Redbridge","08:00:00","2019-09-24",656,9,0,104,11,780
"Southwark","08:00:00","2019-09-24",30,2,0,8,0,40
"Tower Hamlets","08:00:00","2019-09-24",226,11,0,63,8,308
"Westminster","08:00:00","2019-09-24",540,63,8,250,57,918
"Hammersmith and Fulham","09:00:00","2019-09-24",598,32,17,175,24,846
"Hillingdon","09:00:00","2019-09-24",1551,13,52,230,33,1879
"Kingston upon Thames","09:00:00","2019-09-24",681,2,5,135,26,849
"Lambeth","09:00:00","2019-09-24",375,20,3,100,7,505
"Lewisham","09:00:00","2019-09-24",193,1,0,62,3,259
"Redbridge","09:00:00","2019-09-24",513,6,0,108,10,637
"Southwark","09:00:00","2019-09-24",43,0,0,4,0,47
"Tower Hamlets","09:00:00","2019-09-24",250,12,0,66,7,335
"Westminster","09:00:00","2019-09-24",618,54,4,253,45,974
"Hammersmith and Fulham","10:00:00","2019-09-24",558,28,21,230,31,868
"Hillingdon","10:00:00","2019-09-24",1286,13,49,209,44,1601
"Kingston upon Thames","10:00:00","2019-09-24",511,5,5,119,30,670
"Lambeth","10:00:00","2019-09-24",275,6,0,128,9,418
"Lewisham","10:00:00","2019-09-24",172,0,0,46,0,218
"Redbridge","10:00:00","2019-09-24",519,5,2,109,15,650
"Southwark","10:00:00","2019-09-24",34,2,0,10,0,46
"Tower Hamlets","10:00:00","2019-09-24",192,17,0,71,9,289
"Westminster","10:00:00","2019-09-24",654,33,5,244,43,979
"Hammersmith and Fulham","11:00:00","2019-09-24",530,36,20,220,35,841
"Hillingdon","11:00:00","2019-09-24",1323,15,44,238,31,1651
"Kingston upon Thames","11:00:00","2019-09-24",531,2,4,94,31,662
"Lambeth","11:00:00","2019-09-24",243,11,2,105,9,370
"Lewisham","11:00:00","2019-09-24",135,0,0,35,1,171
"Redbridge","11:00:00","2019-09-24",569,9,0,141,13,732
"Southwark","11:00:00","2019-09-24",33,1,0,6,0,40
"Tower Hamlets","11:00:00","2019-09-24",210,13,1,68,4,296
"Westminster","11:00:00","2019-09-24",688,41,11,222,38,1000
"Hammersmith and Fulham","12:00:00","2019-09-24",521,31,17,196,25,790
"Hillingdon","12:00:00","2019-09-24",1433,14,43,236,23,1749
"Kingston upon Thames","12:00:00","2019-09-24",587,2,5,132,15,741
"Lambeth","12:00:00","2019-09-24",290,23,3,110,11,437
"Lewisham","12:00:00","2019-09-24",160,1,0,32,0,193
"Redbridge","12:00:00","2019-09-24",533,10,1,153,14,711
"Southwark","12:00:00","2019-09-24",26,3,0,4,1,34
"Tower Hamlets","12:00:00","2019-09-24",185,12,0,84,9,290
"Westminster","12:00:00","2019-09-24",733,38,17,228,28,1044
"Hammersmith and Fulham","13:00:00","2019-09-24",488,38,14,229,21,790
"Hillingdon","13:00:00","2019-09-24",1622,10,44,237,21,1934
"Kingston upon Thames","13:00:00","2019-09-24",581,2,3,119,23,728
"Lambeth","13:00:00","2019-09-24",297,19,2,140,15,473
"Lewisham","13:00:00","2019-09-24",147,2,0,37,2,188
"Redbridge","13:00:00","2019-09-24",599,4,0,97,12,712
"Southwark","13:00:00","2019-09-24",20,5,0,5,0,30
"Tower Hamlets","13:00:00","2019-09-24",212,22,0,69,8,311
"Westminster","13:00:00","2019-09-24",703,48,11,216,46,1024
"Hammersmith and Fulham","14:00:00","2019-09-24",514,36,19,183,26,778
"Hillingdon","14:00:00","2019-09-24",1607,11,48,250,19,1935
"Kingston upon Thames","14:00:00","2019-09-24",666,4,5,150,24,849
"Lambeth","14:00:00","2019-09-24",325,15,0,126,17,483
"Lewisham","14:00:00","2019-09-24",175,4,0,26,1,206
"Redbridge","14:00:00","2019-09-24",617,10,3,127,18,775
"Southwark","14:00:00","2019-09-24",18,2,0,6,0,26
"Tower Hamlets","14:00:00","2019-09-24",193,21,0,59,3,276
"Westminster","14:00:00","2019-09-24",672,51,13,218,39,993
"Hammersmith and Fulham","15:00:00","2019-09-24",525,28,15,175,19,762
"Hillingdon","15:00:00","2019-09-24",1632,21,47,229,20,1949
"Kingston upon Thames","15:00:00","2019-09-24",716,4,2,149,13,884
"Lambeth","15:00:00","2019-09-24",387,14,2,121,0,524
"Lewisham","15:00:00","2019-09-24",162,1,0,29,0,192
"Redbridge","15:00:00","2019-09-24",587,6,2,136,9,740
"Southwark","15:00:00","2019-09-24",22,2,0,2,0,26
"Tower Hamlets","15:00:00","2019-09-24",216,18,1,60,5,300
"Westminster","15:00:00","2019-09-24",673,29,16,197,21,936
"Hammersmith and Fulham","16:00:00","2019-09-24",547,38,19,174,8,786
"Hillingdon","16:00:00","2019-09-24",1818,21,46,263,18,2166
"Kingston upon Thames","16:00:00","2019-09-24",936,8,5,167,11,1127
"Lambeth","16:00:00","2019-09-24",407,25,4,118,4,558
"Lewisham","16:00:00","2019-09-24",244,4,0,47,0,295
"Redbridge","16:00:00","2019-09-24",625,11,2,129,10,777
"Southwark","16:00:00","2019-09-24",29,4,0,7,0,40
"Tower Hamlets","16:00:00","2019-09-24",195,16,0,72,2,285
"Westminster","16:00:00","2019-09-24",661,31,16,169,29,906
"Hammersmith and Fulham","17:00:00","2019-09-24",601,89,20,105,8,823
"Hillingdon","17:00:00","2019-09-24",2043,26,48,206,7,2330
"Kingston upon Thames","17:00:00","2019-09-24",1085,11,6,116,7,1225
"Lambeth","17:00:00","2019-09-24",395,39,0,83,1,518
"Lewisham","17:00:00","2019-09-24",276,5,0,28,1,310
"Redbridge","17:00:00","2019-09-24",707,9,0,163,7,886
"Southwark","17:00:00","2019-09-24",22,3,0,4,0,29
"Tower Hamlets","17:00:00","2019-09-24",248,28,0,67,3,346
"Westminster","17:00:00","2019-09-24",736,45,11,170,25,987
"Hammersmith and Fulham","18:00:00","2019-09-24",644,59,16,92,6,817
"Hillingdon","18:00:00","2019-09-24",1942,28,50,214,6,2240
"Kingston upon Thames","18:00:00","2019-09-24",891,19,5,52,4,971
"Lambeth","18:00:00","2019-09-24",411,52,2,66,0,531
"Lewisham","18:00:00","2019-09-24",201,11,0,22,0,234
"Redbridge","18:00:00","2019-09-24",638,10,0,78,5,731
"Southwark","18:00:00","2019-09-24",19,8,0,3,0,30
"Tower Hamlets","18:00:00","2019-09-24",200,21,0,44,0,265
"Westminster","18:00:00","2019-09-24",836,41,13,141,25,1056
"Barnet","07:00:00","2019-09-25",3087,102,18,1151,383,4741
"Bromley","07:00:00","2019-09-25",406,3,0,46,3,458
"Camden","07:00:00","2019-09-25",710,70,85,352,58,1275
"Ealing","07:00:00","2019-09-25",360,2,2,69,1,434
"Hounslow","07:00:00","2019-09-25",2011,26,166,425,141,2769
"Kingston upon Thames","07:00:00","2019-09-25",61,0,3,13,0,77
"Richmond upon Thames","07:00:00","2019-09-25",437,6,34,76,4,557
"Waltham Forest","07:00:00","2019-09-25",609,23,5,268,34,939
"Barnet","08:00:00","2019-09-25",3429,95,18,1007,395,4944
"Bromley","08:00:00","2019-09-25",419,0,1,48,0,468
"Camden","08:00:00","2019-09-25",904,91,79,343,46,1463
"Ealing","08:00:00","2019-09-25",526,4,2,68,1,601
"Hounslow","08:00:00","2019-09-25",2302,30,157,387,136,3012
"Kingston upon Thames","08:00:00","2019-09-25",116,0,2,12,0,130
"Richmond upon Thames","08:00:00","2019-09-25",586,14,39,70,5,714
"Waltham Forest","08:00:00","2019-09-25",671,18,1,288,54,1032
"Barnet","09:00:00","2019-09-25",3072,54,31,985,422,4564
"Bromley","09:00:00","2019-09-25",338,4,0,37,5,384
"Camden","09:00:00","2019-09-25",902,61,90,363,62,1478
"Ealing","09:00:00","2019-09-25",469,2,0,101,0,572
"Hounslow","09:00:00","2019-09-25",1748,26,183,387,171,2515
"Kingston upon Thames","09:00:00","2019-09-25",72,3,3,21,0,99
"Richmond upon Thames","09:00:00","2019-09-25",439,2,37,84,12,574
"Waltham Forest","09:00:00","2019-09-25",629,13,2,291,51,986
"Barnet","10:00:00","2019-09-25",2877,25,19,1042,521,4484
"Bromley","10:00:00","2019-09-25",280,3,0,49,4,336
"Camden","10:00:00","2019-09-25",786,50,79,378,49,1342
"Ealing","10:00:00","2019-09-25",299,1,0,43,2,345
"Hounslow","10:00:00","2019-09-25",1245,27,161,309,164,1906
"Kingston upon Thames","10:00:00","2019-09-25",47,0,3,12,0,62
"Richmond upon Thames","10:00:00","2019-09-25",379,3,38,49,8,477
"Waltham Forest","10:00:00","2019-09-25",819,12,5,273,73,1182
"Barnet","11:00:00","2019-09-25",3008,32,19,1133,492,4684
"Bromley","11:00:00","2019-09-25",249,2,0,46,2,299
"Camden","11:00:00","2019-09-25",740,49,66,335,50,1240
"Ealing","11:00:00","2019-09-25",307,2,0,47,1,357
"Hounslow","11:00:00","2019-09-25",1271,38,168,387,167,2031
"Kingston upon Thames","11:00:00","2019-09-25",47,0,3,18,0,68
"Richmond upon Thames","11:00:00","2019-09-25",320,2,31,45,10,408
"Waltham Forest","11:00:00","2019-09-25",868,12,5,306,57,1248
"Barnet","12:00:00","2019-09-25",3165,40,21,1028,464,4718
"Bromley","12:00:00","2019-09-25",279,1,0,43,2,325
"Camden","12:00:00","2019-09-25",731,75,82,296,47,1231
"Ealing","12:00:00","2019-09-25",383,7,0,54,0,444
"Hounslow","12:00:00","2019-09-25",1646,47,154,406,151,2404
"Kingston upon Thames","12:00:00","2019-09-25",54,2,3,9,0,68
"Richmond upon Thames","12:00:00","2019-09-25",348,10,35,42,6,441
"Waltham Forest","12:00:00","2019-09-25",719,14,4,243,40,1020
"Barnet","13:00:00","2019-09-25",3339,39,20,1041,487,4926
"Bromley","13:00:00","2019-09-25",272,0,0,40,3,315
"Camden","13:00:00","2019-09-25",804,71,89,336,31,1331
"Ealing","13:00:00","2019-09-25",379,9,0,53,0,441
"Hounslow","13:00:00","2019-09-25",1723,54,161,338,178,2454
"Kingston upon Thames","13:00:00","2019-09-25",40,0,4,11,1,56
"Richmond upon Thames","13:00:00","2019-09-25",336,5,41,42,7,431
"Waltham Forest","13:00:00","2019-09-25",753,11,2,279,50,1095
"Barnet","14:00:00","2019-09-25",3571,46,19,1104,410,5150
"Bromley","14:00:00","2019-09-25",316,3,0,40,3,362
"Camden","14:00:00","2019-09-25",735,75,73,322,33,1238
"Ealing","14:00:00","2019-09-25",390,9,1,49,2,451
"Hounslow","14:00:00","2019-09-25",1671,42,148,375,186,2422
"Kingston upon Thames","14:00:00","2019-09-25",33,0,4,14,0,51
"Richmond upon Thames","14:00:00","2019-09-25",383,3,44,34,5,469
"Waltham Forest","14:00:00","2019-09-25",825,10,0,302,61,1198
"Barnet","15:00:00","2019-09-25",3610,57,29,1040,329,5065
"Bromley","15:00:00","2019-09-25",379,5,0,44,4,432
"Camden","15:00:00","2019-09-25",757,74,82,295,21,1229
"Ealing","15:00:00","2019-09-25",540,10,4,41,1,596
"Hounslow","15:00:00","2019-09-25",1888,50,172,382,158,2650
"Kingston upon Thames","15:00:00","2019-09-25",81,1,4,25,0,111
"Richmond upon Thames","15:00:00","2019-09-25",369,11,35,41,3,459
"Waltham Forest","15:00:00","2019-09-25",760,13,3,236,37,1049
"Barnet","16:00:00","2019-09-25",4046,91,17,1143,198,5495
"Bromley","16:00:00","2019-09-25",378,3,0,47,3,431
"Camden","16:00:00","2019-09-25",939,92,99,266,7,1403
"Ealing","16:00:00","2019-09-25",433,19,0,73,0,525
"Hounslow","16:00:00","2019-09-25",2151,52,168,381,162,2914
"Kingston upon Thames","16:00:00","2019-09-25",82,0,4,4,0,90
"Richmond upon Thames","16:00:00","2019-09-25",454,5,35,50,2,546
"Waltham Forest","16:00:00","2019-09-25",725,18,4,222,30,999
"Barnet","17:00:00","2019-09-25",4451,125,19,854,143,5592
"Bromley","17:00:00","2019-09-25",398,1,0,36,2,437
"Camden","17:00:00","2019-09-25",962,96,89,215,7,1369
"Ealing","17:00:00","2019-09-25",524,8,0,42,0,574
"Hounslow","17:00:00","2019-09-25",2505,89,165,363,126,3248
"Kingston upon Thames","17:00:00","2019-09-25",115,0,3,11,0,129
"Richmond upon Thames","17:00:00","2019-09-25",492,12,31,40,1,576
"Waltham Forest","17:00:00","2019-09-25",778,37,0,181,31,1027
"Barnet","18:00:00","2019-09-25",4539,106,24,736,120,5525
"Bromley","18:00:00","2019-09-25",423,7,0,24,0,454
"Camden","18:00:00","2019-09-25",1065,86,95,139,17,1402
"Ealing","18:00:00","2019-09-25",471,13,0,69,2,555
"Hounslow","18:00:00","2019-09-25",2338,56,172,229,117,2912
"Kingston upon Thames","18:00:00","2019-09-25",95,4,2,8,0,109
"Richmond upon Thames","18:00:00","2019-09-25",487,14,34,34,0,569
"Waltham Forest","18:00:00","2019-09-25",751,28,2,150,13,944
"Bexley","07:00:00","2019-09-26",104,2,0,18,4,128
"Brent","07:00:00","2019-09-26",93,6,0,19,0,118
"Bromley","07:00:00","2019-09-26",546,6,6,142,10,710
"Croydon","07:00:00","2019-09-26",57,1,0,12,0,70
"Greenwich","07:00:00","2019-09-26",57,1,0,14,0,72
"Hillingdon","07:00:00","2019-09-26",32,1,0,5,0,38
"Lewisham","07:00:00","2019-09-26",18,1,0,3,0,22
"Richmond upon Thames","07:00:00","2019-09-26",375,2,7,65,3,452
"Southwark","07:00:00","2019-09-26",10,2,0,20,6,38
"Bexley","08:00:00","2019-09-26",236,1,0,22,0,259
"Brent","08:00:00","2019-09-26",115,0,0,15,0,130
"Bromley","08:00:00","2019-09-26",708,4,4,151,8,875
"Croydon","08:00:00","2019-09-26",69,2,0,2,0,73
"Greenwich","08:00:00","2019-09-26",116,0,0,13,0,129
"Hillingdon","08:00:00","2019-09-26",71,0,0,3,0,74
"Lewisham","08:00:00","2019-09-26",22,2,0,9,0,33
"Richmond upon Thames","08:00:00","2019-09-26",460,2,4,69,2,537
"Southwark","08:00:00","2019-09-26",14,2,0,23,7,46
"Bexley","09:00:00","2019-09-26",91,1,0,16,0,108
"Brent","09:00:00","2019-09-26",92,0,0,9,0,101
"Bromley","09:00:00","2019-09-26",524,4,5,108,13,654
"Croydon","09:00:00","2019-09-26",44,2,0,9,0,55
"Greenwich","09:00:00","2019-09-26",130,1,9,30,0,170
"Hillingdon","09:00:00","2019-09-26",19,0,0,3,0,22
"Lewisham","09:00:00","2019-09-26",27,1,0,11,0,39
"Richmond upon Thames","09:00:00","2019-09-26",239,1,5,69,4,318
"Southwark","09:00:00","2019-09-26",10,4,0,21,6,41
"Bexley","10:00:00","2019-09-26",69,1,0,11,0,81
"Brent","10:00:00","2019-09-26",74,0,0,26,0,100
"Bromley","10:00:00","2019-09-26",429,3,8,107,7,554
"Croydon","10:00:00","2019-09-26",29,0,0,5,0,34
"Greenwich","10:00:00","2019-09-26",86,2,0,23,3,114
"Hillingdon","10:00:00","2019-09-26",12,2,0,0,0,14
"Lewisham","10:00:00","2019-09-26",15,0,0,11,1,27
"Richmond upon Thames","10:00:00","2019-09-26",209,4,7,48,3,271
"Southwark","10:00:00","2019-09-26",12,6,0,21,5,44
"Bexley","11:00:00","2019-09-26",71,0,0,19,3,93
"Brent","11:00:00","2019-09-26",69,1,0,19,0,89
"Bromley","11:00:00","2019-09-26",403,2,7,87,8,507
"Croydon","11:00:00","2019-09-26",46,0,0,3,0,49
"Greenwich","11:00:00","2019-09-26",98,3,0,29,4,134
"Hillingdon","11:00:00","2019-09-26",29,0,0,4,0,33
"Lewisham","11:00:00","2019-09-26",17,0,0,7,1,25
"Richmond upon Thames","11:00:00","2019-09-26",216,3,7,51,2,279
"Southwark","11:00:00","2019-09-26",16,7,0,24,5,52
"Bexley","12:00:00","2019-09-26",59,0,0,13,3,75
"Brent","12:00:00","2019-09-26",74,2,0,16,2,94
"Bromley","12:00:00","2019-09-26",454,5,6,103,9,577
"Croydon","12:00:00","2019-09-26",27,0,0,6,0,33
"Greenwich","12:00:00","2019-09-26",93,0,0,34,3,130
"Hillingdon","12:00:00","2019-09-26",27,0,0,6,2,35
"Lewisham","12:00:00","2019-09-26",15,2,0,6,0,23
"Richmond upon Thames","12:00:00","2019-09-26",232,2,6,54,2,296
"Southwark","12:00:00","2019-09-26",14,6,0,13,6,39
"Bexley","13:00:00","2019-09-26",61,1,0,12,2,76
"Brent","13:00:00","2019-09-26",77,4,0,23,0,104
"Bromley","13:00:00","2019-09-26",489,5,6,102,10,612
"Croydon","13:00:00","2019-09-26",23,0,0,4,0,27
"Greenwich","13:00:00","2019-09-26",87,0,0,26,1,114
"Hillingdon","13:00:00","2019-09-26",17,0,0,2,0,19
"Lewisham","13:00:00","2019-09-26",15,0,0,7,0,22
"Richmond upon Thames","13:00:00","2019-09-26",192,0,6,42,1,241
"Southwark","13:00:00","2019-09-26",16,6,0,10,3,35
"Bexley","14:00:00","2019-09-26",71,1,0,19,4,95
"Brent","14:00:00","2019-09-26",77,3,0,23,0,103
"Bromley","14:00:00","2019-09-26",559,5,8,99,6,677
"Croydon","14:00:00","2019-09-26",34,0,0,8,0,42
"Greenwich","14:00:00","2019-09-26",90,2,0,26,2,120
"Hillingdon","14:00:00","2019-09-26",24,0,0,5,1,30
"Lewisham","14:00:00","2019-09-26",15,0,0,3,0,18
"Richmond upon Thames","14:00:00","2019-09-26",226,5,6,51,4,292
"Southwark","14:00:00","2019-09-26",12,3,0,13,2,30
"Bexley","15:00:00","2019-09-26",141,0,0,18,0,159
"Brent","15:00:00","2019-09-26",103,3,0,23,3,132
"Bromley","15:00:00","2019-09-26",647,6,6,140,8,807
"Croydon","15:00:00","2019-09-26",41,0,0,3,0,44
"Greenwich","15:00:00","2019-09-26",148,6,6,20,0,180
"Hillingdon","15:00:00","2019-09-26",49,0,0,5,0,54
"Lewisham","15:00:00","2019-09-26",30,2,0,4,0,36
"Richmond upon Thames","15:00:00","2019-09-26",309,5,5,75,2,396
"Southwark","15:00:00","2019-09-26",12,5,0,13,3,33
"Bexley","16:00:00","2019-09-26",113,4,0,18,0,135
"Brent","16:00:00","2019-09-26",126,3,0,16,0,145
"Bromley","16:00:00","2019-09-26",719,13,5,151,4,892
"Croydon","16:00:00","2019-09-26",57,0,0,8,0,65
"Greenwich","16:00:00","2019-09-26",124,3,0,14,0,141
"Hillingdon","16:00:00","2019-09-26",21,0,0,6,0,27
"Lewisham","16:00:00","2019-09-26",33,2,0,4,0,39
"Richmond upon Thames","16:00:00","2019-09-26",333,5,7,82,3,430
"Southwark","16:00:00","2019-09-26",17,3,0,17,0,37
"Bexley","17:00:00","2019-09-26",130,0,0,18,1,149
"Brent","17:00:00","2019-09-26",166,2,0,22,0,190
"Bromley","17:00:00","2019-09-26",795,13,5,100,6,919
"Croydon","17:00:00","2019-09-26",70,0,0,9,0,79
"Greenwich","17:00:00","2019-09-26",114,1,0,10,1,126
"Hillingdon","17:00:00","2019-09-26",21,2,0,2,0,25
"Lewisham","17:00:00","2019-09-26",25,0,0,6,0,31
"Richmond upon Thames","17:00:00","2019-09-26",357,7,5,60,0,429
"Southwark","17:00:00","2019-09-26",11,6,0,6,1,24
"Bexley","18:00:00","2019-09-26",117,2,0,13,0,132
"Brent","18:00:00","2019-09-26",180,3,0,22,4,209
"Bromley","18:00:00","2019-09-26",607,6,5,67,1,686
"Croydon","18:00:00","2019-09-26",76,1,0,5,0,82
"Greenwich","18:00:00","2019-09-26",111,2,0,5,1,119
"Hillingdon","18:00:00","2019-09-26",16,0,0,2,0,18
"Lewisham","18:00:00","2019-09-26",29,1,0,7,0,37
"Richmond upon Thames","18:00:00","2019-09-26",310,6,8,31,1,356
"Southwark","18:00:00","2019-09-26",28,8,0,2,0,38
"Bexley","07:00:00","2019-09-27",78,0,0,10,0,88
"Croydon","07:00:00","2019-09-27",417,8,38,124,20,607
"Ealing","07:00:00","2019-09-27",28,0,0,5,0,33
"Haringey","07:00:00","2019-09-27",119,0,0,37,5,161
"Hounslow","07:00:00","2019-09-27",421,15,33,108,12,589
"Lambeth","07:00:00","2019-09-27",363,67,3,182,20,635
"Richmond upon Thames","07:00:00","2019-09-27",551,16,44,138,11,760
"Tower Hamlets","07:00:00","2019-09-27",60,2,14,12,0,88
"Bexley","08:00:00","2019-09-27",165,1,0,27,1,194
"Croydon","08:00:00","2019-09-27",556,13,33,104,16,722
"Ealing","08:00:00","2019-09-27",55,3,4,3,0,65
"Haringey","08:00:00","2019-09-27",127,0,0,43,0,170
"Hounslow","08:00:00","2019-09-27",500,18,32,77,9,636
"Lambeth","08:00:00","2019-09-27",436,77,6,199,11,729
"Richmond upon Thames","08:00:00","2019-09-27",586,20,43,95,20,764
"Tower Hamlets","08:00:00","2019-09-27",147,3,12,23,0,185
"Bexley","09:00:00","2019-09-27",86,0,0,11,0,97
"Croydon","09:00:00","2019-09-27",486,13,34,139,21,693
"Ealing","09:00:00","2019-09-27",30,1,0,8,0,39
"Haringey","09:00:00","2019-09-27",82,2,0,24,3,111
"Hounslow","09:00:00","2019-09-27",394,16,37,101,19,567
"Lambeth","09:00:00","2019-09-27",386,42,7,123,15,573
"Richmond upon Thames","09:00:00","2019-09-27",442,9,44,107,18,620
"Tower Hamlets","09:00:00","2019-09-27",144,1,11,15,3,174
"Bexley","10:00:00","2019-09-27",55,0,0,8,2,65
"Croydon","10:00:00","2019-09-27",484,7,32,117,20,660
"Ealing","10:00:00","2019-09-27",27,0,0,11,0,38
"Haringey","10:00:00","2019-09-27",78,2,0,27,1,108
"Hounslow","10:00:00","2019-09-27",397,22,37,113,18,587
"Lambeth","10:00:00","2019-09-27",268,21,6,120,15,430
"Richmond upon Thames","10:00:00","2019-09-27",402,9,39,84,15,549
"Tower Hamlets","10:00:00","2019-09-27",112,0,10,17,1,140
"Bexley","11:00:00","2019-09-27",68,0,0,17,0,85
"Croydon","11:00:00","2019-09-27",543,14,27,104,18,706
"Ealing","11:00:00","2019-09-27",29,3,0,11,2,45
"Haringey","11:00:00","2019-09-27",69,2,0,25,2,98
"Hounslow","11:00:00","2019-09-27",455,27,29,125,10,646
"Lambeth","11:00:00","2019-09-27",321,17,4,138,18,498
"Richmond upon Thames","11:00:00","2019-09-27",385,8,46,107,11,557
"Tower Hamlets","11:00:00","2019-09-27",110,1,13,11,3,138
"Bexley","12:00:00","2019-09-27",83,1,0,16,0,100
"Croydon","12:00:00","2019-09-27",554,21,24,120,15,734
"Ealing","12:00:00","2019-09-27",37,0,0,6,0,43
"Haringey","12:00:00","2019-09-27",96,3,0,32,2,133
"Hounslow","12:00:00","2019-09-27",471,21,33,104,10,639
"Lambeth","12:00:00","2019-09-27",308,16,6,106,13,449
"Richmond upon Thames","12:00:00","2019-09-27",389,11,44,81,11,536
"Tower Hamlets","12:00:00","2019-09-27",107,5,11,25,3,151
"Bexley","13:00:00","2019-09-27",73,4,0,13,1,91
"Croydon","13:00:00","2019-09-27",594,30,35,107,19,785
"Ealing","13:00:00","2019-09-27",30,0,0,9,2,41
"Haringey","13:00:00","2019-09-27",136,3,2,22,1,164
"Hounslow","13:00:00","2019-09-27",451,19,35,109,17,631
"Lambeth","13:00:00","2019-09-27",240,13,4,95,12,364
"Richmond upon Thames","13:00:00","2019-09-27",409,13,34,78,8,542
"Tower Hamlets","13:00:00","2019-09-27",136,4,10,23,1,174
"Bexley","14:00:00","2019-09-27",92,1,0,10,0,103
"Croydon","14:00:00","2019-09-27",590,16,27,101,20,754
"Ealing","14:00:00","2019-09-27",32,1,0,4,0,37
"Haringey","14:00:00","2019-09-27",111,4,0,28,1,144
"Hounslow","14:00:00","2019-09-27",480,32,30,108,18,668
"Lambeth","14:00:00","2019-09-27",249,10,5,94,11,369
"Richmond upon Thames","14:00:00","2019-09-27",400,7,38,85,13,543
"Tower Hamlets","14:00:00","2019-09-27",123,9,9,19,0,160
"Bexley","15:00:00","2019-09-27",149,0,0,28,0,177
"Croydon","15:00:00","2019-09-27",651,24,27,110,14,826
"Ealing","15:00:00","2019-09-27",41,0,0,9,0,50
"Haringey","15:00:00","2019-09-27",113,6,1,23,0,143
"Hounslow","15:00:00","2019-09-27",567,27,34,72,7,707
"Lambeth","15:00:00","2019-09-27",381,16,5,70,4,476
"Richmond upon Thames","15:00:00","2019-09-27",478,9,41,58,12,598
"Tower Hamlets","15:00:00","2019-09-27",202,8,8,22,2,242
"Bexley","16:00:00","2019-09-27",91,0,0,19,0,110
"Croydon","16:00:00","2019-09-27",684,38,41,91,6,860
"Ealing","16:00:00","2019-09-27",41,4,0,17,0,62
"Haringey","16:00:00","2019-09-27",104,2,0,18,0,124
"Hounslow","16:00:00","2019-09-27",583,25,32,96,7,743
"Lambeth","16:00:00","2019-09-27",343,26,7,56,2,434
"Richmond upon Thames","16:00:00","2019-09-27",577,10,42,80,9,718
"Tower Hamlets","16:00:00","2019-09-27",160,2,12,25,0,199
"Bexley","17:00:00","2019-09-27",109,0,0,15,0,124
"Croydon","17:00:00","2019-09-27",689,34,26,70,10,829
"Ealing","17:00:00","2019-09-27",43,3,0,13,0,59
"Haringey","17:00:00","2019-09-27",130,10,0,10,0,150
"Hounslow","17:00:00","2019-09-27",669,39,40,69,3,820
"Lambeth","17:00:00","2019-09-27",402,16,6,63,2,489
"Richmond upon Thames","17:00:00","2019-09-27",553,15,39,48,5,660
"Tower Hamlets","17:00:00","2019-09-27",178,10,10,7,0,205
"Bexley","18:00:00","2019-09-27",100,0,0,13,0,113
"Croydon","18:00:00","2019-09-27",687,27,34,73,5,826
"Ealing","18:00:00","2019-09-27",38,1,0,8,0,47
"Haringey","18:00:00","2019-09-27",107,14,1,13,1,136
"Hounslow","18:00:00","2019-09-27",528,30,36,53,3,650
"Lambeth","18:00:00","2019-09-27",438,16,5,37,2,498
"Richmond upon Thames","18:00:00","2019-09-27",553,14,33,51,4,655
"Tower Hamlets","18:00:00","2019-09-27",188,5,9,2,0,204
"Barnet","07:00:00","2019-09-30",350,4,7,62,3,426
"Croydon","07:00:00","2019-09-30",139,0,3,16,0,158
"Haringey","07:00:00","2019-09-30",238,7,14,40,9,308
"Hounslow","07:00:00","2019-09-30",561,14,32,81,11,699
"Islington","07:00:00","2019-09-30",52,0,0,10,2,64
"Kingston upon Thames","07:00:00","2019-09-30",37,0,0,3,0,40
"Lambeth","07:00:00","2019-09-30",109,4,1,23,0,137
"Lewisham","07:00:00","2019-09-30",12,0,0,4,0,16
"Newham","07:00:00","2019-09-30",398,7,17,62,2,486
"Southwark","07:00:00","2019-09-30",205,4,0,32,3,244
"Barnet","08:00:00","2019-09-30",485,1,7,45,7,545
"Croydon","08:00:00","2019-09-30",220,0,2,23,1,246
"Haringey","08:00:00","2019-09-30",460,8,12,56,8,544
"Hounslow","08:00:00","2019-09-30",755,17,33,82,9,896
"Islington","08:00:00","2019-09-30",42,0,0,11,4,57
"Kingston upon Thames","08:00:00","2019-09-30",38,0,0,5,0,43
"Lambeth","08:00:00","2019-09-30",180,2,1,26,0,209
"Lewisham","08:00:00","2019-09-30",30,0,2,7,1,40
"Newham","08:00:00","2019-09-30",601,9,20,63,6,699
"Southwark","08:00:00","2019-09-30",244,1,0,22,3,270
"Barnet","09:00:00","2019-09-30",258,4,7,38,5,312
"Croydon","09:00:00","2019-09-30",77,0,0,8,1,86
"Haringey","09:00:00","2019-09-30",285,6,15,46,6,358
"Hounslow","09:00:00","2019-09-30",520,9,48,85,20,682
"Islington","09:00:00","2019-09-30",60,6,1,8,3,78
"Kingston upon Thames","09:00:00","2019-09-30",32,2,0,6,0,40
"Lambeth","09:00:00","2019-09-30",100,2,0,22,0,124
"Lewisham","09:00:00","2019-09-30",25,0,2,2,0,29
"Newham","09:00:00","2019-09-30",490,14,23,54,8,589
"Southwark","09:00:00","2019-09-30",156,0,0,29,2,187
"Barnet","10:00:00","2019-09-30",211,7,6,33,10,267
"Croydon","10:00:00","2019-09-30",42,0,0,6,3,51
"Haringey","10:00:00","2019-09-30",202,1,15,41,7,266
"Hounslow","10:00:00","2019-09-30",378,11,46,63,17,515
"Islington","10:00:00","2019-09-30",45,3,0,16,4,68
"Kingston upon Thames","10:00:00","2019-09-30",29,1,0,4,0,34
"Lambeth","10:00:00","2019-09-30",53,1,0,19,0,73
"Lewisham","10:00:00","2019-09-30",17,0,0,8,0,25
"Newham","10:00:00","2019-09-30",404,7,20,56,7,494
"Southwark","10:00:00","2019-09-30",94,0,0,8,0,102
"Barnet","11:00:00","2019-09-30",223,2,5,41,4,275
"Croydon","11:00:00","2019-09-30",42,0,1,9,1,53
"Haringey","11:00:00","2019-09-30",204,2,13,36,3,258
"Hounslow","11:00:00","2019-09-30",426,9,42,78,18,573
"Islington","11:00:00","2019-09-30",42,8,0,20,5,75
"Kingston upon Thames","11:00:00","2019-09-30",20,0,0,0,0,20
"Lambeth","11:00:00","2019-09-30",67,0,0,17,0,84
"Lewisham","11:00:00","2019-09-30",24,0,0,5,0,29
"Newham","11:00:00","2019-09-30",407,6,19,78,4,514
"Southwark","11:00:00","2019-09-30",93,1,1,19,1,115
"Barnet","12:00:00","2019-09-30",251,6,7,30,4,298
"Croydon","12:00:00","2019-09-30",35,0,0,6,0,41
"Haringey","12:00:00","2019-09-30",245,7,13,44,4,313
"Hounslow","12:00:00","2019-09-30",370,10,47,87,20,534
"Islington","12:00:00","2019-09-30",46,30,2,15,3,96
"Kingston upon Thames","12:00:00","2019-09-30",26,0,0,2,0,28
"Lambeth","12:00:00","2019-09-30",65,4,0,23,0,92
"Lewisham","12:00:00","2019-09-30",15,2,0,9,0,26
"Newham","12:00:00","2019-09-30",442,13,22,65,4,546
"Southwark","12:00:00","2019-09-30",63,0,0,26,0,89
"Barnet","13:00:00","2019-09-30",233,4,5,39,10,291
"Croydon","13:00:00","2019-09-30",41,0,0,4,0,45
"Haringey","13:00:00","2019-09-30",253,9,13,43,6,324
"Hounslow","13:00:00","2019-09-30",443,13,43,67,11,577
"Islington","13:00:00","2019-09-30",41,26,0,11,0,78
"Kingston upon Thames","13:00:00","2019-09-30",32,0,0,2,0,34
"Lambeth","13:00:00","2019-09-30",67,5,0,22,4,98
"Lewisham","13:00:00","2019-09-30",15,1,0,8,0,24
"Newham","13:00:00","2019-09-30",454,7,22,59,4,546
"Southwark","13:00:00","2019-09-30",107,6,0,23,0,136
"Barnet","14:00:00","2019-09-30",271,2,6,31,4,314
"Croydon","14:00:00","2019-09-30",34,1,0,8,0,43
"Haringey","14:00:00","2019-09-30",240,9,14,36,9,308
"Hounslow","14:00:00","2019-09-30",392,13,39,78,9,531
"Islington","14:00:00","2019-09-30",45,21,0,10,3,79
"Kingston upon Thames","14:00:00","2019-09-30",33,0,0,9,0,42
"Lambeth","14:00:00","2019-09-30",101,1,0,27,0,129
"Lewisham","14:00:00","2019-09-30",22,0,0,5,0,27
"Newham","14:00:00","2019-09-30",500,6,19,91,6,622
"Southwark","14:00:00","2019-09-30",98,3,0,27,0,128
"Barnet","15:00:00","2019-09-30",311,6,3,39,3,362
"Croydon","15:00:00","2019-09-30",54,0,1,11,0,66
"Haringey","15:00:00","2019-09-30",333,9,13,52,1,408
"Hounslow","15:00:00","2019-09-30",545,18,46,84,6,699
"Islington","15:00:00","2019-09-30",46,26,0,12,1,85
"Kingston upon Thames","15:00:00","2019-09-30",31,0,0,9,0,40
"Lambeth","15:00:00","2019-09-30",153,3,0,38,2,196
"Lewisham","15:00:00","2019-09-30",15,0,1,5,0,21
"Newham","15:00:00","2019-09-30",563,15,23,74,4,679
"Southwark","15:00:00","2019-09-30",149,2,0,27,0,178
"Barnet","16:00:00","2019-09-30",356,6,9,54,1,426
"Croydon","16:00:00","2019-09-30",111,0,2,11,1,125
"Haringey","16:00:00","2019-09-30",358,4,13,54,4,433
"Hounslow","16:00:00","2019-09-30",646,19,36,70,6,777
"Islington","16:00:00","2019-09-30",86,17,0,16,0,119
"Kingston upon Thames","16:00:00","2019-09-30",46,1,0,2,0,49
"Lambeth","16:00:00","2019-09-30",209,6,0,49,0,264
"Lewisham","16:00:00","2019-09-30",36,0,0,4,0,40
"Newham","16:00:00","2019-09-30",616,15,19,63,0,713
"Southwark","16:00:00","2019-09-30",171,1,0,30,0,202
"Barnet","17:00:00","2019-09-30",385,8,5,48,0,446
"Croydon","17:00:00","2019-09-30",125,1,0,13,0,139
"Haringey","17:00:00","2019-09-30",393,7,14,31,3,448
"Hounslow","17:00:00","2019-09-30",659,17,42,49,3,770
"Islington","17:00:00","2019-09-30",76,10,0,15,0,101
"Kingston upon Thames","17:00:00","2019-09-30",44,0,0,5,1,50
"Lambeth","17:00:00","2019-09-30",223,5,0,45,0,273
"Lewisham","17:00:00","2019-09-30",30,0,0,6,0,36
"Newham","17:00:00","2019-09-30",591,17,20,62,6,696
"Southwark","17:00:00","2019-09-30",222,3,0,30,0,255
"Barnet","18:00:00","2019-09-30",403,11,6,27,0,447
"Croydon","18:00:00","2019-09-30",98,0,0,7,0,105
"Haringey","18:00:00","2019-09-30",409,8,15,39,1,472
"Hounslow","18:00:00","2019-09-30",538,28,31,47,1,645
"Islington","18:00:00","2019-09-30",72,17,0,7,0,96
"Kingston upon Thames","18:00:00","2019-09-30",55,0,0,10,0,65
"Lambeth","18:00:00","2019-09-30",195,4,0,31,0,230
"Lewisham","18:00:00","2019-09-30",31,2,0,1,0,34
"Newham","18:00:00","2019-09-30",719,11,17,73,2,822
"Southwark","18:00:00","2019-09-30",156,6,0,13,0,175
"Brent","07:00:00","2019-10-01",22,0,0,2,1,25
"Hillingdon","07:00:00","2019-10-01",481,5,6,98,15,605
"Hounslow","07:00:00","2019-10-01",186,2,0,28,1,217
"Lewisham","07:00:00","2019-10-01",31,0,0,5,0,36
"Merton","07:00:00","2019-10-01",262,5,0,48,1,316
"Newham","07:00:00","2019-10-01",43,0,16,15,0,74
"Tower Hamlets","07:00:00","2019-10-01",413,13,49,118,14,607
"Waltham Forest","07:00:00","2019-10-01",526,9,21,100,4,660
"Brent","08:00:00","2019-10-01",68,0,0,8,0,76
"Hillingdon","08:00:00","2019-10-01",278,5,3,79,13,378
"Hounslow","08:00:00","2019-10-01",236,5,0,27,1,269
"Lewisham","08:00:00","2019-10-01",48,0,1,4,0,53
"Merton","08:00:00","2019-10-01",288,7,0,37,3,335
"Newham","08:00:00","2019-10-01",102,1,13,17,1,134
"Tower Hamlets","08:00:00","2019-10-01",606,22,49,117,24,818
"Waltham Forest","08:00:00","2019-10-01",627,4,23,83,9,746
"Brent","09:00:00","2019-10-01",24,0,0,5,0,29
"Hillingdon","09:00:00","2019-10-01",201,4,7,101,18,331
"Hounslow","09:00:00","2019-10-01",96,2,0,14,2,114
"Lewisham","09:00:00","2019-10-01",31,0,2,6,2,41
"Merton","09:00:00","2019-10-01",245,6,0,43,0,294
"Newham","09:00:00","2019-10-01",55,0,13,21,1,90
"Tower Hamlets","09:00:00","2019-10-01",446,14,70,149,21,700
"Waltham Forest","09:00:00","2019-10-01",482,4,22,106,13,627
"Brent","10:00:00","2019-10-01",27,0,0,4,0,31
"Hillingdon","10:00:00","2019-10-01",131,1,6,89,8,235
"Hounslow","10:00:00","2019-10-01",80,3,0,14,5,102
"Lewisham","10:00:00","2019-10-01",12,1,0,10,1,24
"Merton","10:00:00","2019-10-01",157,8,0,37,0,202
"Newham","10:00:00","2019-10-01",37,1,13,18,1,70
"Tower Hamlets","10:00:00","2019-10-01",400,19,61,130,17,627
"Waltham Forest","10:00:00","2019-10-01",422,5,23,85,9,544
"Brent","11:00:00","2019-10-01",26,0,0,2,1,29
"Hillingdon","11:00:00","2019-10-01",141,0,10,103,16,270
"Hounslow","11:00:00","2019-10-01",73,3,0,10,9,95
"Lewisham","11:00:00","2019-10-01",22,2,0,9,0,33
"Merton","11:00:00","2019-10-01",125,3,0,37,3,168
"Newham","11:00:00","2019-10-01",44,0,14,18,0,76
"Tower Hamlets","11:00:00","2019-10-01",518,31,59,167,20,795
"Waltham Forest","11:00:00","2019-10-01",404,3,22,87,9,525
"Brent","12:00:00","2019-10-01",27,0,0,2,0,29
"Hillingdon","12:00:00","2019-10-01",189,1,8,88,14,300
"Hounslow","12:00:00","2019-10-01",70,5,0,16,4,95
"Lewisham","12:00:00","2019-10-01",18,2,0,6,1,27
"Merton","12:00:00","2019-10-01",151,21,0,31,5,208
"Newham","12:00:00","2019-10-01",44,0,12,8,1,65
"Tower Hamlets","12:00:00","2019-10-01",482,27,50,162,16,737
"Waltham Forest","12:00:00","2019-10-01",385,4,22,97,3,511
"Brent","13:00:00","2019-10-01",26,0,0,1,0,27
"Hillingdon","13:00:00","2019-10-01",287,3,11,88,16,405
"Hounslow","13:00:00","2019-10-01",93,9,0,13,0,115
"Lewisham","13:00:00","2019-10-01",24,1,0,5,1,31
"Merton","13:00:00","2019-10-01",118,11,0,39,0,168
"Newham","13:00:00","2019-10-01",48,1,13,18,0,80
"Tower Hamlets","13:00:00","2019-10-01",535,28,44,134,15,756
"Waltham Forest","13:00:00","2019-10-01",402,10,19,100,3,534
"Brent","14:00:00","2019-10-01",21,0,0,1,0,22
"Hillingdon","14:00:00","2019-10-01",293,3,10,92,18,416
"Hounslow","14:00:00","2019-10-01",96,4,0,18,1,119
"Lewisham","14:00:00","2019-10-01",27,1,0,9,1,38
"Merton","14:00:00","2019-10-01",148,11,1,37,3,200
"Newham","14:00:00","2019-10-01",38,1,12,9,0,60
"Tower Hamlets","14:00:00","2019-10-01",565,46,70,146,17,844
"Waltham Forest","14:00:00","2019-10-01",438,5,26,83,7,559
"Brent","15:00:00","2019-10-01",48,2,0,4,1,55
"Hillingdon","15:00:00","2019-10-01",377,3,10,92,13,495
"Hounslow","15:00:00","2019-10-01",120,7,0,16,2,145
"Lewisham","15:00:00","2019-10-01",46,2,2,4,0,54
"Merton","15:00:00","2019-10-01",221,4,0,38,1,264
"Newham","15:00:00","2019-10-01",74,1,13,26,1,115
"Tower Hamlets","15:00:00","2019-10-01",601,37,57,135,17,847
"Waltham Forest","15:00:00","2019-10-01",541,7,30,95,5,678
"Brent","16:00:00","2019-10-01",55,0,0,6,2,63
"Hillingdon","16:00:00","2019-10-01",351,14,8,52,14,439
"Hounslow","16:00:00","2019-10-01",148,2,0,20,0,170
"Lewisham","16:00:00","2019-10-01",24,2,2,9,0,37
"Merton","16:00:00","2019-10-01",246,12,0,33,0,291
"Newham","16:00:00","2019-10-01",63,2,12,19,0,96
"Tower Hamlets","16:00:00","2019-10-01",695,34,53,130,12,924
"Waltham Forest","16:00:00","2019-10-01",545,8,26,73,1,653
"Brent","17:00:00","2019-10-01",40,0,0,2,2,44
"Hillingdon","17:00:00","2019-10-01",352,4,3,46,8,413
"Hounslow","17:00:00","2019-10-01",152,2,0,14,1,169
"Lewisham","17:00:00","2019-10-01",30,1,0,3,0,34
"Merton","17:00:00","2019-10-01",315,19,0,35,1,370
"Newham","17:00:00","2019-10-01",53,0,12,16,0,81
"Tower Hamlets","17:00:00","2019-10-01",738,39,63,95,5,940
"Waltham Forest","17:00:00","2019-10-01",645,9,20,85,1,760
"Brent","18:00:00","2019-10-01",37,3,0,4,0,44
"Hillingdon","18:00:00","2019-10-01",280,9,11,40,1,341
"Hounslow","18:00:00","2019-10-01",157,4,0,10,3,174
"Lewisham","18:00:00","2019-10-01",39,4,0,4,0,47
"Merton","18:00:00","2019-10-01",285,22,0,18,0,325
"Newham","18:00:00","2019-10-01",45,0,11,14,0,70
"Tower Hamlets","18:00:00","2019-10-01",806,42,55,70,4,977
"Waltham Forest","18:00:00","2019-10-01",528,7,27,69,1,632
"Bromley","07:00:00","2019-10-02",73,0,0,10,0,83
"Ealing","07:00:00","2019-10-02",10,0,0,1,0,11
"Havering","07:00:00","2019-10-02",2545,107,35,682,88,3457
"Islington","07:00:00","2019-10-02",333,19,43,114,43,552
"Kingston upon Thames","07:00:00","2019-10-02",35,0,2,8,2,47
"Sutton","07:00:00","2019-10-02",875,13,8,211,27,1134
"Tower Hamlets","07:00:00","2019-10-02",362,23,8,193,21,607
"Wandsworth","07:00:00","2019-10-02",39,1,0,8,0,48
"Bromley","08:00:00","2019-10-02",99,0,0,13,0,112
"Ealing","08:00:00","2019-10-02",13,0,0,2,1,16
"Havering","08:00:00","2019-10-02",3004,109,26,600,95,3834
"Islington","08:00:00","2019-10-02",353,21,51,158,44,627
"Kingston upon Thames","08:00:00","2019-10-02",38,4,5,14,1,62
"Sutton","08:00:00","2019-10-02",1108,14,11,192,22,1347
"Tower Hamlets","08:00:00","2019-10-02",481,24,10,209,18,742
"Wandsworth","08:00:00","2019-10-02",47,3,0,7,0,57
"Bromley","09:00:00","2019-10-02",56,0,0,6,1,63
"Ealing","09:00:00","2019-10-02",4,0,0,4,0,8
"Havering","09:00:00","2019-10-02",2376,69,27,469,98,3039
"Islington","09:00:00","2019-10-02",311,26,34,168,52,591
"Kingston upon Thames","09:00:00","2019-10-02",46,3,7,9,3,68
"Sutton","09:00:00","2019-10-02",787,7,13,200,28,1035
"Tower Hamlets","09:00:00","2019-10-02",477,11,11,175,12,686
"Wandsworth","09:00:00","2019-10-02",45,0,0,8,0,53
"Bromley","10:00:00","2019-10-02",70,0,0,14,2,86
"Ealing","10:00:00","2019-10-02",11,0,0,3,0,14
"Havering","10:00:00","2019-10-02",2195,30,33,544,134,2936
"Islington","10:00:00","2019-10-02",328,26,50,154,64,622
"Kingston upon Thames","10:00:00","2019-10-02",31,1,4,8,4,48
"Sutton","10:00:00","2019-10-02",665,11,9,149,23,857
"Tower Hamlets","10:00:00","2019-10-02",503,17,10,226,15,771
"Wandsworth","10:00:00","2019-10-02",45,0,0,5,0,50
"Bromley","11:00:00","2019-10-02",58,0,0,12,0,70
"Ealing","11:00:00","2019-10-02",7,0,0,5,0,12
"Havering","11:00:00","2019-10-02",2175,28,26,533,122,2884
"Islington","11:00:00","2019-10-02",367,24,50,176,48,665
"Kingston upon Thames","11:00:00","2019-10-02",23,3,6,9,2,43
"Sutton","11:00:00","2019-10-02",803,17,9,174,48,1051
"Tower Hamlets","11:00:00","2019-10-02",479,19,10,175,16,699
"Wandsworth","11:00:00","2019-10-02",29,2,0,8,1,40
"Bromley","12:00:00","2019-10-02",63,2,0,14,0,79
"Ealing","12:00:00","2019-10-02",13,0,0,7,0,20
"Havering","12:00:00","2019-10-02",2292,40,25,522,85,2964
"Islington","12:00:00","2019-10-02",294,33,37,166,37,567
"Kingston upon Thames","12:00:00","2019-10-02",34,5,4,19,1,63
"Sutton","12:00:00","2019-10-02",786,11,6,164,42,1009
"Tower Hamlets","12:00:00","2019-10-02",473,18,8,163,14,676
"Wandsworth","12:00:00","2019-10-02",32,1,0,7,1,41
"Bromley","13:00:00","2019-10-02",59,0,0,10,1,70
"Ealing","13:00:00","2019-10-02",13,0,0,6,0,19
"Havering","13:00:00","2019-10-02",2485,32,30,506,104,3157
"Islington","13:00:00","2019-10-02",379,52,47,121,37,636
"Kingston upon Thames","13:00:00","2019-10-02",39,6,4,8,0,57
"Sutton","13:00:00","2019-10-02",761,21,11,180,34,1007
"Tower Hamlets","13:00:00","2019-10-02",473,16,9,159,12,669
"Wandsworth","13:00:00","2019-10-02",31,1,0,7,1,40
"Bromley","14:00:00","2019-10-02",55,0,0,7,1,63
"Ealing","14:00:00","2019-10-02",11,0,0,2,0,13
"Havering","14:00:00","2019-10-02",2467,33,23,551,113,3187
"Islington","14:00:00","2019-10-02",395,60,50,169,51,725
"Kingston upon Thames","14:00:00","2019-10-02",38,5,5,16,3,67
"Sutton","14:00:00","2019-10-02",779,10,8,182,26,1005
"Tower Hamlets","14:00:00","2019-10-02",531,17,7,171,16,742
"Wandsworth","14:00:00","2019-10-02",25,1,0,8,0,34
"Bromley","15:00:00","2019-10-02",70,2,0,7,0,79
"Ealing","15:00:00","2019-10-02",10,0,0,1,0,11
"Havering","15:00:00","2019-10-02",2768,33,23,550,91,3465
"Islington","15:00:00","2019-10-02",389,48,40,188,31,696
"Kingston upon Thames","15:00:00","2019-10-02",50,11,6,8,0,75
"Sutton","15:00:00","2019-10-02",990,14,7,174,33,1218
"Tower Hamlets","15:00:00","2019-10-02",527,15,9,149,11,711
"Wandsworth","15:00:00","2019-10-02",30,2,0,10,0,42
"Bromley","16:00:00","2019-10-02",69,0,0,12,0,81
"Ealing","16:00:00","2019-10-02",9,0,0,3,0,12
"Havering","16:00:00","2019-10-02",2941,47,32,565,89,3674
"Islington","16:00:00","2019-10-02",462,104,46,181,43,836
"Kingston upon Thames","16:00:00","2019-10-02",39,6,5,7,0,57
"Sutton","16:00:00","2019-10-02",935,17,9,186,34,1181
"Tower Hamlets","16:00:00","2019-10-02",603,24,10,162,13,812
"Wandsworth","16:00:00","2019-10-02",48,3,0,6,4,61
"Bromley","17:00:00","2019-10-02",55,2,0,15,0,72
"Ealing","17:00:00","2019-10-02",19,0,0,4,0,23
"Havering","17:00:00","2019-10-02",3015,94,25,484,73,3691
"Islington","17:00:00","2019-10-02",488,111,48,139,28,814
"Kingston upon Thames","17:00:00","2019-10-02",72,5,2,1,4,84
"Sutton","17:00:00","2019-10-02",1116,27,9,173,8,1333
"Tower Hamlets","17:00:00","2019-10-02",614,33,6,129,5,787
"Wandsworth","17:00:00","2019-10-02",59,4,0,8,0,71
"Bromley","18:00:00","2019-10-02",57,1,0,7,0,65
"Ealing","18:00:00","2019-10-02",8,0,0,2,0,10
"Havering","18:00:00","2019-10-02",2906,104,24,430,61,3525
"Islington","18:00:00","2019-10-02",434,132,49,107,32,754
"Kingston upon Thames","18:00:00","2019-10-02",71,9,4,4,1,89
"Sutton","18:00:00","2019-10-02",1081,24,9,144,5,1263
"Tower Hamlets","18:00:00","2019-10-02",667,24,9,71,5,776
"Wandsworth","18:00:00","2019-10-02",51,1,0,3,0,55
"Bexley","07:00:00","2019-10-03",498,7,38,115,7,665
"Bromley","07:00:00","2019-10-03",683,11,7,149,11,861
"City of London","07:00:00","2019-10-03",245,45,57,137,28,512
"Croydon","07:00:00","2019-10-03",97,0,2,12,3,114
"Enfield","07:00:00","2019-10-03",1554,12,13,491,56,2126
"Hammersmith and Fulham","07:00:00","2019-10-03",367,15,64,109,9,564
"Havering","07:00:00","2019-10-03",603,4,6,156,9,778
"Hounslow","07:00:00","2019-10-03",57,0,2,8,3,70
"Kensington and Chelsea","07:00:00","2019-10-03",59,3,24,19,7,112
"Richmond upon Thames","07:00:00","2019-10-03",88,1,0,12,0,101
"Sutton","07:00:00","2019-10-03",22,0,0,4,0,26
"Wandsworth","07:00:00","2019-10-03",42,0,0,11,0,53
"Bexley","08:00:00","2019-10-03",776,9,48,101,7,941
"Bromley","08:00:00","2019-10-03",743,10,5,131,17,906
"City of London","08:00:00","2019-10-03",323,50,64,135,22,594
"Croydon","08:00:00","2019-10-03",158,2,0,11,4,175
"Enfield","08:00:00","2019-10-03",1143,7,21,229,30,1430
"Hammersmith and Fulham","08:00:00","2019-10-03",491,20,72,117,8,708
"Havering","08:00:00","2019-10-03",839,3,2,104,13,961
"Hounslow","08:00:00","2019-10-03",138,0,2,14,2,156
"Kensington and Chelsea","08:00:00","2019-10-03",108,4,24,23,5,164
"Richmond upon Thames","08:00:00","2019-10-03",138,0,0,13,2,153
"Sutton","08:00:00","2019-10-03",21,0,0,2,0,23
"Wandsworth","08:00:00","2019-10-03",68,4,0,14,0,86
"Bexley","09:00:00","2019-10-03",468,11,48,85,16,628
"Bromley","09:00:00","2019-10-03",664,6,7,157,19,853
"City of London","09:00:00","2019-10-03",342,39,61,169,31,642
"Croydon","09:00:00","2019-10-03",101,1,0,14,4,120
"Enfield","09:00:00","2019-10-03",1155,7,17,277,46,1502
"Hammersmith and Fulham","09:00:00","2019-10-03",422,19,83,109,11,644
"Havering","09:00:00","2019-10-03",663,5,6,141,16,831
"Hounslow","09:00:00","2019-10-03",72,0,3,17,3,95
"Kensington and Chelsea","09:00:00","2019-10-03",106,5,25,24,17,177
"Richmond upon Thames","09:00:00","2019-10-03",72,1,0,15,4,92
"Sutton","09:00:00","2019-10-03",18,0,0,0,0,18
"Wandsworth","09:00:00","2019-10-03",64,1,0,11,2,78
"Bexley","10:00:00","2019-10-03",524,13,47,88,12,684
"Bromley","10:00:00","2019-10-03",565,2,7,130,19,723
"City of London","10:00:00","2019-10-03",341,34,63,162,25,625
"Croydon","10:00:00","2019-10-03",72,0,0,23,1,96
"Enfield","10:00:00","2019-10-03",1000,10,24,215,28,1277
"Hammersmith and Fulham","10:00:00","2019-10-03",412,30,80,116,12,650
"Havering","10:00:00","2019-10-03",631,1,2,94,14,742
"Hounslow","10:00:00","2019-10-03",60,0,2,15,2,79
"Kensington and Chelsea","10:00:00","2019-10-03",88,8,30,29,5,160
"Richmond upon Thames","10:00:00","2019-10-03",41,0,0,7,3,51
"Sutton","10:00:00","2019-10-03",19,0,0,11,0,30
"Wandsworth","10:00:00","2019-10-03",43,3,0,21,2,69
"Bexley","11:00:00","2019-10-03",578,10,47,97,8,740
"Bromley","11:00:00","2019-10-03",531,5,6,149,21,712
"City of London","11:00:00","2019-10-03",298,40,64,162,31,595
"Croydon","11:00:00","2019-10-03",99,0,0,20,2,121
"Enfield","11:00:00","2019-10-03",963,6,20,223,43,1255
"Hammersmith and Fulham","11:00:00","2019-10-03",432,23,66,146,11,678
"Havering","11:00:00","2019-10-03",610,3,3,105,12,733
"Hounslow","11:00:00","2019-10-03",55,0,1,11,5,72
"Kensington and Chelsea","11:00:00","2019-10-03",76,6,31,42,2,157
"Richmond upon Thames","11:00:00","2019-10-03",77,0,0,10,0,87
"Sutton","11:00:00","2019-10-03",16,0,0,0,1,17
"Wandsworth","11:00:00","2019-10-03",47,1,0,17,0,65
"Bexley","12:00:00","2019-10-03",531,9,44,78,4,666
"Bromley","12:00:00","2019-10-03",543,4,8,128,20,703
"City of London","12:00:00","2019-10-03",316,46,65,159,29,615
"Croydon","12:00:00","2019-10-03",105,0,0,17,2,124
"Enfield","12:00:00","2019-10-03",771,8,20,206,35,1040
"Hammersmith and Fulham","12:00:00","2019-10-03",414,45,70,136,12,677
"Havering","12:00:00","2019-10-03",650,6,2,102,12,772
"Hounslow","12:00:00","2019-10-03",47,0,2,14,2,65
"Kensington and Chelsea","12:00:00","2019-10-03",90,10,29,24,5,158
"Richmond upon Thames","12:00:00","2019-10-03",51,1,0,21,2,75
"Sutton","12:00:00","2019-10-03",21,2,0,2,0,25
"Wandsworth","12:00:00","2019-10-03",47,3,0,14,3,67
"Bexley","13:00:00","2019-10-03",556,13,52,89,4,714
"Bromley","13:00:00","2019-10-03",528,2,7,120,14,671
"City of London","13:00:00","2019-10-03",323,62,57,124,28,594
"Croydon","13:00:00","2019-10-03",100,3,0,15,4,122
"Enfield","13:00:00","2019-10-03",799,7,21,221,42,1090
"Hammersmith and Fulham","13:00:00","2019-10-03",433,25,75,159,11,703
"Havering","13:00:00","2019-10-03",648,3,3,103,16,773
"Hounslow","13:00:00","2019-10-03",75,2,2,16,4,99
"Kensington and Chelsea","13:00:00","2019-10-03",87,12,30,42,2,173
"Richmond upon Thames","13:00:00","2019-10-03",55,2,0,14,2,73
"Sutton","13:00:00","2019-10-03",13,0,0,1,0,14
"Wandsworth","13:00:00","2019-10-03",41,4,0,18,3,66
"Bexley","14:00:00","2019-10-03",577,10,44,77,4,712
"Bromley","14:00:00","2019-10-03",645,5,6,120,18,794
"City of London","14:00:00","2019-10-03",344,29,53,129,29,584
"Croydon","14:00:00","2019-10-03",107,1,1,20,4,133
"Enfield","14:00:00","2019-10-03",1031,9,21,252,38,1351
"Hammersmith and Fulham","14:00:00","2019-10-03",479,27,67,172,13,758
"Havering","14:00:00","2019-10-03",702,3,3,125,21,854
"Hounslow","14:00:00","2019-10-03",63,3,1,24,0,91
"Kensington and Chelsea","14:00:00","2019-10-03",96,15,31,24,1,167
"Richmond upon Thames","14:00:00","2019-10-03",72,2,0,10,0,84
"Sutton","14:00:00","2019-10-03",19,0,0,7,0,26
"Wandsworth","14:00:00","2019-10-03",50,4,0,17,0,71
"Bexley","15:00:00","2019-10-03",572,18,48,90,6,734
"Bromley","15:00:00","2019-10-03",727,3,8,123,6,867
"City of London","15:00:00","2019-10-03",359,30,65,140,30,624
"Croydon","15:00:00","2019-10-03",176,1,1,12,2,192
"Enfield","15:00:00","2019-10-03",985,11,12,236,38,1282
"Hammersmith and Fulham","15:00:00","2019-10-03",544,29,64,188,11,836
"Havering","15:00:00","2019-10-03",849,8,6,132,8,1003
"Hounslow","15:00:00","2019-10-03",119,1,2,20,0,142
"Kensington and Chelsea","15:00:00","2019-10-03",115,10,30,23,4,182
"Richmond upon Thames","15:00:00","2019-10-03",95,1,0,17,4,117
"Sutton","15:00:00","2019-10-03",19,0,0,9,0,28
"Wandsworth","15:00:00","2019-10-03",64,2,0,13,2,81
"Bexley","16:00:00","2019-10-03",563,13,44,95,3,718
"Bromley","16:00:00","2019-10-03",753,12,6,118,10,899
"City of London","16:00:00","2019-10-03",391,36,69,136,16,648
"Croydon","16:00:00","2019-10-03",143,6,1,19,0,169
"Enfield","16:00:00","2019-10-03",1260,10,18,274,36,1598
"Hammersmith and Fulham","16:00:00","2019-10-03",534,40,65,189,11,839
"Havering","16:00:00","2019-10-03",760,9,3,116,1,889
"Hounslow","16:00:00","2019-10-03",110,4,2,21,1,138
"Kensington and Chelsea","16:00:00","2019-10-03",110,9,33,20,4,176
"Richmond upon Thames","16:00:00","2019-10-03",161,2,0,19,5,187
"Sutton","16:00:00","2019-10-03",21,0,0,0,0,21
"Wandsworth","16:00:00","2019-10-03",96,2,0,14,0,112
"Bexley","17:00:00","2019-10-03",615,13,46,68,1,743
"Bromley","17:00:00","2019-10-03",759,10,6,91,0,866
"City of London","17:00:00","2019-10-03",354,41,55,93,13,556
"Croydon","17:00:00","2019-10-03",158,6,0,18,1,183
"Enfield","17:00:00","2019-10-03",1316,9,18,205,16,1564
"Hammersmith and Fulham","17:00:00","2019-10-03",525,63,65,126,7,786
"Havering","17:00:00","2019-10-03",885,5,2,141,2,1035
"Hounslow","17:00:00","2019-10-03",102,0,2,21,0,125
"Kensington and Chelsea","17:00:00","2019-10-03",104,16,26,19,2,167
"Richmond upon Thames","17:00:00","2019-10-03",179,1,0,14,0,194
"Sutton","17:00:00","2019-10-03",38,0,0,4,0,42
"Wandsworth","17:00:00","2019-10-03",96,4,0,10,1,111
"Bexley","18:00:00","2019-10-03",579,9,46,60,1,695
"Bromley","18:00:00","2019-10-03",730,12,7,61,3,813
"City of London","18:00:00","2019-10-03",344,50,62,98,15,569
"Croydon","18:00:00","2019-10-03",135,8,0,13,1,157
"Enfield","18:00:00","2019-10-03",1210,6,16,152,10,1394
"Hammersmith and Fulham","18:00:00","2019-10-03",537,43,72,85,1,738
"Havering","18:00:00","2019-10-03",835,14,2,77,8,936
"Hounslow","18:00:00","2019-10-03",107,1,1,9,0,118
"Kensington and Chelsea","18:00:00","2019-10-03",107,12,29,10,0,158
"Richmond upon Thames","18:00:00","2019-10-03",167,1,0,10,0,178
"Sutton","18:00:00","2019-10-03",29,0,0,2,0,31
"Wandsworth","18:00:00","2019-10-03",63,16,0,5,0,84
"Barnet","07:00:00","2019-10-04",634,3,10,161,19,827
"Camden","07:00:00","2019-10-04",50,14,0,48,15,127
"Harrow","07:00:00","2019-10-04",217,0,13,21,1,252
"Hillingdon","07:00:00","2019-10-04",68,2,0,6,0,76
"Hounslow","07:00:00","2019-10-04",8,0,0,2,0,10
"Lambeth","07:00:00","2019-10-04",16,0,0,9,0,25
"Newham","07:00:00","2019-10-04",30,2,0,13,12,57
"Redbridge","07:00:00","2019-10-04",20,0,0,3,0,23
"Barnet","08:00:00","2019-10-04",716,3,10,124,29,882
"Camden","08:00:00","2019-10-04",66,19,1,63,12,161
"Harrow","08:00:00","2019-10-04",385,0,10,28,3,426
"Hillingdon","08:00:00","2019-10-04",151,0,0,13,0,164
"Hounslow","08:00:00","2019-10-04",7,0,0,1,0,8
"Lambeth","08:00:00","2019-10-04",24,2,0,5,0,31
"Newham","08:00:00","2019-10-04",33,0,0,10,5,48
"Redbridge","08:00:00","2019-10-04",39,0,0,3,0,42
"Barnet","09:00:00","2019-10-04",542,5,6,118,28,699
"Bexley","09:00:00","2019-10-04",3882,88,43,1110,498,5621
"Camden","09:00:00","2019-10-04",106,28,0,65,8,207
"Harrow","09:00:00","2019-10-04",221,0,11,28,0,260
"Hillingdon","09:00:00","2019-10-04",81,1,0,8,0,90
"Hounslow","09:00:00","2019-10-04",4,0,0,1,0,5
"Lambeth","09:00:00","2019-10-04",35,1,0,6,0,42
"Newham","09:00:00","2019-10-04",33,3,0,25,7,68
"Redbridge","09:00:00","2019-10-04",23,0,0,2,0,25
"Barnet","10:00:00","2019-10-04",480,9,7,90,30,616
"Bexley","10:00:00","2019-10-04",3486,35,28,1039,455,5043
"Camden","10:00:00","2019-10-04",99,18,0,66,12,195
"Harrow","10:00:00","2019-10-04",148,4,12,20,2,186
"Hillingdon","10:00:00","2019-10-04",56,0,0,4,0,60
"Hounslow","10:00:00","2019-10-04",5,0,0,2,0,7
"Lambeth","10:00:00","2019-10-04",19,0,0,4,1,24
"Newham","10:00:00","2019-10-04",40,2,0,26,5,73
"Redbridge","10:00:00","2019-10-04",14,0,0,3,1,18
"Barnet","11:00:00","2019-10-04",376,5,5,93,27,506
"Bexley","11:00:00","2019-10-04",3544,24,18,1070,449,5105
"Camden","11:00:00","2019-10-04",99,23,0,83,9,214
"Harrow","11:00:00","2019-10-04",159,0,12,32,2,205
"Hillingdon","11:00:00","2019-10-04",72,2,0,9,0,83
"Hounslow","11:00:00","2019-10-04",6,0,0,2,0,8
"Lambeth","11:00:00","2019-10-04",29,0,0,6,0,35
"Newham","11:00:00","2019-10-04",30,9,0,27,8,74
"Redbridge","11:00:00","2019-10-04",15,0,0,1,0,16
"Barnet","12:00:00","2019-10-04",464,3,4,87,17,575
"Bexley","12:00:00","2019-10-04",3648,46,18,1202,478,5392
"Camden","12:00:00","2019-10-04",106,27,0,61,3,197
"Harrow","12:00:00","2019-10-04",175,0,12,22,0,209
"Hillingdon","12:00:00","2019-10-04",52,0,0,13,0,65
"Hounslow","12:00:00","2019-10-04",5,0,0,1,0,6
"Lambeth","12:00:00","2019-10-04",38,0,0,6,0,44
"Newham","12:00:00","2019-10-04",31,3,0,21,9,64
"Redbridge","12:00:00","2019-10-04",16,0,0,2,0,18
"Barnet","13:00:00","2019-10-04",459,5,4,99,11,578
"Bexley","13:00:00","2019-10-04",4017,67,18,1250,458,5810
"Camden","13:00:00","2019-10-04",106,24,0,67,1,198
"Harrow","13:00:00","2019-10-04",171,0,12,22,0,205
"Hillingdon","13:00:00","2019-10-04",55,1,0,10,2,68
"Hounslow","13:00:00","2019-10-04",5,0,0,4,0,9
"Lambeth","13:00:00","2019-10-04",38,0,0,5,0,43
"Newham","13:00:00","2019-10-04",41,4,0,20,7,72
"Redbridge","13:00:00","2019-10-04",22,0,0,2,0,24
"Barnet","14:00:00","2019-10-04",537,2,7,108,20,674
"Bexley","14:00:00","2019-10-04",4433,76,23,1469,442,6443
"Camden","14:00:00","2019-10-04",122,25,0,56,6,209
"Harrow","14:00:00","2019-10-04",230,1,12,24,1,268
"Hillingdon","14:00:00","2019-10-04",71,0,0,8,0,79
"Hounslow","14:00:00","2019-10-04",7,0,0,0,0,7
"Lambeth","14:00:00","2019-10-04",37,1,0,4,0,42
"Newham","14:00:00","2019-10-04",43,7,0,26,6,82
"Redbridge","14:00:00","2019-10-04",26,0,0,4,0,30
"Barnet","15:00:00","2019-10-04",655,1,10,120,18,804
"Camden","15:00:00","2019-10-04",117,24,1,49,2,193
"Harrow","15:00:00","2019-10-04",307,0,12,29,0,348
"Hillingdon","15:00:00","2019-10-04",82,2,0,9,0,93
"Hounslow","15:00:00","2019-10-04",8,0,0,2,0,10
"Lambeth","15:00:00","2019-10-04",30,1,0,9,0,40
"Newham","15:00:00","2019-10-04",38,3,0,14,14,69
"Redbridge","15:00:00","2019-10-04",37,2,0,4,0,43
"Barnet","16:00:00","2019-10-04",614,2,10,84,10,720
"Camden","16:00:00","2019-10-04",106,18,0,44,4,172
"Harrow","16:00:00","2019-10-04",264,0,13,26,0,303
"Hillingdon","16:00:00","2019-10-04",80,2,0,11,0,93
"Hounslow","16:00:00","2019-10-04",6,0,0,0,1,7
"Lambeth","16:00:00","2019-10-04",36,1,0,10,0,47
"Newham","16:00:00","2019-10-04",50,3,0,23,9,85
"Redbridge","16:00:00","2019-10-04",21,0,0,3,0,24
"Barnet","17:00:00","2019-10-04",686,2,10,94,11,803
"Camden","17:00:00","2019-10-04",120,25,0,25,1,171
"Harrow","17:00:00","2019-10-04",216,1,13,21,2,253
"Hillingdon","17:00:00","2019-10-04",74,1,0,6,0,81
"Hounslow","17:00:00","2019-10-04",10,0,0,3,0,13
"Lambeth","17:00:00","2019-10-04",39,0,0,8,0,47
"Newham","17:00:00","2019-10-04",46,2,0,17,3,68
"Redbridge","17:00:00","2019-10-04",21,0,0,0,0,21
"Barnet","18:00:00","2019-10-04",638,5,6,63,5,717
"Camden","18:00:00","2019-10-04",108,23,0,29,1,161
"Harrow","18:00:00","2019-10-04",223,4,12,12,0,251
"Hillingdon","18:00:00","2019-10-04",107,5,0,8,0,120
"Hounslow","18:00:00","2019-10-04",7,1,0,1,0,9
"Lambeth","18:00:00","2019-10-04",35,1,0,7,0,43
"Newham","18:00:00","2019-10-04",26,2,0,7,0,35
"Redbridge","18:00:00","2019-10-04",24,0,0,1,0,25
"Bromley","07:00:00","2019-10-07",158,0,0,37,0,195
"Croydon","07:00:00","2019-10-07",107,5,0,21,2,135
"Greenwich","07:00:00","2019-10-07",236,2,18,41,3,300
"Hammersmith and Fulham","07:00:00","2019-10-07",22,0,0,4,0,26
"Harrow","07:00:00","2019-10-07",14,0,0,4,2,20
"Hillingdon","07:00:00","2019-10-07",303,3,4,53,4,367
"Lambeth","07:00:00","2019-10-07",670,21,22,163,10,886
"Richmond upon Thames","07:00:00","2019-10-07",662,28,23,149,8,870
"Sutton","07:00:00","2019-10-07",259,0,0,40,3,302
"Wandsworth","07:00:00","2019-10-07",51,1,0,10,1,63
"Bromley","08:00:00","2019-10-07",190,2,0,36,1,229
"Croydon","08:00:00","2019-10-07",164,1,0,24,2,191
"Greenwich","08:00:00","2019-10-07",329,2,14,40,2,387
"Hammersmith and Fulham","08:00:00","2019-10-07",41,1,0,7,5,54
"Harrow","08:00:00","2019-10-07",18,0,0,3,0,21
"Hillingdon","08:00:00","2019-10-07",527,0,4,31,3,565
"Lambeth","08:00:00","2019-10-07",622,28,21,132,18,821
"Richmond upon Thames","08:00:00","2019-10-07",699,29,23,117,7,875
"Sutton","08:00:00","2019-10-07",477,4,0,52,1,534
"Wandsworth","08:00:00","2019-10-07",54,1,0,6,1,62
"Bromley","09:00:00","2019-10-07",89,0,0,24,2,115
"Croydon","09:00:00","2019-10-07",123,1,0,21,1,146
"Greenwich","09:00:00","2019-10-07",269,2,13,46,2,332
"Hammersmith and Fulham","09:00:00","2019-10-07",27,1,0,8,0,36
"Harrow","09:00:00","2019-10-07",7,0,0,2,0,9
"Hillingdon","09:00:00","2019-10-07",190,1,5,24,3,223
"Lambeth","09:00:00","2019-10-07",629,18,23,171,16,857
"Richmond upon Thames","09:00:00","2019-10-07",518,15,22,139,10,704
"Sutton","09:00:00","2019-10-07",177,1,2,29,4,213
"Wandsworth","09:00:00","2019-10-07",37,0,0,8,0,45
"Bromley","10:00:00","2019-10-07",71,1,0,12,0,84
"Croydon","10:00:00","2019-10-07",92,0,0,19,0,111
"Greenwich","10:00:00","2019-10-07",225,1,15,43,3,287
"Hammersmith and Fulham","10:00:00","2019-10-07",25,1,0,5,2,33
"Harrow","10:00:00","2019-10-07",10,0,0,3,0,13
"Hillingdon","10:00:00","2019-10-07",144,0,5,21,7,177
"Lambeth","10:00:00","2019-10-07",560,20,21,162,22,785
"Richmond upon Thames","10:00:00","2019-10-07",449,8,19,146,9,631
"Sutton","10:00:00","2019-10-07",127,0,0,29,2,158
"Wandsworth","10:00:00","2019-10-07",30,0,0,9,1,40
"Bromley","11:00:00","2019-10-07",80,1,0,11,0,92
"Croydon","11:00:00","2019-10-07",77,5,0,19,0,101
"Greenwich","11:00:00","2019-10-07",226,0,16,36,4,282
"Hammersmith and Fulham","11:00:00","2019-10-07",20,1,0,6,0,27
"Harrow","11:00:00","2019-10-07",6,0,0,6,0,12
"Hillingdon","11:00:00","2019-10-07",173,6,4,38,6,227
"Lambeth","11:00:00","2019-10-07",505,18,21,142,26,712
"Richmond upon Thames","11:00:00","2019-10-07",438,18,19,148,14,637
"Sutton","11:00:00","2019-10-07",128,0,0,23,1,152
"Wandsworth","11:00:00","2019-10-07",29,1,0,8,0,38
"Bromley","12:00:00","2019-10-07",63,3,0,13,0,79
"Croydon","12:00:00","2019-10-07",116,2,0,22,0,140
"Greenwich","12:00:00","2019-10-07",250,1,12,48,2,313
"Hammersmith and Fulham","12:00:00","2019-10-07",24,4,0,8,0,36
"Harrow","12:00:00","2019-10-07",10,0,0,1,1,12
"Hillingdon","12:00:00","2019-10-07",176,0,4,29,5,214
"Lambeth","12:00:00","2019-10-07",498,20,21,151,17,707
"Richmond upon Thames","12:00:00","2019-10-07",439,18,19,128,11,615
"Sutton","12:00:00","2019-10-07",150,0,0,23,4,177
"Wandsworth","12:00:00","2019-10-07",28,0,0,7,0,35
"Bromley","13:00:00","2019-10-07",56,2,0,13,0,71
"Croydon","13:00:00","2019-10-07",93,2,0,20,0,115
"Greenwich","13:00:00","2019-10-07",226,7,13,43,2,291
"Hammersmith and Fulham","13:00:00","2019-10-07",26,5,0,4,0,35
"Harrow","13:00:00","2019-10-07",9,0,0,5,0,14
"Hillingdon","13:00:00","2019-10-07",191,1,4,19,9,224
"Lambeth","13:00:00","2019-10-07",586,22,19,161,19,807
"Richmond upon Thames","13:00:00","2019-10-07",410,15,22,125,13,585
"Sutton","13:00:00","2019-10-07",137,2,0,18,2,159
"Wandsworth","13:00:00","2019-10-07",35,0,0,4,1,40
"Bromley","14:00:00","2019-10-07",66,0,0,19,1,86
"Croydon","14:00:00","2019-10-07",134,4,0,20,2,160
"Greenwich","14:00:00","2019-10-07",250,1,15,47,1,314
"Hammersmith and Fulham","14:00:00","2019-10-07",18,0,0,5,0,23
"Harrow","14:00:00","2019-10-07",10,0,0,1,0,11
"Hillingdon","14:00:00","2019-10-07",240,7,4,35,3,289
"Lambeth","14:00:00","2019-10-07",637,22,20,166,9,854
"Richmond upon Thames","14:00:00","2019-10-07",441,15,22,128,9,615
"Sutton","14:00:00","2019-10-07",170,1,1,33,0,205
"Wandsworth","14:00:00","2019-10-07",36,0,0,6,0,42
"Bromley","15:00:00","2019-10-07",112,1,0,17,0,130
"Croydon","15:00:00","2019-10-07",152,6,0,19,0,177
"Greenwich","15:00:00","2019-10-07",296,2,15,46,4,363
"Hammersmith and Fulham","15:00:00","2019-10-07",42,3,0,6,1,52
"Harrow","15:00:00","2019-10-07",10,0,0,7,0,17
"Hillingdon","15:00:00","2019-10-07",386,4,7,44,3,444
"Lambeth","15:00:00","2019-10-07",693,22,19,179,16,929
"Richmond upon Thames","15:00:00","2019-10-07",519,14,22,137,10,702
"Sutton","15:00:00","2019-10-07",272,0,0,40,2,314
"Wandsworth","15:00:00","2019-10-07",43,5,0,7,0,55
"Bromley","16:00:00","2019-10-07",102,3,0,24,1,130
"Croydon","16:00:00","2019-10-07",163,4,0,25,2,194
"Greenwich","16:00:00","2019-10-07",326,3,15,43,2,389
"Hammersmith and Fulham","16:00:00","2019-10-07",29,3,0,7,0,39
"Harrow","16:00:00","2019-10-07",13,0,0,2,0,15
"Hillingdon","16:00:00","2019-10-07",318,1,5,52,1,377
"Lambeth","16:00:00","2019-10-07",688,30,22,141,14,895
"Richmond upon Thames","16:00:00","2019-10-07",688,25,20,123,6,862
"Sutton","16:00:00","2019-10-07",234,0,0,31,1,266
"Wandsworth","16:00:00","2019-10-07",40,3,0,5,0,48
"Bromley","17:00:00","2019-10-07",117,1,0,22,0,140
"Croydon","17:00:00","2019-10-07",194,6,0,31,0,231
"Greenwich","17:00:00","2019-10-07",385,3,12,52,0,452
"Hammersmith and Fulham","17:00:00","2019-10-07",30,3,0,6,0,39
"Harrow","17:00:00","2019-10-07",17,3,0,1,0,21
"Hillingdon","17:00:00","2019-10-07",328,3,4,35,3,373
"Lambeth","17:00:00","2019-10-07",679,26,20,148,15,888
"Richmond upon Thames","17:00:00","2019-10-07",766,48,22,116,5,957
"Sutton","17:00:00","2019-10-07",306,3,0,31,0,340
"Wandsworth","17:00:00","2019-10-07",45,8,0,7,0,60
"Bromley","18:00:00","2019-10-07",92,2,0,10,0,104
"Croydon","18:00:00","2019-10-07",222,8,0,17,0,247
"Greenwich","18:00:00","2019-10-07",337,5,12,51,1,406
"Hammersmith and Fulham","18:00:00","2019-10-07",46,3,0,3,0,52
"Harrow","18:00:00","2019-10-07",12,0,0,3,0,15
"Hillingdon","18:00:00","2019-10-07",319,5,4,34,2,364
"Lambeth","18:00:00","2019-10-07",645,29,22,97,4,797
"Richmond upon Thames","18:00:00","2019-10-07",781,43,18,72,6,920
"Sutton","18:00:00","2019-10-07",241,0,0,20,0,261
"Wandsworth","18:00:00","2019-10-07",46,3,0,3,0,52
"Barnet","07:00:00","2019-10-08",1334,27,70,209,55,1695
"Brent","07:00:00","2019-10-08",813,15,34,173,7,1042
"Bromley","07:00:00","2019-10-08",419,9,0,96,3,527
"Croydon","07:00:00","2019-10-08",1206,27,12,275,28,1548
"Ealing","07:00:00","2019-10-08",19,1,0,8,0,28
"Hounslow","07:00:00","2019-10-08",205,6,0,53,0,264
"Lambeth","07:00:00","2019-10-08",388,19,15,123,9,554
"Newham","07:00:00","2019-10-08",380,3,14,62,10,469
"Richmond upon Thames","07:00:00","2019-10-08",25,0,0,2,0,27
"Tower Hamlets","07:00:00","2019-10-08",425,25,38,238,10,736
"Waltham Forest","07:00:00","2019-10-08",119,1,0,15,2,137
"Wandsworth","07:00:00","2019-10-08",32,0,0,9,0,41
"Barnet","08:00:00","2019-10-08",1271,16,68,171,54,1580
"Brent","08:00:00","2019-10-08",1163,9,28,114,13,1327
"Bromley","08:00:00","2019-10-08",464,2,0,55,6,527
"Croydon","08:00:00","2019-10-08",1320,32,8,224,35,1619
"Ealing","08:00:00","2019-10-08",25,1,0,5,0,31
"Hounslow","08:00:00","2019-10-08",389,5,0,51,2,447
"Lambeth","08:00:00","2019-10-08",540,16,11,110,7,684
"Newham","08:00:00","2019-10-08",592,3,15,71,14,695
"Richmond upon Thames","08:00:00","2019-10-08",42,0,0,2,0,44
"Tower Hamlets","08:00:00","2019-10-08",544,17,41,190,11,803
"Waltham Forest","08:00:00","2019-10-08",178,0,0,16,7,201
"Wandsworth","08:00:00","2019-10-08",58,1,0,6,0,65
"Barnet","09:00:00","2019-10-08",1159,21,77,191,61,1509
"Brent","09:00:00","2019-10-08",774,8,32,110,14,938
"Bromley","09:00:00","2019-10-08",256,7,0,39,2,304
"Croydon","09:00:00","2019-10-08",1159,33,13,271,40,1516
"Ealing","09:00:00","2019-10-08",26,0,0,8,1,35
"Hounslow","09:00:00","2019-10-08",307,5,0,68,0,380
"Lambeth","09:00:00","2019-10-08",433,27,14,104,5,583
"Newham","09:00:00","2019-10-08",397,2,17,103,19,538
"Richmond upon Thames","09:00:00","2019-10-08",36,0,0,2,0,38
"Tower Hamlets","09:00:00","2019-10-08",527,11,41,185,14,778
"Waltham Forest","09:00:00","2019-10-08",107,1,0,15,2,125
"Wandsworth","09:00:00","2019-10-08",47,1,0,13,0,61
"Barnet","10:00:00","2019-10-08",1148,27,73,199,45,1492
"Brent","10:00:00","2019-10-08",656,7,32,133,18,846
"Bromley","10:00:00","2019-10-08",205,4,0,40,2,251
"Croydon","10:00:00","2019-10-08",1020,37,13,251,47,1368
"Ealing","10:00:00","2019-10-08",15,0,0,5,0,20
"Hounslow","10:00:00","2019-10-08",202,4,0,38,0,244
"Lambeth","10:00:00","2019-10-08",294,18,8,90,12,422
"Newham","10:00:00","2019-10-08",387,2,15,87,8,499
"Richmond upon Thames","10:00:00","2019-10-08",20,0,0,0,0,20
"Tower Hamlets","10:00:00","2019-10-08",484,14,40,150,8,696
"Waltham Forest","10:00:00","2019-10-08",83,1,0,13,2,99
"Wandsworth","10:00:00","2019-10-08",30,0,0,6,1,37
"Barnet","11:00:00","2019-10-08",1036,20,67,188,41,1352
"Brent","11:00:00","2019-10-08",630,6,34,109,9,788
"Bromley","11:00:00","2019-10-08",218,2,0,35,4,259
"Croydon","11:00:00","2019-10-08",995,34,9,253,33,1324
"Ealing","11:00:00","2019-10-08",17,0,0,4,1,22
"Hounslow","11:00:00","2019-10-08",161,3,0,25,0,189
"Lambeth","11:00:00","2019-10-08",287,14,12,73,11,397
"Newham","11:00:00","2019-10-08",349,3,16,64,10,442
"Richmond upon Thames","11:00:00","2019-10-08",22,0,0,3,0,25
"Tower Hamlets","11:00:00","2019-10-08",396,14,37,156,12,615
"Waltham Forest","11:00:00","2019-10-08",83,1,0,21,0,105
"Wandsworth","11:00:00","2019-10-08",33,1,0,13,0,47
"Barnet","12:00:00","2019-10-08",1198,13,64,178,54,1507
"Brent","12:00:00","2019-10-08",632,14,26,116,15,803
"Bromley","12:00:00","2019-10-08",200,3,0,44,6,253
"Croydon","12:00:00","2019-10-08",1014,58,11,248,51,1382
"Ealing","12:00:00","2019-10-08",14,1,0,5,0,20
"Hounslow","12:00:00","2019-10-08",122,4,0,24,1,151
"Lambeth","12:00:00","2019-10-08",282,13,12,62,14,383
"Newham","12:00:00","2019-10-08",364,3,13,67,14,461
"Richmond upon Thames","12:00:00","2019-10-08",17,0,0,1,0,18
"Tower Hamlets","12:00:00","2019-10-08",406,17,37,193,14,667
"Waltham Forest","12:00:00","2019-10-08",97,2,0,20,0,119
"Wandsworth","12:00:00","2019-10-08",32,1,0,8,0,41
"Barnet","13:00:00","2019-10-08",1223,17,69,182,45,1536
"Brent","13:00:00","2019-10-08",654,21,28,117,11,831
"Bromley","13:00:00","2019-10-08",225,1,0,42,4,272
"Croydon","13:00:00","2019-10-08",1028,58,10,247,39,1382
"Ealing","13:00:00","2019-10-08",11,1,0,6,0,18
"Hounslow","13:00:00","2019-10-08",122,1,0,23,1,147
"Lambeth","13:00:00","2019-10-08",307,15,8,61,10,401
"Newham","13:00:00","2019-10-08",425,5,14,65,16,525
"Richmond upon Thames","13:00:00","2019-10-08",18,0,0,3,4,25
"Tower Hamlets","13:00:00","2019-10-08",400,25,37,192,9,663
"Waltham Forest","13:00:00","2019-10-08",99,2,0,11,0,112
"Wandsworth","13:00:00","2019-10-08",32,0,0,6,0,38
"Barnet","14:00:00","2019-10-08",1223,25,64,180,49,1541
"Brent","14:00:00","2019-10-08",697,20,26,108,9,860
"Bromley","14:00:00","2019-10-08",261,1,0,44,8,314
"Croydon","14:00:00","2019-10-08",1196,49,13,234,29,1521
"Ealing","14:00:00","2019-10-08",21,6,0,3,0,30
"Hounslow","14:00:00","2019-10-08",134,1,0,18,0,153
"Lambeth","14:00:00","2019-10-08",363,22,10,87,5,487
"Newham","14:00:00","2019-10-08",442,6,12,77,10,547
"Richmond upon Thames","14:00:00","2019-10-08",21,0,0,6,0,27
"Tower Hamlets","14:00:00","2019-10-08",416,25,36,184,8,669
"Waltham Forest","14:00:00","2019-10-08",99,0,0,13,0,112
"Wandsworth","14:00:00","2019-10-08",30,2,0,8,0,40
"Barnet","15:00:00","2019-10-08",1263,21,66,170,40,1560
"Brent","15:00:00","2019-10-08",845,8,33,112,8,1006
"Bromley","15:00:00","2019-10-08",352,4,1,53,4,414
"Croydon","15:00:00","2019-10-08",1196,35,10,223,20,1484
"Ealing","15:00:00","2019-10-08",16,0,0,8,0,24
"Hounslow","15:00:00","2019-10-08",198,1,0,28,0,227
"Lambeth","15:00:00","2019-10-08",476,13,12,100,4,605
"Newham","15:00:00","2019-10-08",630,9,12,79,16,746
"Richmond upon Thames","15:00:00","2019-10-08",26,0,0,4,0,30
"Tower Hamlets","15:00:00","2019-10-08",401,19,40,173,6,639
"Waltham Forest","15:00:00","2019-10-08",144,1,0,13,1,159
"Wandsworth","15:00:00","2019-10-08",35,2,0,6,0,43
"Barnet","16:00:00","2019-10-08",1410,12,59,158,33,1672
"Brent","16:00:00","2019-10-08",841,22,27,134,6,1030
"Bromley","16:00:00","2019-10-08",361,2,0,77,3,443
"Croydon","16:00:00","2019-10-08",1145,58,8,249,18,1478
"Ealing","16:00:00","2019-10-08",12,0,0,4,0,16
"Hounslow","16:00:00","2019-10-08",290,0,0,31,0,321
"Lambeth","16:00:00","2019-10-08",517,31,10,121,4,683
"Newham","16:00:00","2019-10-08",659,3,13,83,8,766
"Richmond upon Thames","16:00:00","2019-10-08",22,0,0,0,0,22
"Tower Hamlets","16:00:00","2019-10-08",449,18,39,175,6,687
"Waltham Forest","16:00:00","2019-10-08",144,1,0,14,0,159
"Wandsworth","16:00:00","2019-10-08",38,0,0,9,0,47
"Barnet","17:00:00","2019-10-08",1484,31,60,198,25,1798
"Brent","17:00:00","2019-10-08",874,26,37,119,1,1057
"Bromley","17:00:00","2019-10-08",473,10,0,72,0,555
"Croydon","17:00:00","2019-10-08",1159,72,10,158,16,1415
"Ealing","17:00:00","2019-10-08",20,1,0,1,0,22
"Hounslow","17:00:00","2019-10-08",389,5,0,59,0,453
"Lambeth","17:00:00","2019-10-08",596,33,12,101,2,744
"Newham","17:00:00","2019-10-08",682,12,14,98,6,812
"Richmond upon Thames","17:00:00","2019-10-08",25,0,0,2,0,27
"Tower Hamlets","17:00:00","2019-10-08",495,25,42,113,4,679
"Waltham Forest","17:00:00","2019-10-08",142,1,0,21,0,164
"Wandsworth","17:00:00","2019-10-08",53,1,0,5,0,59
"Barnet","18:00:00","2019-10-08",1551,13,60,175,28,1827
"Brent","18:00:00","2019-10-08",870,27,32,117,4,1050
"Bromley","18:00:00","2019-10-08",411,2,0,51,5,469
"Croydon","18:00:00","2019-10-08",1235,78,11,123,13,1460
"Ealing","18:00:00","2019-10-08",14,0,0,2,0,16
"Hounslow","18:00:00","2019-10-08",307,4,0,27,0,338
"Lambeth","18:00:00","2019-10-08",601,41,9,86,0,737
"Newham","18:00:00","2019-10-08",656,6,13,60,5,740
"Richmond upon Thames","18:00:00","2019-10-08",23,0,0,3,0,26
"Tower Hamlets","18:00:00","2019-10-08",432,26,42,67,4,571
"Waltham Forest","18:00:00","2019-10-08",135,4,0,18,0,157
"Wandsworth","18:00:00","2019-10-08",48,4,0,6,0,58
"Croydon","07:00:00","2019-10-09",427,7,0,79,8,521
"Haringey","07:00:00","2019-10-09",310,8,20,81,5,424
"Harrow","07:00:00","2019-10-09",1371,19,3,233,17,1643
"Southwark","07:00:00","2019-10-09",37,0,0,3,0,40
"Sutton","07:00:00","2019-10-09",719,4,0,127,11,861
"Croydon","08:00:00","2019-10-09",563,6,0,70,4,643
"Haringey","08:00:00","2019-10-09",437,11,37,86,5,576
"Harrow","08:00:00","2019-10-09",1278,17,2,161,25,1483
"Southwark","08:00:00","2019-10-09",57,0,0,10,6,73
"Sutton","08:00:00","2019-10-09",892,4,2,115,9,1022
"Croydon","09:00:00","2019-10-09",420,17,0,75,9,521
"Haringey","09:00:00","2019-10-09",356,9,33,80,9,487
"Harrow","09:00:00","2019-10-09",880,7,2,120,16,1025
"Richmond upon Thames","09:00:00","2019-10-09",2683,122,27,458,79,3369
"Southwark","09:00:00","2019-10-09",38,1,0,21,4,64
"Sutton","09:00:00","2019-10-09",536,0,0,102,13,651
"Croydon","10:00:00","2019-10-09",240,18,0,70,2,330
"Haringey","10:00:00","2019-10-09",284,9,24,68,14,399
"Harrow","10:00:00","2019-10-09",780,6,3,166,25,980
"Richmond upon Thames","10:00:00","2019-10-09",2116,48,27,479,82,2752
"Southwark","10:00:00","2019-10-09",33,4,0,4,1,42
"Sutton","10:00:00","2019-10-09",468,4,1,63,7,543
"Croydon","11:00:00","2019-10-09",232,12,0,74,8,326
"Haringey","11:00:00","2019-10-09",244,17,22,101,6,390
"Harrow","11:00:00","2019-10-09",839,5,2,151,27,1024
"Richmond upon Thames","11:00:00","2019-10-09",2220,45,15,449,87,2816
"Southwark","11:00:00","2019-10-09",37,0,0,6,1,44
"Sutton","11:00:00","2019-10-09",393,0,0,60,13,466
"Croydon","12:00:00","2019-10-09",250,18,0,69,12,349
"Haringey","12:00:00","2019-10-09",267,20,20,90,7,404
"Harrow","12:00:00","2019-10-09",782,6,2,132,19,941
"Richmond upon Thames","12:00:00","2019-10-09",2362,62,15,508,59,3006
"Southwark","12:00:00","2019-10-09",31,5,0,15,2,53
"Sutton","12:00:00","2019-10-09",466,1,0,77,9,553
"Croydon","13:00:00","2019-10-09",256,20,0,72,5,353
"Haringey","13:00:00","2019-10-09",259,19,22,56,4,360
"Harrow","13:00:00","2019-10-09",824,10,0,141,25,1000
"Richmond upon Thames","13:00:00","2019-10-09",2091,48,18,509,72,2738
"Southwark","13:00:00","2019-10-09",25,1,0,16,3,45
"Sutton","13:00:00","2019-10-09",432,4,4,93,13,546
"Croydon","14:00:00","2019-10-09",339,29,0,90,3,461
"Haringey","14:00:00","2019-10-09",278,18,23,83,8,410
"Harrow","14:00:00","2019-10-09",955,12,2,147,23,1139
"Richmond upon Thames","14:00:00","2019-10-09",2413,46,16,519,90,3084
"Southwark","14:00:00","2019-10-09",41,7,0,24,3,75
"Sutton","14:00:00","2019-10-09",514,3,0,100,3,620
"Croydon","15:00:00","2019-10-09",459,23,0,102,2,586
"Haringey","15:00:00","2019-10-09",379,16,20,74,7,496
"Harrow","15:00:00","2019-10-09",1012,10,1,138,23,1184
"Southwark","15:00:00","2019-10-09",51,1,0,17,4,73
"Sutton","15:00:00","2019-10-09",694,4,2,108,7,815
"Croydon","16:00:00","2019-10-09",479,23,0,109,4,615
"Haringey","16:00:00","2019-10-09",400,18,25,56,5,504
"Harrow","16:00:00","2019-10-09",1285,21,0,175,15,1496
"Southwark","16:00:00","2019-10-09",48,5,0,9,0,62
"Sutton","16:00:00","2019-10-09",711,6,1,158,2,878
"Croydon","17:00:00","2019-10-09",601,32,0,83,0,716
"Haringey","17:00:00","2019-10-09",399,30,32,43,2,506
"Harrow","17:00:00","2019-10-09",1464,20,0,191,8,1683
"Southwark","17:00:00","2019-10-09",48,1,0,10,1,60
"Sutton","17:00:00","2019-10-09",761,5,2,105,5,878
"Croydon","18:00:00","2019-10-09",504,30,0,53,0,587
"Haringey","18:00:00","2019-10-09",374,24,26,38,3,465
"Harrow","18:00:00","2019-10-09",1417,9,0,165,7,1598
"Southwark","18:00:00","2019-10-09",55,3,0,5,2,65
"Sutton","18:00:00","2019-10-09",677,6,1,86,0,770
"Bromley","07:00:00","2019-10-10",191,0,0,47,0,238
"Croydon","07:00:00","2019-10-10",694,13,10,112,11,840
"Ealing","07:00:00","2019-10-10",26,2,0,2,0,30
"Enfield","07:00:00","2019-10-10",236,7,11,45,2,301
"Haringey","07:00:00","2019-10-10",36,0,5,15,1,57
"Havering","07:00:00","2019-10-10",25,0,0,5,0,30
"Islington","07:00:00","2019-10-10",277,10,0,117,2,406
"Kingston upon Thames","07:00:00","2019-10-10",408,4,0,71,1,484
"Newham","07:00:00","2019-10-10",62,0,0,7,0,69
"Richmond upon Thames","07:00:00","2019-10-10",231,7,12,29,1,280
"Tower Hamlets","07:00:00","2019-10-10",365,21,14,150,21,571
"Bromley","08:00:00","2019-10-10",251,4,0,37,1,293
"Croydon","08:00:00","2019-10-10",970,9,10,145,16,1150
"Ealing","08:00:00","2019-10-10",31,1,0,2,0,34
"Enfield","08:00:00","2019-10-10",473,2,12,46,5,538
"Haringey","08:00:00","2019-10-10",56,0,6,17,1,80
"Havering","08:00:00","2019-10-10",72,0,0,9,0,81
"Islington","08:00:00","2019-10-10",343,25,0,108,4,480
"Kingston upon Thames","08:00:00","2019-10-10",600,6,0,67,1,674
"Newham","08:00:00","2019-10-10",107,0,0,6,0,113
"Richmond upon Thames","08:00:00","2019-10-10",374,7,15,32,7,435
"Tower Hamlets","08:00:00","2019-10-10",571,25,12,144,26,778
"Bromley","09:00:00","2019-10-10",157,3,0,27,0,187
"Croydon","09:00:00","2019-10-10",590,12,11,117,4,734
"Ealing","09:00:00","2019-10-10",27,0,0,5,0,32
"Enfield","09:00:00","2019-10-10",274,2,12,51,8,347
"Haringey","09:00:00","2019-10-10",73,3,6,17,2,101
"Havering","09:00:00","2019-10-10",57,0,0,4,0,61
"Islington","09:00:00","2019-10-10",307,18,0,90,2,417
"Kingston upon Thames","09:00:00","2019-10-10",199,4,1,27,2,233
"Newham","09:00:00","2019-10-10",92,0,0,16,0,108
"Richmond upon Thames","09:00:00","2019-10-10",167,4,13,40,12,236
"Tower Hamlets","09:00:00","2019-10-10",517,28,13,157,43,758
"Bromley","10:00:00","2019-10-10",144,0,0,28,0,172
"Croydon","10:00:00","2019-10-10",401,12,11,102,12,538
"Ealing","10:00:00","2019-10-10",24,1,0,8,0,33
"Enfield","10:00:00","2019-10-10",184,0,12,43,4,243
"Haringey","10:00:00","2019-10-10",58,2,6,19,3,88
"Havering","10:00:00","2019-10-10",48,0,0,6,0,54
"Islington","10:00:00","2019-10-10",304,17,0,114,0,435
"Kingston upon Thames","10:00:00","2019-10-10",168,0,0,31,2,201
"Newham","10:00:00","2019-10-10",72,2,0,14,1,89
"Richmond upon Thames","10:00:00","2019-10-10",203,2,16,41,10,272
"Tower Hamlets","10:00:00","2019-10-10",494,27,12,198,50,781
"Bromley","11:00:00","2019-10-10",162,1,0,29,2,194
"Croydon","11:00:00","2019-10-10",424,12,9,84,9,538
"Ealing","11:00:00","2019-10-10",28,0,0,6,0,34
"Enfield","11:00:00","2019-10-10",172,1,11,36,6,226
"Haringey","11:00:00","2019-10-10",67,4,6,25,2,104
"Havering","11:00:00","2019-10-10",34,0,0,4,0,38
"Islington","11:00:00","2019-10-10",277,20,1,109,4,411
"Kingston upon Thames","11:00:00","2019-10-10",156,0,0,37,0,193
"Newham","11:00:00","2019-10-10",79,4,0,11,1,95
"Richmond upon Thames","11:00:00","2019-10-10",213,4,13,43,7,280
"Tower Hamlets","11:00:00","2019-10-10",540,35,12,206,36,829
"Bromley","12:00:00","2019-10-10",150,2,0,27,0,179
"Croydon","12:00:00","2019-10-10",448,13,13,102,14,590
"Ealing","12:00:00","2019-10-10",21,2,0,8,0,31
"Enfield","12:00:00","2019-10-10",233,6,8,30,11,288
"Haringey","12:00:00","2019-10-10",64,1,5,11,0,81
"Havering","12:00:00","2019-10-10",46,0,0,7,1,54
"Islington","12:00:00","2019-10-10",243,10,0,99,2,354
"Kingston upon Thames","12:00:00","2019-10-10",188,2,0,27,0,217
"Newham","12:00:00","2019-10-10",95,1,0,9,0,105
"Richmond upon Thames","12:00:00","2019-10-10",164,6,12,35,6,223
"Tower Hamlets","12:00:00","2019-10-10",514,60,13,139,25,751
"Bromley","13:00:00","2019-10-10",117,2,0,28,0,147
"Croydon","13:00:00","2019-10-10",466,16,10,94,5,591
"Ealing","13:00:00","2019-10-10",33,5,0,7,0,45
"Enfield","13:00:00","2019-10-10",245,5,12,40,4,306
"Haringey","13:00:00","2019-10-10",95,2,5,18,2,122
"Havering","13:00:00","2019-10-10",39,1,0,5,1,46
"Islington","13:00:00","2019-10-10",315,18,0,103,0,436
"Kingston upon Thames","13:00:00","2019-10-10",180,4,0,26,1,211
"Newham","13:00:00","2019-10-10",85,5,0,7,0,97
"Richmond upon Thames","13:00:00","2019-10-10",190,4,15,39,8,256
"Tower Hamlets","13:00:00","2019-10-10",550,80,12,137,27,806
"Bromley","14:00:00","2019-10-10",127,2,0,21,0,150
"Croydon","14:00:00","2019-10-10",598,14,10,108,9,739
"Ealing","14:00:00","2019-10-10",27,1,0,5,0,33
"Enfield","14:00:00","2019-10-10",271,4,12,39,7,333
"Haringey","14:00:00","2019-10-10",88,7,6,21,1,123
"Havering","14:00:00","2019-10-10",29,1,0,7,0,37
"Islington","14:00:00","2019-10-10",332,15,0,101,1,449
"Kingston upon Thames","14:00:00","2019-10-10",168,4,0,30,1,203
"Newham","14:00:00","2019-10-10",95,0,0,8,1,104
"Richmond upon Thames","14:00:00","2019-10-10",199,4,17,43,10,273
"Tower Hamlets","14:00:00","2019-10-10",584,54,12,124,27,801
"Bromley","15:00:00","2019-10-10",223,0,0,35,0,258
"Croydon","15:00:00","2019-10-10",745,13,10,124,8,900
"Ealing","15:00:00","2019-10-10",31,0,0,4,0,35
"Enfield","15:00:00","2019-10-10",369,10,11,49,8,447
"Haringey","15:00:00","2019-10-10",103,2,6,24,1,136
"Havering","15:00:00","2019-10-10",67,0,0,7,0,74
"Islington","15:00:00","2019-10-10",340,19,0,102,1,462
"Kingston upon Thames","15:00:00","2019-10-10",242,2,1,44,0,289
"Newham","15:00:00","2019-10-10",91,0,0,7,0,98
"Richmond upon Thames","15:00:00","2019-10-10",287,4,19,37,2,349
"Tower Hamlets","15:00:00","2019-10-10",613,32,18,104,43,810
"Bromley","16:00:00","2019-10-10",223,1,0,64,0,288
"Croydon","16:00:00","2019-10-10",673,15,12,134,4,838
"Ealing","16:00:00","2019-10-10",31,0,0,9,0,40
"Enfield","16:00:00","2019-10-10",338,9,16,51,5,419
"Haringey","16:00:00","2019-10-10",126,3,5,32,3,169
"Havering","16:00:00","2019-10-10",77,0,0,6,0,83
"Islington","16:00:00","2019-10-10",347,26,0,95,0,468
"Kingston upon Thames","16:00:00","2019-10-10",264,4,0,32,3,303
"Newham","16:00:00","2019-10-10",131,3,0,10,1,145
"Richmond upon Thames","16:00:00","2019-10-10",285,6,13,27,5,336
"Tower Hamlets","16:00:00","2019-10-10",681,49,16,110,18,874
"Bromley","17:00:00","2019-10-10",218,7,0,37,0,262
"Croydon","17:00:00","2019-10-10",754,27,11,115,5,912
"Ealing","17:00:00","2019-10-10",35,1,0,4,0,40
"Enfield","17:00:00","2019-10-10",422,17,10,40,5,494
"Haringey","17:00:00","2019-10-10",89,1,4,23,1,118
"Havering","17:00:00","2019-10-10",53,0,0,4,0,57
"Islington","17:00:00","2019-10-10",399,26,0,91,1,517
"Kingston upon Thames","17:00:00","2019-10-10",330,10,0,38,2,380
"Newham","17:00:00","2019-10-10",98,4,0,13,1,116
"Richmond upon Thames","17:00:00","2019-10-10",207,9,13,22,1,252
"Tower Hamlets","17:00:00","2019-10-10",815,56,12,80,5,968
"Bromley","18:00:00","2019-10-10",171,4,0,20,1,196
"Croydon","18:00:00","2019-10-10",856,26,12,89,2,985
"Ealing","18:00:00","2019-10-10",32,0,0,1,0,33
"Enfield","18:00:00","2019-10-10",343,22,13,31,3,412
"Haringey","18:00:00","2019-10-10",114,5,4,11,2,136
"Havering","18:00:00","2019-10-10",44,0,0,3,0,47
"Islington","18:00:00","2019-10-10",396,16,0,53,1,466
"Kingston upon Thames","18:00:00","2019-10-10",265,6,0,29,0,300
"Newham","18:00:00","2019-10-10",110,2,0,12,0,124
"Richmond upon Thames","18:00:00","2019-10-10",201,10,12,13,2,238
"Tower Hamlets","18:00:00","2019-10-10",748,82,10,61,1,902
"Brent","07:00:00","2019-10-11",528,16,61,242,68,915
"Croydon","07:00:00","2019-10-11",2052,60,33,500,64,2709
"Enfield","07:00:00","2019-10-11",992,23,4,301,175,1495
"Hillingdon","07:00:00","2019-10-11",370,1,2,41,2,416
"Islington","07:00:00","2019-10-11",108,2,0,79,2,191
"Kensington and Chelsea","07:00:00","2019-10-11",1047,78,30,293,65,1513
"Brent","08:00:00","2019-10-11",640,15,45,246,104,1050
"Croydon","08:00:00","2019-10-11",2152,36,25,358,52,2623
"Enfield","08:00:00","2019-10-11",945,10,2,232,209,1398
"Hillingdon","08:00:00","2019-10-11",497,2,2,47,1,549
"Islington","08:00:00","2019-10-11",113,3,0,59,3,178
"Kensington and Chelsea","08:00:00","2019-10-11",1019,89,25,227,71,1431
"Brent","09:00:00","2019-10-11",678,23,47,272,107,1127
"Croydon","09:00:00","2019-10-11",1887,25,26,444,54,2436
"Enfield","09:00:00","2019-10-11",770,4,2,246,204,1226
"Hillingdon","09:00:00","2019-10-11",220,2,2,24,0,248
"Islington","09:00:00","2019-10-11",145,6,0,56,7,214
"Kensington and Chelsea","09:00:00","2019-10-11",930,55,29,275,80,1369
"Brent","10:00:00","2019-10-11",780,14,49,237,103,1183
"Croydon","10:00:00","2019-10-11",1836,33,28,432,78,2407
"Enfield","10:00:00","2019-10-11",762,8,6,281,198,1255
"Hillingdon","10:00:00","2019-10-11",170,2,2,20,4,198
"Islington","10:00:00","2019-10-11",110,3,0,44,6,163
"Kensington and Chelsea","10:00:00","2019-10-11",993,40,23,318,78,1452
"Brent","11:00:00","2019-10-11",824,13,35,198,107,1177
"Croydon","11:00:00","2019-10-11",1754,43,20,431,67,2315
"Enfield","11:00:00","2019-10-11",790,15,1,273,238,1317
"Hillingdon","11:00:00","2019-10-11",162,5,2,30,1,200
"Islington","11:00:00","2019-10-11",93,9,1,33,0,136
"Kensington and Chelsea","11:00:00","2019-10-11",983,27,24,336,84,1454
"Brent","12:00:00","2019-10-11",955,20,47,222,112,1356
"Croydon","12:00:00","2019-10-11",1921,55,29,422,65,2492
"Enfield","12:00:00","2019-10-11",834,18,5,243,170,1270
"Hillingdon","12:00:00","2019-10-11",164,2,2,28,0,196
"Islington","12:00:00","2019-10-11",105,7,0,33,3,148
"Kensington and Chelsea","12:00:00","2019-10-11",944,54,32,343,128,1501
"Brent","13:00:00","2019-10-11",971,20,49,215,113,1368
"Croydon","13:00:00","2019-10-11",1859,36,28,384,66,2373
"Enfield","13:00:00","2019-10-11",951,15,2,218,170,1356
"Hillingdon","13:00:00","2019-10-11",136,6,2,37,0,181
"Islington","13:00:00","2019-10-11",86,7,0,35,1,129
"Kensington and Chelsea","13:00:00","2019-10-11",997,55,34,267,113,1466
"Brent","14:00:00","2019-10-11",1003,38,59,226,154,1480
"Croydon","14:00:00","2019-10-11",1896,46,21,401,40,2404
"Enfield","14:00:00","2019-10-11",944,13,4,241,188,1390
"Hillingdon","14:00:00","2019-10-11",254,1,3,27,2,287
"Islington","14:00:00","2019-10-11",113,11,0,41,1,166
"Kensington and Chelsea","14:00:00","2019-10-11",1014,58,30,292,105,1499
"Brent","15:00:00","2019-10-11",1022,23,57,226,115,1443
"Croydon","15:00:00","2019-10-11",2070,55,27,379,46,2577
"Enfield","15:00:00","2019-10-11",1021,17,1,227,159,1425
"Hillingdon","15:00:00","2019-10-11",418,0,2,30,3,453
"Islington","15:00:00","2019-10-11",128,7,0,35,2,172
"Kensington and Chelsea","15:00:00","2019-10-11",1021,72,25,288,103,1509
"Brent","16:00:00","2019-10-11",1072,24,50,216,90,1452
"Croydon","16:00:00","2019-10-11",2196,66,18,355,25,2660
"Enfield","16:00:00","2019-10-11",1098,13,1,188,118,1418
"Hillingdon","16:00:00","2019-10-11",334,1,3,45,0,383
"Islington","16:00:00","2019-10-11",129,10,0,31,0,170
"Kensington and Chelsea","16:00:00","2019-10-11",1157,76,31,279,91,1634
"Brent","17:00:00","2019-10-11",1098,15,38,160,63,1374
"Croydon","17:00:00","2019-10-11",2176,77,20,288,12,2573
"Enfield","17:00:00","2019-10-11",1232,14,6,187,120,1559
"Hillingdon","17:00:00","2019-10-11",370,5,3,43,0,421
"Islington","17:00:00","2019-10-11",150,24,0,25,0,199
"Kensington and Chelsea","17:00:00","2019-10-11",1061,93,30,260,72,1516
"Brent","18:00:00","2019-10-11",1014,17,35,118,43,1227
"Croydon","18:00:00","2019-10-11",2265,99,21,260,17,2662
"Enfield","18:00:00","2019-10-11",1247,17,1,165,90,1520
"Hillingdon","18:00:00","2019-10-11",302,0,2,26,0,330
"Islington","18:00:00","2019-10-11",135,20,0,24,0,179
"Kensington and Chelsea","18:00:00","2019-10-11",1100,105,33,272,62,1572
"Camden","07:00:00","2019-10-15",1,0,0,1,0,2
"Ealing","07:00:00","2019-10-15",26,0,0,7,0,33
"Haringey","07:00:00","2019-10-15",15,0,0,7,0,22
"Hounslow","07:00:00","2019-10-15",11,2,0,4,0,17
"Lewisham","07:00:00","2019-10-15",23,1,0,4,0,28
"Merton","07:00:00","2019-10-15",813,19,32,167,32,1063
"Redbridge","07:00:00","2019-10-15",1129,4,14,190,7,1344
"Westminster","07:00:00","2019-10-15",390,49,14,183,54,690
"Camden","08:00:00","2019-10-15",2,0,0,3,0,5
"Ealing","08:00:00","2019-10-15",42,0,0,8,0,50
"Haringey","08:00:00","2019-10-15",18,1,0,2,0,21
"Hounslow","08:00:00","2019-10-15",9,0,0,11,0,20
"Lewisham","08:00:00","2019-10-15",37,2,0,6,0,45
"Merton","08:00:00","2019-10-15",705,23,27,123,32,910
"Redbridge","08:00:00","2019-10-15",1324,11,13,153,18,1519
"Westminster","08:00:00","2019-10-15",479,47,20,189,35,770
"Camden","09:00:00","2019-10-15",3,0,0,4,0,7
"Ealing","09:00:00","2019-10-15",23,0,0,4,0,27
"Haringey","09:00:00","2019-10-15",20,0,0,7,0,27
"Hounslow","09:00:00","2019-10-15",6,3,0,3,3,15
"Lewisham","09:00:00","2019-10-15",29,1,0,11,1,42
"Merton","09:00:00","2019-10-15",627,20,34,131,50,862
"Redbridge","09:00:00","2019-10-15",1129,7,10,154,12,1312
"Westminster","09:00:00","2019-10-15",442,54,30,198,36,760
"Camden","10:00:00","2019-10-15",3,0,0,7,0,10
"Ealing","10:00:00","2019-10-15",20,5,0,8,0,33
"Haringey","10:00:00","2019-10-15",11,0,0,7,0,18
"Hounslow","10:00:00","2019-10-15",6,2,0,6,2,16
"Lewisham","10:00:00","2019-10-15",21,0,0,11,0,32
"Merton","10:00:00","2019-10-15",617,16,33,135,33,834
"Redbridge","10:00:00","2019-10-15",1134,3,11,187,21,1356
"Westminster","10:00:00","2019-10-15",504,35,31,213,41,824
"Camden","11:00:00","2019-10-15",3,0,0,0,3,6
"Ealing","11:00:00","2019-10-15",17,1,0,8,0,26
"Haringey","11:00:00","2019-10-15",13,0,0,2,0,15
"Hounslow","11:00:00","2019-10-15",9,0,0,4,0,13
"Lewisham","11:00:00","2019-10-15",31,0,0,12,0,43
"Merton","11:00:00","2019-10-15",520,15,33,132,38,738
"Redbridge","11:00:00","2019-10-15",1159,7,10,189,19,1384
"Westminster","11:00:00","2019-10-15",489,39,24,226,35,813
"Camden","12:00:00","2019-10-15",2,0,0,3,0,5
"Ealing","12:00:00","2019-10-15",17,0,0,4,0,21
"Haringey","12:00:00","2019-10-15",24,1,0,8,0,33
"Hounslow","12:00:00","2019-10-15",10,0,0,3,0,13
"Lewisham","12:00:00","2019-10-15",24,1,0,11,0,36
"Merton","12:00:00","2019-10-15",564,24,29,127,40,784
"Redbridge","12:00:00","2019-10-15",1030,6,12,212,10,1270
"Westminster","12:00:00","2019-10-15",475,48,31,176,29,759
"Camden","13:00:00","2019-10-15",3,0,0,3,0,6
"Ealing","13:00:00","2019-10-15",18,1,0,6,0,25
"Haringey","13:00:00","2019-10-15",15,2,0,7,0,24
"Hounslow","13:00:00","2019-10-15",9,0,0,3,0,12
"Lewisham","13:00:00","2019-10-15",30,1,0,2,0,33
"Merton","13:00:00","2019-10-15",571,23,29,136,35,794
"Redbridge","13:00:00","2019-10-15",1006,7,13,188,15,1229
"Westminster","13:00:00","2019-10-15",530,47,25,217,35,854
"Camden","14:00:00","2019-10-15",2,2,0,1,0,5
"Ealing","14:00:00","2019-10-15",24,0,0,2,0,26
"Haringey","14:00:00","2019-10-15",16,0,0,3,0,19
"Hounslow","14:00:00","2019-10-15",8,1,0,0,0,9
"Lewisham","14:00:00","2019-10-15",21,0,0,5,1,27
"Merton","14:00:00","2019-10-15",609,28,28,119,27,811
"Redbridge","14:00:00","2019-10-15",1139,5,12,166,16,1338
"Westminster","14:00:00","2019-10-15",517,58,33,213,35,856
"Camden","15:00:00","2019-10-15",4,1,0,3,0,8
"Ealing","15:00:00","2019-10-15",27,0,0,2,0,29
"Haringey","15:00:00","2019-10-15",31,0,0,5,0,36
"Hounslow","15:00:00","2019-10-15",12,1,0,9,0,22
"Lewisham","15:00:00","2019-10-15",35,1,0,8,1,45
"Merton","15:00:00","2019-10-15",756,24,34,119,31,964
"Redbridge","15:00:00","2019-10-15",1145,10,14,188,16,1373
"Westminster","15:00:00","2019-10-15",634,47,21,180,22,904
"Camden","16:00:00","2019-10-15",4,0,0,2,0,6
"Ealing","16:00:00","2019-10-15",32,0,0,2,0,34
"Haringey","16:00:00","2019-10-15",27,2,0,1,0,30
"Hounslow","16:00:00","2019-10-15",13,1,0,3,0,17
"Lewisham","16:00:00","2019-10-15",24,2,0,12,1,39
"Merton","16:00:00","2019-10-15",783,28,31,153,26,1021
"Redbridge","16:00:00","2019-10-15",1214,6,15,166,13,1414
"Westminster","16:00:00","2019-10-15",698,66,31,189,16,1000
"Camden","17:00:00","2019-10-15",4,0,0,1,0,5
"Ealing","17:00:00","2019-10-15",36,1,0,3,0,40
"Haringey","17:00:00","2019-10-15",28,3,0,1,0,32
"Hounslow","17:00:00","2019-10-15",14,0,0,1,0,15
"Lewisham","17:00:00","2019-10-15",32,2,0,10,2,46
"Merton","17:00:00","2019-10-15",875,30,29,98,11,1043
"Redbridge","17:00:00","2019-10-15",1213,6,13,132,9,1373
"Westminster","17:00:00","2019-10-15",609,95,30,148,19,901
"Camden","18:00:00","2019-10-15",8,0,0,0,0,8
"Ealing","18:00:00","2019-10-15",35,0,0,4,0,39
"Haringey","18:00:00","2019-10-15",25,1,0,7,0,33
"Hounslow","18:00:00","2019-10-15",20,7,0,3,0,30
"Lewisham","18:00:00","2019-10-15",41,4,0,2,0,47
"Merton","18:00:00","2019-10-15",878,28,25,91,6,1028
"Redbridge","18:00:00","2019-10-15",1302,4,13,140,6,1465
"Westminster","18:00:00","2019-10-15",758,81,29,202,12,1082
"Barking and Dagenham","07:00:00","2019-10-16",9,0,0,4,0,13
"Bromley","07:00:00","2019-10-16",374,2,14,76,5,471
"Croydon","07:00:00","2019-10-16",1378,14,16,288,23,1719
"Haringey","07:00:00","2019-10-16",145,0,0,18,2,165
"Merton","07:00:00","2019-10-16",654,23,35,147,13,872
"Tower Hamlets","07:00:00","2019-10-16",363,10,18,123,7,521
"Barking and Dagenham","08:00:00","2019-10-16",21,1,0,1,0,23
"Bromley","08:00:00","2019-10-16",476,0,10,53,6,545
"Croydon","08:00:00","2019-10-16",1650,13,17,263,32,1975
"Haringey","08:00:00","2019-10-16",266,1,0,28,0,295
"Merton","08:00:00","2019-10-16",777,13,30,136,11,967
"Tower Hamlets","08:00:00","2019-10-16",697,8,21,123,14,863
"Barking and Dagenham","09:00:00","2019-10-16",10,2,0,2,0,14
"Bromley","09:00:00","2019-10-16",232,0,12,40,12,296
"Croydon","09:00:00","2019-10-16",1062,15,21,229,47,1374
"Haringey","09:00:00","2019-10-16",93,3,0,18,1,115
"Merton","09:00:00","2019-10-16",579,17,34,150,21,801
"Tower Hamlets","09:00:00","2019-10-16",522,3,24,122,22,693
"Barking and Dagenham","10:00:00","2019-10-16",12,3,0,2,1,18
"Bromley","10:00:00","2019-10-16",207,0,14,31,6,258
"Croydon","10:00:00","2019-10-16",811,11,19,200,47,1088
"Haringey","10:00:00","2019-10-16",37,2,0,6,1,46
"Merton","10:00:00","2019-10-16",427,7,40,132,15,621
"Tower Hamlets","10:00:00","2019-10-16",336,5,18,110,26,495
"Barking and Dagenham","11:00:00","2019-10-16",6,0,0,2,0,8
"Bromley","11:00:00","2019-10-16",246,3,10,50,6,315
"Croydon","11:00:00","2019-10-16",718,4,16,171,26,935
"Haringey","11:00:00","2019-10-16",30,0,0,10,0,40
"Merton","11:00:00","2019-10-16",439,11,35,126,15,626
"Tower Hamlets","11:00:00","2019-10-16",398,10,18,118,8,552
"Barking and Dagenham","12:00:00","2019-10-16",5,0,0,0,1,6
"Bromley","12:00:00","2019-10-16",248,1,10,46,14,319
"Croydon","12:00:00","2019-10-16",835,10,14,216,37,1112
"Haringey","12:00:00","2019-10-16",42,4,0,8,1,55
"Merton","12:00:00","2019-10-16",465,5,37,106,21,634
"Tower Hamlets","12:00:00","2019-10-16",373,6,17,93,15,504
"Barking and Dagenham","13:00:00","2019-10-16",8,0,0,5,0,13
"Bromley","13:00:00","2019-10-16",218,0,12,42,9,281
"Croydon","13:00:00","2019-10-16",916,18,14,232,36,1216
"Haringey","13:00:00","2019-10-16",58,3,0,14,1,76
"Merton","13:00:00","2019-10-16",507,9,32,134,12,694
"Tower Hamlets","13:00:00","2019-10-16",433,21,15,132,6,607
"Barking and Dagenham","14:00:00","2019-10-16",7,0,0,3,0,10
"Bromley","14:00:00","2019-10-16",266,1,11,35,3,316
"Croydon","14:00:00","2019-10-16",1060,22,15,217,30,1344
"Haringey","14:00:00","2019-10-16",68,0,0,8,1,77
"Merton","14:00:00","2019-10-16",601,19,36,109,15,780
"Tower Hamlets","14:00:00","2019-10-16",511,12,19,130,14,686
"Barking and Dagenham","15:00:00","2019-10-16",7,2,0,4,0,13
"Bromley","15:00:00","2019-10-16",304,1,12,57,3,377
"Croydon","15:00:00","2019-10-16",1232,14,12,254,31,1543
"Haringey","15:00:00","2019-10-16",107,5,0,24,0,136
"Merton","15:00:00","2019-10-16",647,11,39,128,14,839
"Tower Hamlets","15:00:00","2019-10-16",653,16,17,116,8,810
"Barking and Dagenham","16:00:00","2019-10-16",10,0,0,2,0,12
"Bromley","16:00:00","2019-10-16",338,1,12,77,6,434
"Croydon","16:00:00","2019-10-16",1284,20,20,271,32,1627
"Haringey","16:00:00","2019-10-16",101,0,0,20,2,123
"Merton","16:00:00","2019-10-16",680,24,35,140,10,889
"Tower Hamlets","16:00:00","2019-10-16",610,14,20,129,10,783
"Barking and Dagenham","17:00:00","2019-10-16",11,0,0,1,0,12
"Bromley","17:00:00","2019-10-16",371,1,11,47,1,431
"Croydon","17:00:00","2019-10-16",1494,14,13,265,13,1799
"Haringey","17:00:00","2019-10-16",98,0,0,15,2,115
"Merton","17:00:00","2019-10-16",703,36,37,117,4,897
"Tower Hamlets","17:00:00","2019-10-16",714,39,19,87,4,863
"Barking and Dagenham","18:00:00","2019-10-16",8,2,0,0,0,10
"Bromley","18:00:00","2019-10-16",273,4,10,34,0,321
"Croydon","18:00:00","2019-10-16",1370,27,17,179,12,1605
"Haringey","18:00:00","2019-10-16",112,4,0,10,0,126
"Merton","18:00:00","2019-10-16",659,32,41,98,3,833
"Tower Hamlets","18:00:00","2019-10-16",608,32,20,64,1,725
"Barking and Dagenham","07:00:00","2019-10-17",495,9,14,105,10,633
"Bexley","07:00:00","2019-10-17",1061,12,13,408,98,1592
"Bromley","07:00:00","2019-10-17",756,4,14,157,12,943
"Ealing","07:00:00","2019-10-17",318,1,6,96,12,433
"Hackney","07:00:00","2019-10-17",132,1,20,30,10,193
"Haringey","07:00:00","2019-10-17",701,5,18,224,18,966
"Hillingdon","07:00:00","2019-10-17",900,6,10,176,11,1103
"Richmond upon Thames","07:00:00","2019-10-17",521,21,16,131,4,693
"Westminster","07:00:00","2019-10-17",58,7,17,33,5,120
"Barking and Dagenham","08:00:00","2019-10-17",528,8,16,77,10,639
"Bexley","08:00:00","2019-10-17",1076,10,12,297,105,1500
"Bromley","08:00:00","2019-10-17",854,5,11,87,20,977
"Ealing","08:00:00","2019-10-17",298,3,11,94,2,408
"Hackney","08:00:00","2019-10-17",157,1,11,34,11,214
"Haringey","08:00:00","2019-10-17",761,12,22,161,21,977
"Hillingdon","08:00:00","2019-10-17",1133,7,9,151,15,1315
"Richmond upon Thames","08:00:00","2019-10-17",570,28,16,95,13,722
"Westminster","08:00:00","2019-10-17",64,14,20,39,3,140
"Barking and Dagenham","09:00:00","2019-10-17",534,10,15,89,16,664
"Bexley","09:00:00","2019-10-17",1030,8,20,296,95,1449
"Bromley","09:00:00","2019-10-17",662,3,11,126,23,825
"Ealing","09:00:00","2019-10-17",230,1,9,83,8,331
"Hackney","09:00:00","2019-10-17",141,3,12,40,10,206
"Haringey","09:00:00","2019-10-17",801,9,23,160,19,1012
"Hillingdon","09:00:00","2019-10-17",970,4,15,174,29,1192
"Richmond upon Thames","09:00:00","2019-10-17",490,10,18,113,24,655
"Westminster","09:00:00","2019-10-17",86,9,22,50,12,179
"Barking and Dagenham","10:00:00","2019-10-17",488,7,14,107,12,628
"Bexley","10:00:00","2019-10-17",849,8,16,310,89,1272
"Bromley","10:00:00","2019-10-17",600,5,12,105,21,743
"Ealing","10:00:00","2019-10-17",146,6,8,73,21,254
"Hackney","10:00:00","2019-10-17",112,9,13,57,19,210
"Haringey","10:00:00","2019-10-17",632,8,22,146,18,826
"Hillingdon","10:00:00","2019-10-17",1065,4,8,163,22,1262
"Richmond upon Thames","10:00:00","2019-10-17",460,7,19,134,10,630
"Westminster","10:00:00","2019-10-17",78,12,31,44,5,170
"Barking and Dagenham","11:00:00","2019-10-17",463,3,10,93,19,588
"Bexley","11:00:00","2019-10-17",912,5,14,334,120,1385
"Bromley","11:00:00","2019-10-17",549,4,10,115,13,691
"Ealing","11:00:00","2019-10-17",191,5,8,62,15,281
"Hackney","11:00:00","2019-10-17",148,7,12,55,7,229
"Haringey","11:00:00","2019-10-17",598,10,23,155,12,798
"Hillingdon","11:00:00","2019-10-17",890,7,8,169,21,1095
"Richmond upon Thames","11:00:00","2019-10-17",502,15,20,138,15,690
"Westminster","11:00:00","2019-10-17",80,9,19,31,7,146
"Barking and Dagenham","12:00:00","2019-10-17",502,5,14,97,22,640
"Bexley","12:00:00","2019-10-17",997,14,21,339,119,1490
"Bromley","12:00:00","2019-10-17",527,8,11,136,21,703
"Ealing","12:00:00","2019-10-17",198,2,8,76,13,297
"Hackney","12:00:00","2019-10-17",143,14,11,69,11,248
"Haringey","12:00:00","2019-10-17",677,15,25,150,24,891
"Hillingdon","12:00:00","2019-10-17",955,5,8,146,27,1141
"Richmond upon Thames","12:00:00","2019-10-17",505,20,23,116,15,679
"Westminster","12:00:00","2019-10-17",95,8,19,35,6,163
"Barking and Dagenham","13:00:00","2019-10-17",507,1,10,101,10,629
"Bexley","13:00:00","2019-10-17",951,13,19,326,116,1425
"Bromley","13:00:00","2019-10-17",541,3,11,105,13,673
"Ealing","13:00:00","2019-10-17",210,4,8,69,18,309
"Hackney","13:00:00","2019-10-17",158,6,14,46,9,233
"Haringey","13:00:00","2019-10-17",786,6,22,164,17,995
"Hillingdon","13:00:00","2019-10-17",918,12,9,140,14,1093
"Richmond upon Thames","13:00:00","2019-10-17",510,25,17,130,10,692
"Westminster","13:00:00","2019-10-17",83,5,19,31,2,140
"Barking and Dagenham","14:00:00","2019-10-17",550,5,15,104,11,685
"Bexley","14:00:00","2019-10-17",961,19,22,310,118,1430
"Bromley","14:00:00","2019-10-17",658,1,9,129,18,815
"Ealing","14:00:00","2019-10-17",243,3,9,74,9,338
"Hackney","14:00:00","2019-10-17",174,3,11,43,10,241
"Haringey","14:00:00","2019-10-17",740,8,23,161,16,948
"Hillingdon","14:00:00","2019-10-17",908,8,10,165,19,1110
"Richmond upon Thames","14:00:00","2019-10-17",550,24,22,129,16,741
"Westminster","14:00:00","2019-10-17",70,10,21,28,2,131
"Barking and Dagenham","15:00:00","2019-10-17",635,15,13,116,9,788
"Bexley","15:00:00","2019-10-17",1068,7,16,337,108,1536
"Bromley","15:00:00","2019-10-17",697,6,8,120,6,837
"Ealing","15:00:00","2019-10-17",263,3,11,119,12,408
"Hackney","15:00:00","2019-10-17",206,11,11,36,9,273
"Haringey","15:00:00","2019-10-17",808,7,25,204,17,1061
"Hillingdon","15:00:00","2019-10-17",1032,2,9,154,16,1213
"Richmond upon Thames","15:00:00","2019-10-17",587,18,16,115,8,744
"Westminster","15:00:00","2019-10-17",99,8,15,36,2,160
"Barking and Dagenham","16:00:00","2019-10-17",661,12,15,94,4,786
"Bexley","16:00:00","2019-10-17",1160,14,18,309,64,1565
"Bromley","16:00:00","2019-10-17",765,4,12,128,12,921
"Ealing","16:00:00","2019-10-17",286,5,7,57,12,367
"Hackney","16:00:00","2019-10-17",183,7,14,30,5,239
"Haringey","16:00:00","2019-10-17",833,8,21,177,14,1053
"Hillingdon","16:00:00","2019-10-17",941,8,7,145,12,1113
"Richmond upon Thames","16:00:00","2019-10-17",594,23,18,123,1,759
"Westminster","16:00:00","2019-10-17",89,10,18,23,1,141
"Barking and Dagenham","17:00:00","2019-10-17",688,7,11,84,3,793
"Bexley","17:00:00","2019-10-17",1192,15,14,239,39,1499
"Bromley","17:00:00","2019-10-17",816,9,8,96,4,933
"Ealing","17:00:00","2019-10-17",395,5,10,64,4,478
"Hackney","17:00:00","2019-10-17",143,12,16,23,4,198
"Haringey","17:00:00","2019-10-17",832,18,24,129,12,1015
"Hillingdon","17:00:00","2019-10-17",970,5,2,115,11,1103
"Richmond upon Thames","17:00:00","2019-10-17",578,33,17,67,1,696
"Westminster","17:00:00","2019-10-17",95,19,17,23,0,154
"Barking and Dagenham","18:00:00","2019-10-17",664,7,11,93,3,778
"Bexley","18:00:00","2019-10-17",1026,15,14,217,36,1308
"Bromley","18:00:00","2019-10-17",933,12,14,94,6,1059
"Ealing","18:00:00","2019-10-17",304,5,7,49,0,365
"Hackney","18:00:00","2019-10-17",183,12,9,13,3,220
"Haringey","18:00:00","2019-10-17",809,6,21,129,11,976
"Hillingdon","18:00:00","2019-10-17",1021,5,8,99,2,1135
"Richmond upon Thames","18:00:00","2019-10-17",534,28,19,52,4,637
"Westminster","18:00:00","2019-10-17",114,15,24,14,1,168
"Bromley","07:00:00","2019-10-18",50,0,0,10,0,60
"Croydon","07:00:00","2019-10-18",22,0,0,8,0,30
"Enfield","07:00:00","2019-10-18",4805,108,38,1632,436,7019
"Greenwich","07:00:00","2019-10-18",3649,172,65,1465,365,5716
"Hackney","07:00:00","2019-10-18",1112,102,78,529,180,2001
"Hounslow","07:00:00","2019-10-18",350,5,49,54,7,465
"Kensington and Chelsea","07:00:00","2019-10-18",8,1,0,13,2,24
"Merton","07:00:00","2019-10-18",680,21,43,217,40,1001
"Tower Hamlets","07:00:00","2019-10-18",80,2,0,27,1,110
"Westminster","07:00:00","2019-10-18",1088,169,80,730,184,2251
"Bromley","08:00:00","2019-10-18",71,0,0,9,0,80
"Croydon","08:00:00","2019-10-18",39,0,0,5,0,44
"Enfield","08:00:00","2019-10-18",4491,103,34,1304,480,6412
"Greenwich","08:00:00","2019-10-18",3884,151,38,1110,371,5554
"Hackney","08:00:00","2019-10-18",1266,94,78,471,183,2092
"Hounslow","08:00:00","2019-10-18",566,7,45,48,10,676
"Kensington and Chelsea","08:00:00","2019-10-18",22,2,0,7,1,32
"Merton","08:00:00","2019-10-18",634,43,36,175,53,941
"Tower Hamlets","08:00:00","2019-10-18",153,1,0,25,2,181
"Westminster","08:00:00","2019-10-18",1259,219,72,718,164,2432
"Bromley","09:00:00","2019-10-18",54,0,0,7,0,61
"Croydon","09:00:00","2019-10-18",20,0,0,13,0,33
"Enfield","09:00:00","2019-10-18",4028,62,42,1245,622,5999
"Greenwich","09:00:00","2019-10-18",3185,73,40,1013,438,4749
"Hackney","09:00:00","2019-10-18",1103,72,74,394,135,1778
"Hounslow","09:00:00","2019-10-18",518,10,59,86,12,685
"Kensington and Chelsea","09:00:00","2019-10-18",30,4,0,11,1,46
"Merton","09:00:00","2019-10-18",548,24,40,177,66,855
"Tower Hamlets","09:00:00","2019-10-18",135,5,0,52,2,194
"Westminster","09:00:00","2019-10-18",1333,158,73,706,163,2433
"Bromley","10:00:00","2019-10-18",43,0,0,5,2,50
"Croydon","10:00:00","2019-10-18",17,0,0,5,0,22
"Enfield","10:00:00","2019-10-18",3890,60,43,1338,617,5948
"Greenwich","10:00:00","2019-10-18",2871,41,33,940,439,4324
"Hackney","10:00:00","2019-10-18",1557,85,113,454,203,2412
"Hounslow","10:00:00","2019-10-18",460,7,52,52,7,578
"Kensington and Chelsea","10:00:00","2019-10-18",27,3,0,14,1,45
"Merton","10:00:00","2019-10-18",619,14,31,198,50,912
"Tower Hamlets","10:00:00","2019-10-18",91,0,0,53,1,145
"Westminster","10:00:00","2019-10-18",1227,127,105,777,181,2417
"Bromley","11:00:00","2019-10-18",52,0,0,15,2,69
"Croydon","11:00:00","2019-10-18",17,0,0,6,2,25
"Enfield","11:00:00","2019-10-18",3921,48,43,1238,577,5827
"Greenwich","11:00:00","2019-10-18",3010,24,29,1026,457,4546
"Hackney","11:00:00","2019-10-18",1085,67,65,401,169,1787
"Hounslow","11:00:00","2019-10-18",489,10,46,65,6,616
"Kensington and Chelsea","11:00:00","2019-10-18",29,2,0,16,2,49
"Merton","11:00:00","2019-10-18",665,13,35,189,53,955
"Tower Hamlets","11:00:00","2019-10-18",101,1,0,50,5,157
"Westminster","11:00:00","2019-10-18",1258,153,85,687,189,2372
"Bromley","12:00:00","2019-10-18",48,3,0,15,0,66
"Croydon","12:00:00","2019-10-18",20,0,0,5,0,25
"Enfield","12:00:00","2019-10-18",4268,59,34,1244,520,6125
"Greenwich","12:00:00","2019-10-18",3192,44,20,1040,451,4747
"Hackney","12:00:00","2019-10-18",1226,72,66,395,138,1897
"Hounslow","12:00:00","2019-10-18",487,9,48,65,15,624
"Kensington and Chelsea","12:00:00","2019-10-18",29,4,0,12,1,46
"Merton","12:00:00","2019-10-18",634,21,33,191,47,926
"Tower Hamlets","12:00:00","2019-10-18",148,5,0,44,5,202
"Westminster","12:00:00","2019-10-18",1368,142,100,680,126,2416
"Bromley","13:00:00","2019-10-18",50,0,0,8,0,58
"Croydon","13:00:00","2019-10-18",25,2,0,5,0,32
"Enfield","13:00:00","2019-10-18",4196,68,34,1355,490,6143
"Greenwich","13:00:00","2019-10-18",3301,48,15,1167,441,4972
"Hackney","13:00:00","2019-10-18",1195,125,114,403,182,2019
"Hounslow","13:00:00","2019-10-18",558,18,45,64,15,700
"Kensington and Chelsea","13:00:00","2019-10-18",35,6,0,14,1,56
"Merton","13:00:00","2019-10-18",763,35,34,164,27,1023
"Tower Hamlets","13:00:00","2019-10-18",134,4,0,32,0,170
"Westminster","13:00:00","2019-10-18",1445,143,77,728,130,2523
"Bromley","14:00:00","2019-10-18",44,0,0,4,1,49
"Croydon","14:00:00","2019-10-18",22,0,0,2,0,24
"Enfield","14:00:00","2019-10-18",4412,70,53,1333,456,6324
"Greenwich","14:00:00","2019-10-18",3622,43,27,1313,392,5397
"Hackney","14:00:00","2019-10-18",1245,78,65,424,132,1944
"Hounslow","14:00:00","2019-10-18",615,18,48,56,6,743
"Kensington and Chelsea","14:00:00","2019-10-18",29,4,0,14,0,47
"Merton","14:00:00","2019-10-18",685,44,38,174,26,967
"Tower Hamlets","14:00:00","2019-10-18",149,11,0,34,0,194
"Westminster","14:00:00","2019-10-18",1575,171,92,726,145,2709
"Bromley","15:00:00","2019-10-18",65,0,0,6,1,72
"Croydon","15:00:00","2019-10-18",21,0,0,4,1,26
"Enfield","15:00:00","2019-10-18",4549,95,38,1199,350,6231
"Greenwich","15:00:00","2019-10-18",3727,66,21,1374,304,5492
"Hackney","15:00:00","2019-10-18",1357,105,68,391,103,2024
"Hounslow","15:00:00","2019-10-18",622,21,47,66,13,769
"Kensington and Chelsea","15:00:00","2019-10-18",33,4,0,14,1,52
"Merton","15:00:00","2019-10-18",584,33,35,150,24,826
"Tower Hamlets","15:00:00","2019-10-18",222,13,0,43,3,281
"Westminster","15:00:00","2019-10-18",1503,186,74,646,128,2537
"Bromley","16:00:00","2019-10-18",72,0,0,6,0,78
"Croydon","16:00:00","2019-10-18",26,1,0,5,2,34
"Enfield","16:00:00","2019-10-18",5105,114,43,1167,255,6684
"Greenwich","16:00:00","2019-10-18",3510,123,28,1012,183,4856
"Hackney","16:00:00","2019-10-18",1534,142,80,362,82,2200
"Hounslow","16:00:00","2019-10-18",686,22,53,69,9,839
"Kensington and Chelsea","16:00:00","2019-10-18",34,8,0,8,0,50
"Merton","16:00:00","2019-10-18",711,44,36,137,18,946
"Tower Hamlets","16:00:00","2019-10-18",215,9,0,36,0,260
"Westminster","16:00:00","2019-10-18",1657,246,69,520,82,2574
"Bromley","17:00:00","2019-10-18",75,3,0,7,0,85
"Croydon","17:00:00","2019-10-18",37,2,0,3,0,42
"Enfield","17:00:00","2019-10-18",5508,150,37,1061,191,6947
"Greenwich","17:00:00","2019-10-18",4473,184,38,942,185,5822
"Hackney","17:00:00","2019-10-18",1577,154,75,293,65,2164
"Hounslow","17:00:00","2019-10-18",724,18,50,58,4,854
"Kensington and Chelsea","17:00:00","2019-10-18",29,10,0,3,0,42
"Merton","17:00:00","2019-10-18",798,50,32,97,8,985
"Tower Hamlets","17:00:00","2019-10-18",211,7,0,30,0,248
"Westminster","17:00:00","2019-10-18",1813,344,94,393,66,2710
"Bromley","18:00:00","2019-10-18",73,2,0,4,0,79
"Croydon","18:00:00","2019-10-18",28,1,0,1,0,30
"Enfield","18:00:00","2019-10-18",5642,125,30,797,162,6756
"Greenwich","18:00:00","2019-10-18",4308,146,60,586,118,5218
"Hackney","18:00:00","2019-10-18",1639,90,74,232,50,2085
"Hounslow","18:00:00","2019-10-18",654,17,50,40,1,762
"Kensington and Chelsea","18:00:00","2019-10-18",24,5,0,5,0,34
"Merton","18:00:00","2019-10-18",930,67,30,68,9,1104
"Tower Hamlets","18:00:00","2019-10-18",253,9,0,26,0,288
"Westminster","18:00:00","2019-10-18",2057,333,79,318,56,2843
"Bromley","07:00:00","2019-11-04",889,12,20,175,9,1105
"Ealing","07:00:00","2019-11-04",1446,80,27,441,155,2149
"Bromley","08:00:00","2019-11-04",804,4,16,147,11,982
"Ealing","08:00:00","2019-11-04",1523,44,34,374,149,2124
"Bromley","09:00:00","2019-11-04",764,2,15,144,12,937
"Ealing","09:00:00","2019-11-04",1471,38,34,391,167,2101
"Bromley","10:00:00","2019-11-04",701,2,19,106,17,845
"Ealing","10:00:00","2019-11-04",1480,25,29,417,208,2159
"Bromley","11:00:00","2019-11-04",607,2,14,96,11,730
"Ealing","11:00:00","2019-11-04",1562,29,26,489,192,2298
"Bromley","12:00:00","2019-11-04",626,3,18,124,6,777
"Ealing","12:00:00","2019-11-04",1451,41,30,419,170,2111
"Bromley","13:00:00","2019-11-04",625,4,17,96,13,755
"Ealing","13:00:00","2019-11-04",1434,30,25,455,171,2115
"Bromley","14:00:00","2019-11-04",657,3,20,118,8,806
"Ealing","14:00:00","2019-11-04",1185,39,34,457,161,1876
"Bromley","15:00:00","2019-11-04",726,2,14,125,7,874
"Ealing","15:00:00","2019-11-04",1395,43,33,383,127,1981
"Bromley","16:00:00","2019-11-04",880,6,20,152,5,1063
"Ealing","16:00:00","2019-11-04",1534,46,29,366,138,2113
"Bromley","17:00:00","2019-11-04",1017,6,14,105,0,1142
"Ealing","17:00:00","2019-11-04",1541,69,26,282,93,2011
"Bromley","18:00:00","2019-11-04",884,3,16,70,1,974
"Ealing","18:00:00","2019-11-04",1684,54,28,261,66,2093
"Southwark","07:00:00","2019-11-05",514,23,41,138,13,729
"Southwark","08:00:00","2019-11-05",677,41,29,121,23,891
"Southwark","09:00:00","2019-11-05",593,15,36,105,22,771
"Southwark","10:00:00","2019-11-05",550,14,32,133,10,739
"Southwark","11:00:00","2019-11-05",576,23,35,100,20,754
"Southwark","12:00:00","2019-11-05",471,19,25,127,14,656
"Southwark","13:00:00","2019-11-05",468,21,40,123,14,666
"Southwark","14:00:00","2019-11-05",482,22,35,128,9,676
"Southwark","15:00:00","2019-11-05",588,19,34,151,4,796
"Southwark","16:00:00","2019-11-05",708,29,30,145,4,916
"Southwark","17:00:00","2019-11-05",745,33,24,113,2,917
"Southwark","18:00:00","2019-11-05",679,37,46,83,1,846
"Newham","07:00:00","2019-11-06",378,10,24,63,16,491
"Newham","08:00:00","2019-11-06",582,4,22,68,22,698
"Newham","09:00:00","2019-11-06",463,3,25,59,29,579
"Newham","10:00:00","2019-11-06",418,2,28,88,30,566
"Waltham Forest","10:00:00","2019-11-06",4756,39,15,1645,709,7164
"Newham","11:00:00","2019-11-06",369,7,22,77,36,511
"Waltham Forest","11:00:00","2019-11-06",4323,44,8,1514,661,6550
"Newham","12:00:00","2019-11-06",385,9,23,85,29,531
"Waltham Forest","12:00:00","2019-11-06",4389,36,7,1448,599,6479
"Newham","13:00:00","2019-11-06",412,10,22,60,34,538
"Waltham Forest","13:00:00","2019-11-06",4420,52,14,1413,521,6420
"Newham","14:00:00","2019-11-06",448,4,23,101,30,606
"Newham","15:00:00","2019-11-06",685,8,21,99,31,844
"Newham","16:00:00","2019-11-06",648,10,20,88,16,782
"Newham","17:00:00","2019-11-06",745,18,21,70,11,865
"Newham","18:00:00","2019-11-06",666,9,17,47,4,743
"Hounslow","07:00:00","2019-11-07",584,31,52,149,27,843
"Hounslow","08:00:00","2019-11-07",773,37,50,180,31,1071
"Hounslow","09:00:00","2019-11-07",821,39,60,198,27,1145
"Hounslow","10:00:00","2019-11-07",694,24,54,145,32,949
"Hounslow","11:00:00","2019-11-07",742,34,50,187,33,1046
"Hounslow","12:00:00","2019-11-07",711,51,48,175,28,1013
"Hounslow","13:00:00","2019-11-07",625,36,48,167,34,910
"Hounslow","14:00:00","2019-11-07",642,55,51,169,28,945
"Hounslow","15:00:00","2019-11-07",758,52,49,151,20,1030
"Hounslow","16:00:00","2019-11-07",859,47,55,139,26,1126
"Hounslow","17:00:00","2019-11-07",899,75,47,108,19,1148
"Hounslow","18:00:00","2019-11-07",1028,43,52,85,16,1224
"Hammersmith and Fulham","07:00:00","2020-03-23",337,14,52,144,19,566
"Lambeth","07:00:00","2020-03-23",664,26,13,259,30,992
"Hammersmith and Fulham","08:00:00","2020-03-23",334,31,68,96,27,556
"Lambeth","08:00:00","2020-03-23",579,23,18,204,46,870
"Hammersmith and Fulham","09:00:00","2020-03-23",292,29,66,106,29,522
"Lambeth","09:00:00","2020-03-23",484,14,12,150,40,700
"Hammersmith and Fulham","10:00:00","2020-03-23",268,20,65,110,29,492
"Lambeth","10:00:00","2020-03-23",459,15,14,175,45,708
"Hammersmith and Fulham","11:00:00","2020-03-23",271,21,62,108,18,480
"Lambeth","11:00:00","2020-03-23",462,6,13,179,44,704
"Hammersmith and Fulham","12:00:00","2020-03-23",307,36,60,107,21,531
"Lambeth","12:00:00","2020-03-23",481,22,13,136,36,688
"Hammersmith and Fulham","13:00:00","2020-03-23",344,65,62,108,11,590
"Lambeth","13:00:00","2020-03-23",517,22,15,155,44,753
"Hammersmith and Fulham","14:00:00","2020-03-23",319,41,65,98,7,530
"Lambeth","14:00:00","2020-03-23",590,25,13,152,29,809
"Hammersmith and Fulham","15:00:00","2020-03-23",367,51,61,100,17,596
"Lambeth","15:00:00","2020-03-23",620,24,13,155,30,842
"Hammersmith and Fulham","16:00:00","2020-03-23",371,53,63,98,6,591
"Lambeth","16:00:00","2020-03-23",670,26,13,159,25,893
"Hammersmith and Fulham","17:00:00","2020-03-23",396,80,61,62,10,609
"Lambeth","17:00:00","2020-03-23",697,30,12,115,4,858
"Hammersmith and Fulham","18:00:00","2020-03-23",346,69,63,32,8,518
"Lambeth","18:00:00","2020-03-23",595,19,14,103,11,742
"Barnet","07:00:00","2020-04-20",547,16,44,206,34,847
"Camden","07:00:00","2020-04-20",631,41,42,198,42,954
"Ealing","07:00:00","2020-04-20",3080,82,4,1332,404,4902
"Enfield","07:00:00","2020-04-20",1191,23,10,517,144,1885
"Havering","07:00:00","2020-04-20",1239,11,140,305,79,1774
"Kensington and Chelsea","07:00:00","2020-04-20",709,41,36,256,53,1095
"Barnet","08:00:00","2020-04-20",632,14,45,184,39,914
"Camden","08:00:00","2020-04-20",568,39,43,209,52,911
"Ealing","08:00:00","2020-04-20",2730,57,13,1043,485,4328
"Enfield","08:00:00","2020-04-20",1143,9,14,385,151,1702
"Havering","08:00:00","2020-04-20",1501,13,184,311,91,2100
"Kensington and Chelsea","08:00:00","2020-04-20",639,23,45,229,65,1001
"Barnet","09:00:00","2020-04-20",621,12,60,185,38,916
"Camden","09:00:00","2020-04-20",415,30,51,168,53,717
"Ealing","09:00:00","2020-04-20",2145,36,11,901,523,3616
"Enfield","09:00:00","2020-04-20",1043,17,14,359,156,1589
"Hackney","09:00:00","2020-04-20",1508,27,7,657,208,2407
"Havering","09:00:00","2020-04-20",1278,13,185,323,90,1889
"Kensington and Chelsea","09:00:00","2020-04-20",446,30,45,193,52,766
"Barnet","10:00:00","2020-04-20",619,19,47,167,52,904
"Camden","10:00:00","2020-04-20",338,34,46,163,50,631
"Ealing","10:00:00","2020-04-20",2026,45,4,982,524,3581
"Enfield","10:00:00","2020-04-20",1141,9,14,384,154,1702
"Hackney","10:00:00","2020-04-20",1381,32,6,615,202,2236
"Havering","10:00:00","2020-04-20",1512,18,189,359,97,2175
"Kensington and Chelsea","10:00:00","2020-04-20",415,36,43,173,44,711
"Barnet","11:00:00","2020-04-20",686,12,49,218,39,1004
"Camden","11:00:00","2020-04-20",318,44,47,163,54,626
"Ealing","11:00:00","2020-04-20",2156,48,5,915,534,3658
"Enfield","11:00:00","2020-04-20",1271,21,14,326,132,1764
"Hackney","11:00:00","2020-04-20",1483,35,2,594,187,2301
"Havering","11:00:00","2020-04-20",1733,18,174,355,97,2377
"Kensington and Chelsea","11:00:00","2020-04-20",393,34,40,185,47,699
"Barnet","12:00:00","2020-04-20",784,23,43,156,45,1051
"Camden","12:00:00","2020-04-20",353,68,41,179,46,687
"Ealing","12:00:00","2020-04-20",2530,47,3,956,502,4038
"Enfield","12:00:00","2020-04-20",1439,18,13,376,139,1985
"Hackney","12:00:00","2020-04-20",1684,46,2,630,181,2543
"Havering","12:00:00","2020-04-20",1866,42,194,363,79,2544
"Kensington and Chelsea","12:00:00","2020-04-20",414,59,40,159,39,711
"Barnet","13:00:00","2020-04-20",860,35,43,152,39,1129
"Camden","13:00:00","2020-04-20",389,69,40,174,44,716
"Ealing","13:00:00","2020-04-20",2717,65,6,1043,478,4309
"Enfield","13:00:00","2020-04-20",1675,38,12,366,116,2207
"Hackney","13:00:00","2020-04-20",1900,53,3,635,174,2765
"Havering","13:00:00","2020-04-20",2022,31,188,305,76,2622
"Kensington and Chelsea","13:00:00","2020-04-20",464,63,41,149,40,757
"Barnet","14:00:00","2020-04-20",945,24,45,177,40,1231
"Camden","14:00:00","2020-04-20",399,75,44,141,29,688
"Ealing","14:00:00","2020-04-20",3068,73,7,1025,455,4628
"Enfield","14:00:00","2020-04-20",1622,55,12,390,103,2182
"Hackney","14:00:00","2020-04-20",2101,47,2,668,158,2976
"Havering","14:00:00","2020-04-20",1930,42,180,344,88,2584
"Kensington and Chelsea","14:00:00","2020-04-20",478,60,38,145,23,744
"Barnet","15:00:00","2020-04-20",926,30,48,170,35,1209
"Camden","15:00:00","2020-04-20",398,82,40,179,27,726
"Ealing","15:00:00","2020-04-20",3302,81,3,1085,374,4845
"Enfield","15:00:00","2020-04-20",1723,46,15,419,100,2303
"Havering","15:00:00","2020-04-20",1857,31,187,329,73,2477
"Kensington and Chelsea","15:00:00","2020-04-20",549,63,40,172,24,848
"Barnet","16:00:00","2020-04-20",1009,44,43,160,24,1280
"Camden","16:00:00","2020-04-20",520,64,43,150,17,794
"Ealing","16:00:00","2020-04-20",3943,97,3,1069,271,5383
"Enfield","16:00:00","2020-04-20",1800,47,12,415,69,2343
"Havering","16:00:00","2020-04-20",1908,36,191,330,45,2510
"Kensington and Chelsea","16:00:00","2020-04-20",589,48,41,136,14,828
"Barnet","17:00:00","2020-04-20",986,41,48,126,16,1217
"Camden","17:00:00","2020-04-20",397,72,25,71,14,579
"Ealing","17:00:00","2020-04-20",4108,104,3,878,198,5291
"Enfield","17:00:00","2020-04-20",1687,50,11,297,62,2107
"Havering","17:00:00","2020-04-20",1810,46,178,208,36,2278
"Kensington and Chelsea","17:00:00","2020-04-20",671,52,40,91,9,863
"Barnet","18:00:00","2020-04-20",833,43,45,88,9,1018
"Camden","18:00:00","2020-04-20",274,44,2,25,5,350
"Ealing","18:00:00","2020-04-20",3281,74,10,506,144,4015
"Enfield","18:00:00","2020-04-20",1525,43,14,179,62,1823
"Hackney","18:00:00","2020-04-20",2436,54,6,358,46,2900
"Havering","18:00:00","2020-04-20",1509,43,171,157,46,1926
"Kensington and Chelsea","18:00:00","2020-04-20",639,56,42,58,11,806
"Enfield","07:00:00","2020-04-21",295,8,23,85,13,424
"Greenwich","07:00:00","2020-04-21",662,23,24,255,98,1062
"Hammersmith and Fulham","07:00:00","2020-04-21",1862,102,7,758,150,2879
"Hounslow","07:00:00","2020-04-21",209,2,37,83,26,357
"Wandsworth","07:00:00","2020-04-21",974,63,29,452,89,1607
"Enfield","08:00:00","2020-04-21",318,7,28,59,18,430
"Greenwich","08:00:00","2020-04-21",606,8,32,242,138,1026
"Hammersmith and Fulham","08:00:00","2020-04-21",1536,58,4,685,140,2423
"Hounslow","08:00:00","2020-04-21",270,8,44,69,26,417
"Wandsworth","08:00:00","2020-04-21",883,45,29,340,109,1406
"Enfield","09:00:00","2020-04-21",310,8,30,66,13,427
"Greenwich","09:00:00","2020-04-21",525,16,39,262,135,977
"Hammersmith and Fulham","09:00:00","2020-04-21",1227,60,5,500,190,1982
"Hounslow","09:00:00","2020-04-21",233,1,43,65,30,372
"Wandsworth","09:00:00","2020-04-21",698,40,31,320,100,1189
"Enfield","10:00:00","2020-04-21",374,9,30,73,19,505
"Greenwich","10:00:00","2020-04-21",532,10,34,288,153,1017
"Hammersmith and Fulham","10:00:00","2020-04-21",1023,65,4,478,147,1717
"Hounslow","10:00:00","2020-04-21",307,5,38,79,30,459
"Wandsworth","10:00:00","2020-04-21",648,60,30,272,112,1122
"Enfield","11:00:00","2020-04-21",429,12,30,72,15,558
"Greenwich","11:00:00","2020-04-21",592,13,36,272,129,1042
"Hammersmith and Fulham","11:00:00","2020-04-21",1069,64,0,448,137,1718
"Hounslow","11:00:00","2020-04-21",367,7,40,91,30,535
"Wandsworth","11:00:00","2020-04-21",724,58,28,287,108,1205
"Enfield","12:00:00","2020-04-21",488,19,27,75,11,620
"Greenwich","12:00:00","2020-04-21",712,26,35,216,102,1091
"Hammersmith and Fulham","12:00:00","2020-04-21",1117,76,5,433,119,1750
"Hounslow","12:00:00","2020-04-21",447,16,40,78,25,606
"Wandsworth","12:00:00","2020-04-21",781,78,28,303,85,1275
"Enfield","13:00:00","2020-04-21",446,11,31,69,10,567
"Greenwich","13:00:00","2020-04-21",740,34,36,192,108,1110
"Hammersmith and Fulham","13:00:00","2020-04-21",1309,94,2,416,117,1938
"Hounslow","13:00:00","2020-04-21",485,23,38,76,18,640
"Wandsworth","13:00:00","2020-04-21",751,76,27,286,91,1231
"Enfield","14:00:00","2020-04-21",485,13,31,75,10,614
"Greenwich","14:00:00","2020-04-21",779,19,31,190,120,1139
"Hammersmith and Fulham","14:00:00","2020-04-21",1277,107,1,425,92,1902
"Hounslow","14:00:00","2020-04-21",496,24,38,68,10,636
"Wandsworth","14:00:00","2020-04-21",777,95,29,284,76,1261
"Enfield","15:00:00","2020-04-21",570,14,30,88,7,709
"Greenwich","15:00:00","2020-04-21",800,27,33,198,92,1150
"Hammersmith and Fulham","15:00:00","2020-04-21",1534,89,2,493,74,2192
"Hounslow","15:00:00","2020-04-21",493,17,39,79,20,648
"Wandsworth","15:00:00","2020-04-21",893,103,29,302,44,1371
"Enfield","16:00:00","2020-04-21",509,16,30,73,9,637
"Greenwich","16:00:00","2020-04-21",971,29,34,203,63,1300
"Hammersmith and Fulham","16:00:00","2020-04-21",1652,122,5,469,56,2304
"Hounslow","16:00:00","2020-04-21",468,22,38,83,16,627
"Wandsworth","16:00:00","2020-04-21",932,105,27,291,21,1376
"Enfield","17:00:00","2020-04-21",486,16,24,73,3,602
"Greenwich","17:00:00","2020-04-21",931,41,33,140,33,1178
"Hammersmith and Fulham","17:00:00","2020-04-21",1755,112,0,313,37,2217
"Hounslow","17:00:00","2020-04-21",460,36,38,70,6,610
"Wandsworth","17:00:00","2020-04-21",1164,97,28,257,26,1572
"Enfield","18:00:00","2020-04-21",424,18,24,37,3,506
"Greenwich","18:00:00","2020-04-21",897,27,33,88,24,1069
"Hammersmith and Fulham","18:00:00","2020-04-21",1605,107,1,206,34,1953
"Hounslow","18:00:00","2020-04-21",419,22,37,53,7,538
"Wandsworth","18:00:00","2020-04-21",1040,102,28,154,13,1337
"Bexley","07:00:00","2020-04-22",637,8,16,242,88,991
"Brent","07:00:00","2020-04-22",3163,85,2,1626,424,5300
"Ealing","07:00:00","2020-04-22",2447,122,22,1032,220,3843
"Greenwich","07:00:00","2020-04-22",1023,33,122,264,140,1582
"Havering","07:00:00","2020-04-22",1788,23,1,1609,1559,4980
"Lambeth","07:00:00","2020-04-22",311,36,107,130,21,605
"Redbridge","07:00:00","2020-04-22",541,9,17,155,19,741
"Bexley","08:00:00","2020-04-22",723,4,16,240,64,1047
"Brent","08:00:00","2020-04-22",2530,47,11,1363,475,4426
"Ealing","08:00:00","2020-04-22",2077,65,19,786,277,3224
"Greenwich","08:00:00","2020-04-22",974,12,145,299,138,1568
"Havering","08:00:00","2020-04-22",1437,13,1,1041,1340,3832
"Lambeth","08:00:00","2020-04-22",295,25,113,106,33,572
"Redbridge","08:00:00","2020-04-22",623,10,22,171,30,856
"Bexley","09:00:00","2020-04-22",662,5,13,215,64,959
"Brent","09:00:00","2020-04-22",2181,38,10,1166,497,3892
"Ealing","09:00:00","2020-04-22",1725,53,25,759,289,2851
"Greenwich","09:00:00","2020-04-22",788,15,159,374,133,1469
"Havering","09:00:00","2020-04-22",1140,11,0,830,1357,3338
"Lambeth","09:00:00","2020-04-22",196,12,118,73,18,417
"Redbridge","09:00:00","2020-04-22",594,7,30,162,40,833
"Bexley","10:00:00","2020-04-22",823,7,16,221,63,1130
"Brent","10:00:00","2020-04-22",2019,52,5,1103,536,3715
"Ealing","10:00:00","2020-04-22",1506,58,26,753,322,2665
"Greenwich","10:00:00","2020-04-22",735,22,145,379,148,1429
"Havering","10:00:00","2020-04-22",1088,13,2,754,1434,3291
"Lambeth","10:00:00","2020-04-22",188,17,111,60,21,397
"Redbridge","10:00:00","2020-04-22",613,10,29,154,38,844
"Bexley","11:00:00","2020-04-22",876,5,10,229,52,1172
"Brent","11:00:00","2020-04-22",2270,58,3,1019,495,3845
"Ealing","11:00:00","2020-04-22",1605,75,23,706,291,2700
"Greenwich","11:00:00","2020-04-22",871,17,149,374,160,1571
"Havering","11:00:00","2020-04-22",1191,15,1,810,1425,3442
"Lambeth","11:00:00","2020-04-22",153,18,110,71,20,372
"Redbridge","11:00:00","2020-04-22",702,14,31,190,36,973
"Bexley","12:00:00","2020-04-22",950,12,9,234,73,1278
"Brent","12:00:00","2020-04-22",2653,76,4,1022,506,4261
"Ealing","12:00:00","2020-04-22",1759,78,20,631,258,2746
"Greenwich","12:00:00","2020-04-22",972,15,143,259,143,1532
"Havering","12:00:00","2020-04-22",1300,18,1,817,1504,3640
"Lambeth","12:00:00","2020-04-22",192,27,108,75,10,412
"Redbridge","12:00:00","2020-04-22",795,18,28,174,35,1050
"Bexley","13:00:00","2020-04-22",1029,12,9,225,76,1351
"Brent","13:00:00","2020-04-22",2786,64,4,1017,468,4339
"Ealing","13:00:00","2020-04-22",1915,89,21,682,278,2985
"Greenwich","13:00:00","2020-04-22",1052,28,138,236,125,1579
"Havering","13:00:00","2020-04-22",1452,12,2,821,1529,3816
"Lambeth","13:00:00","2020-04-22",184,37,105,79,16,421
"Redbridge","13:00:00","2020-04-22",858,20,25,162,30,1095
"Bexley","14:00:00","2020-04-22",1005,8,11,214,61,1299
"Brent","14:00:00","2020-04-22",3096,79,2,1125,431,4733
"Ealing","14:00:00","2020-04-22",2098,91,22,715,224,3150
"Greenwich","14:00:00","2020-04-22",1083,27,143,221,135,1609
"Havering","14:00:00","2020-04-22",1530,13,2,963,1435,3943
"Lambeth","14:00:00","2020-04-22",183,36,100,84,14,417
"Redbridge","14:00:00","2020-04-22",1012,24,30,187,21,1274
"Bexley","15:00:00","2020-04-22",1027,12,10,224,32,1305
"Brent","15:00:00","2020-04-22",3378,81,1,1134,382,4976
"Ealing","15:00:00","2020-04-22",2392,102,21,727,181,3423
"Greenwich","15:00:00","2020-04-22",1172,36,139,264,137,1748
"Havering","15:00:00","2020-04-22",1696,23,3,1178,1423,4323
"Lambeth","15:00:00","2020-04-22",239,39,106,95,19,498
"Redbridge","15:00:00","2020-04-22",996,28,24,174,15,1237
"Bexley","16:00:00","2020-04-22",972,17,11,189,27,1216
"Brent","16:00:00","2020-04-22",4036,111,1,1178,248,5574
"Ealing","16:00:00","2020-04-22",2820,119,25,747,115,3826
"Greenwich","16:00:00","2020-04-22",1243,43,148,219,66,1719
"Havering","16:00:00","2020-04-22",1968,14,0,1211,1079,4272
"Lambeth","16:00:00","2020-04-22",276,30,104,77,5,492
"Redbridge","16:00:00","2020-04-22",1067,38,28,164,18,1315
"Bexley","17:00:00","2020-04-22",984,18,9,139,22,1172
"Brent","17:00:00","2020-04-22",4273,103,5,1090,186,5657
"Ealing","17:00:00","2020-04-22",3076,116,18,601,97,3908
"Greenwich","17:00:00","2020-04-22",1309,52,148,166,47,1722
"Havering","17:00:00","2020-04-22",2164,24,3,860,1120,4171
"Lambeth","17:00:00","2020-04-22",279,39,108,54,7,487
"Redbridge","17:00:00","2020-04-22",1122,37,26,163,17,1365
"Bexley","18:00:00","2020-04-22",710,5,12,78,13,818
"Brent","18:00:00","2020-04-22",3355,94,3,606,143,4201
"Ealing","18:00:00","2020-04-22",2468,104,17,319,70,2978
"Greenwich","18:00:00","2020-04-22",1252,44,144,127,59,1626
"Havering","18:00:00","2020-04-22",1600,17,0,481,830,2928
"Lambeth","18:00:00","2020-04-22",300,36,112,31,8,487
"Redbridge","18:00:00","2020-04-22",1056,43,27,96,10,1232
"Bromley","07:00:00","2020-04-23",684,11,9,348,80,1132
"Croydon","07:00:00","2020-04-23",600,13,47,260,52,972
"Hillingdon","07:00:00","2020-04-23",642,10,0,266,297,1215
"Redbridge","07:00:00","2020-04-23",2950,41,5,1304,449,4749
"Tower Hamlets","07:00:00","2020-04-23",1964,116,10,738,176,3004
"Bromley","08:00:00","2020-04-23",658,8,11,241,102,1020
"Croydon","08:00:00","2020-04-23",569,13,47,195,42,866
"Hillingdon","08:00:00","2020-04-23",576,6,2,272,267,1123
"Redbridge","08:00:00","2020-04-23",2499,22,18,994,513,4046
"Tower Hamlets","08:00:00","2020-04-23",1914,55,10,831,240,3050
"Bromley","09:00:00","2020-04-23",504,6,10,201,113,834
"Croydon","09:00:00","2020-04-23",486,14,42,210,35,787
"Hillingdon","09:00:00","2020-04-23",467,14,4,268,252,1005
"Redbridge","09:00:00","2020-04-23",2029,18,8,863,555,3473
"Tower Hamlets","09:00:00","2020-04-23",1360,64,18,665,284,2391
"Bromley","10:00:00","2020-04-23",506,9,6,200,92,813
"Croydon","10:00:00","2020-04-23",561,21,41,191,48,862
"Hillingdon","10:00:00","2020-04-23",381,4,2,244,263,894
"Redbridge","10:00:00","2020-04-23",1950,25,9,814,557,3355
"Tower Hamlets","10:00:00","2020-04-23",1109,64,8,628,273,2082
"Bromley","11:00:00","2020-04-23",525,9,4,215,91,844
"Croydon","11:00:00","2020-04-23",640,14,37,202,52,945
"Hillingdon","11:00:00","2020-04-23",502,2,0,221,293,1018
"Redbridge","11:00:00","2020-04-23",2102,31,6,864,537,3540
"Tower Hamlets","11:00:00","2020-04-23",1142,70,16,655,230,2113
"Bromley","12:00:00","2020-04-23",651,7,6,199,82,945
"Croydon","12:00:00","2020-04-23",659,26,38,165,50,938
"Hillingdon","12:00:00","2020-04-23",585,22,0,194,228,1029
"Redbridge","12:00:00","2020-04-23",2458,21,6,856,494,3835
"Tower Hamlets","12:00:00","2020-04-23",1392,114,8,680,206,2400
"Bromley","13:00:00","2020-04-23",670,7,5,215,66,963
"Croydon","13:00:00","2020-04-23",812,36,38,181,39,1106
"Hillingdon","13:00:00","2020-04-23",701,24,0,231,267,1223
"Redbridge","13:00:00","2020-04-23",2811,36,10,850,469,4176
"Tower Hamlets","13:00:00","2020-04-23",1528,109,9,668,179,2493
"Bromley","14:00:00","2020-04-23",687,14,5,213,77,996
"Croydon","14:00:00","2020-04-23",763,25,36,185,44,1053
"Hillingdon","14:00:00","2020-04-23",753,6,0,295,233,1287
"Redbridge","14:00:00","2020-04-23",3068,53,2,871,461,4455
"Tower Hamlets","14:00:00","2020-04-23",1749,120,8,703,165,2745
"Bromley","15:00:00","2020-04-23",715,15,6,268,50,1054
"Croydon","15:00:00","2020-04-23",783,41,38,217,24,1103
"Hillingdon","15:00:00","2020-04-23",702,18,0,233,237,1190
"Redbridge","15:00:00","2020-04-23",3329,44,4,974,420,4771
"Tower Hamlets","15:00:00","2020-04-23",1978,130,8,772,125,3013
"Bromley","16:00:00","2020-04-23",759,15,4,243,33,1054
"Croydon","16:00:00","2020-04-23",914,45,38,190,20,1207
"Hillingdon","16:00:00","2020-04-23",724,24,0,255,177,1180
"Redbridge","16:00:00","2020-04-23",3896,44,1,972,310,5223
"Tower Hamlets","16:00:00","2020-04-23",2172,144,7,717,80,3120
"Bromley","17:00:00","2020-04-23",790,17,6,164,31,1008
"Croydon","17:00:00","2020-04-23",906,38,43,157,14,1158
"Hillingdon","17:00:00","2020-04-23",809,22,2,202,178,1213
"Redbridge","17:00:00","2020-04-23",4157,53,1,817,191,5219
"Tower Hamlets","17:00:00","2020-04-23",2641,163,8,478,56,3346
"Bromley","18:00:00","2020-04-23",640,13,8,104,15,780
"Croydon","18:00:00","2020-04-23",804,48,38,101,15,1006
"Hillingdon","18:00:00","2020-04-23",772,20,2,130,123,1047
"Redbridge","18:00:00","2020-04-23",3767,43,3,577,154,4544
"Tower Hamlets","18:00:00","2020-04-23",2595,149,11,276,38,3069
"Lambeth","07:00:00","2020-04-24",692,43,128,243,41,1147
"Lewisham","07:00:00","2020-04-24",429,17,17,127,34,624
"Southwark","07:00:00","2020-04-24",571,36,37,231,65,940
"Tower Hamlets","07:00:00","2020-04-24",2958,105,17,1372,263,4715
"Lambeth","08:00:00","2020-04-24",511,39,147,164,38,899
"Lewisham","08:00:00","2020-04-24",439,5,17,105,33,599
"Southwark","08:00:00","2020-04-24",521,26,39,184,59,829
"Tower Hamlets","08:00:00","2020-04-24",2397,45,25,1160,278,3905
"Lambeth","09:00:00","2020-04-24",389,25,142,171,46,773
"Lewisham","09:00:00","2020-04-24",421,13,22,110,26,592
"Southwark","09:00:00","2020-04-24",401,24,50,217,63,755
"Tower Hamlets","09:00:00","2020-04-24",1808,52,22,997,304,3183
"Lambeth","10:00:00","2020-04-24",311,33,143,181,37,705
"Lewisham","10:00:00","2020-04-24",405,11,21,108,24,569
"Southwark","10:00:00","2020-04-24",372,27,40,163,58,660
"Tower Hamlets","10:00:00","2020-04-24",1868,48,17,932,281,3146
"Lambeth","11:00:00","2020-04-24",327,60,141,148,32,708
"Lewisham","11:00:00","2020-04-24",548,15,17,121,27,728
"Southwark","11:00:00","2020-04-24",429,35,38,145,50,697
"Tower Hamlets","11:00:00","2020-04-24",1961,68,18,856,293,3196
"Lambeth","12:00:00","2020-04-24",391,78,133,157,30,789
"Lewisham","12:00:00","2020-04-24",550,37,19,121,29,756
"Southwark","12:00:00","2020-04-24",438,43,35,160,45,721
"Tower Hamlets","12:00:00","2020-04-24",2275,71,13,850,238,3447
"Lambeth","13:00:00","2020-04-24",426,71,136,160,23,816
"Lewisham","13:00:00","2020-04-24",604,12,17,120,32,785
"Southwark","13:00:00","2020-04-24",496,37,36,147,30,746
"Tower Hamlets","13:00:00","2020-04-24",2588,84,15,911,207,3805
"Lambeth","14:00:00","2020-04-24",439,76,133,157,33,838
"Lewisham","14:00:00","2020-04-24",661,25,18,127,29,860
"Southwark","14:00:00","2020-04-24",553,43,33,154,43,826
"Tower Hamlets","14:00:00","2020-04-24",2874,89,13,895,211,4082
"Lambeth","15:00:00","2020-04-24",480,79,128,178,29,894
"Lewisham","15:00:00","2020-04-24",698,25,20,133,13,889
"Southwark","15:00:00","2020-04-24",582,45,35,150,22,834
"Tower Hamlets","15:00:00","2020-04-24",3142,115,16,923,153,4349
"Lambeth","16:00:00","2020-04-24",605,83,127,141,17,973
"Lewisham","16:00:00","2020-04-24",698,28,19,79,13,837
"Southwark","16:00:00","2020-04-24",625,80,34,124,14,877
"Tower Hamlets","16:00:00","2020-04-24",3557,120,12,814,96,4599
"Lambeth","17:00:00","2020-04-24",640,83,141,78,15,957
"Lewisham","17:00:00","2020-04-24",737,52,19,90,12,910
"Southwark","17:00:00","2020-04-24",675,74,31,94,12,886
"Tower Hamlets","17:00:00","2020-04-24",3747,114,14,677,91,4643
"Lambeth","18:00:00","2020-04-24",680,85,127,50,12,954
"Lewisham","18:00:00","2020-04-24",650,74,20,40,7,791
"Southwark","18:00:00","2020-04-24",699,66,35,70,14,884
"Tower Hamlets","18:00:00","2020-04-24",3401,108,20,474,74,4077
"Camden","07:00:00","2020-04-27",266,22,55,135,30,508
"Kensington and Chelsea","07:00:00","2020-04-27",787,55,12,292,60,1206
"Kingston upon Thames","07:00:00","2020-04-27",2618,84,3,1287,206,4198
"Lambeth","07:00:00","2020-04-27",667,39,30,287,54,1077
"Richmond upon Thames","07:00:00","2020-04-27",170,8,73,64,23,338
"Southwark","07:00:00","2020-04-27",497,33,9,196,42,777
"Westminster","07:00:00","2020-04-27",391,38,12,123,36,600
"Camden","08:00:00","2020-04-27",255,18,62,147,24,506
"Kensington and Chelsea","08:00:00","2020-04-27",748,28,14,285,89,1164
"Kingston upon Thames","08:00:00","2020-04-27",2404,45,1,986,227,3663
"Lambeth","08:00:00","2020-04-27",720,16,38,250,61,1085
"Richmond upon Thames","08:00:00","2020-04-27",197,7,108,52,19,383
"Southwark","08:00:00","2020-04-27",344,35,13,147,48,587
"Westminster","08:00:00","2020-04-27",348,19,9,124,52,552
"Camden","09:00:00","2020-04-27",207,22,64,91,24,408
"Kensington and Chelsea","09:00:00","2020-04-27",489,25,16,249,111,890
"Kingston upon Thames","09:00:00","2020-04-27",1878,38,3,831,219,2969
"Lambeth","09:00:00","2020-04-27",505,24,43,203,63,838
"Richmond upon Thames","09:00:00","2020-04-27",172,8,124,60,22,386
"Southwark","09:00:00","2020-04-27",251,30,10,119,44,454
"Westminster","09:00:00","2020-04-27",233,20,13,114,56,436
"Camden","10:00:00","2020-04-27",173,24,64,100,26,387
"Kensington and Chelsea","10:00:00","2020-04-27",447,38,17,274,86,862
"Kingston upon Thames","10:00:00","2020-04-27",1959,42,3,878,196,3078
"Lambeth","10:00:00","2020-04-27",393,23,39,225,71,751
"Richmond upon Thames","10:00:00","2020-04-27",211,11,123,57,20,422
"Southwark","10:00:00","2020-04-27",198,39,9,109,33,388
"Westminster","10:00:00","2020-04-27",193,15,13,119,56,396
"Camden","11:00:00","2020-04-27",199,36,58,112,29,434
"Kensington and Chelsea","11:00:00","2020-04-27",490,43,11,259,94,897
"Kingston upon Thames","11:00:00","2020-04-27",2022,50,2,753,207,3034
"Lambeth","11:00:00","2020-04-27",440,38,38,212,73,801
"Richmond upon Thames","11:00:00","2020-04-27",219,14,123,63,17,436
"Southwark","11:00:00","2020-04-27",202,36,9,100,41,388
"Westminster","11:00:00","2020-04-27",213,23,11,116,44,407
"Camden","12:00:00","2020-04-27",236,57,58,98,22,471
"Kensington and Chelsea","12:00:00","2020-04-27",488,44,12,248,65,857
"Kingston upon Thames","12:00:00","2020-04-27",2224,50,1,759,187,3221
"Lambeth","12:00:00","2020-04-27",490,53,32,222,56,853
"Richmond upon Thames","12:00:00","2020-04-27",265,15,114,63,12,469
"Southwark","12:00:00","2020-04-27",266,49,8,123,29,475
"Westminster","12:00:00","2020-04-27",233,46,10,116,28,433
"Camden","13:00:00","2020-04-27",228,67,57,80,9,441
"Kensington and Chelsea","13:00:00","2020-04-27",512,60,9,220,63,864
"Kingston upon Thames","13:00:00","2020-04-27",2421,64,2,729,183,3399
"Lambeth","13:00:00","2020-04-27",566,56,34,208,44,908
"Richmond upon Thames","13:00:00","2020-04-27",251,17,122,79,15,484
"Southwark","13:00:00","2020-04-27",260,62,10,98,29,459
"Westminster","13:00:00","2020-04-27",244,38,11,98,34,425
"Camden","14:00:00","2020-04-27",247,55,55,82,11,450
"Kensington and Chelsea","14:00:00","2020-04-27",628,59,12,244,58,1001
"Kingston upon Thames","14:00:00","2020-04-27",2338,53,3,796,172,3362
"Lambeth","14:00:00","2020-04-27",550,48,32,197,43,870
"Richmond upon Thames","14:00:00","2020-04-27",293,21,120,66,12,512
"Southwark","14:00:00","2020-04-27",265,49,10,101,35,460
"Westminster","14:00:00","2020-04-27",272,30,9,125,26,462
"Camden","15:00:00","2020-04-27",243,49,54,75,7,428
"Kensington and Chelsea","15:00:00","2020-04-27",680,62,11,263,43,1059
"Kingston upon Thames","15:00:00","2020-04-27",2687,67,1,958,142,3855
"Lambeth","15:00:00","2020-04-27",618,59,31,245,24,977
"Richmond upon Thames","15:00:00","2020-04-27",304,12,116,65,13,510
"Southwark","15:00:00","2020-04-27",308,35,8,135,22,508
"Westminster","15:00:00","2020-04-27",298,39,11,119,12,479
"Camden","16:00:00","2020-04-27",262,62,57,62,6,449
"Kensington and Chelsea","16:00:00","2020-04-27",818,87,11,217,35,1168
"Kingston upon Thames","16:00:00","2020-04-27",2919,105,0,1036,94,4154
"Lambeth","16:00:00","2020-04-27",777,58,33,191,32,1091
"Richmond upon Thames","16:00:00","2020-04-27",291,20,122,66,7,506
"Southwark","16:00:00","2020-04-27",371,51,8,125,11,566
"Westminster","16:00:00","2020-04-27",353,56,10,117,19,555
"Camden","17:00:00","2020-04-27",269,64,55,43,7,438
"Kensington and Chelsea","17:00:00","2020-04-27",867,91,10,165,29,1162
"Kingston upon Thames","17:00:00","2020-04-27",3026,91,0,662,65,3844
"Lambeth","17:00:00","2020-04-27",801,66,31,131,14,1043
"Richmond upon Thames","17:00:00","2020-04-27",286,16,116,36,4,458
"Southwark","17:00:00","2020-04-27",378,46,8,61,32,525
"Westminster","17:00:00","2020-04-27",390,61,9,68,15,543
"Camden","18:00:00","2020-04-27",262,111,59,27,5,464
"Kensington and Chelsea","18:00:00","2020-04-27",783,97,11,80,20,991
"Kingston upon Thames","18:00:00","2020-04-27",2429,75,2,376,49,2931
"Lambeth","18:00:00","2020-04-27",745,70,35,91,12,953
"Richmond upon Thames","18:00:00","2020-04-27",229,32,108,29,2,400
"Southwark","18:00:00","2020-04-27",339,46,12,41,13,451
"Westminster","18:00:00","2020-04-27",373,53,11,44,1,482
"Barnet","07:00:00","2020-04-28",1907,53,31,938,136,3065
"Croydon","07:00:00","2020-04-28",827,15,15,326,67,1250
"Havering","07:00:00","2020-04-28",1239,12,2,622,95,1970
"Hounslow","07:00:00","2020-04-28",332,5,24,85,17,463
"Lambeth","07:00:00","2020-04-28",247,11,41,103,20,422
"Southwark","07:00:00","2020-04-28",482,14,9,181,11,697
"Tower Hamlets","07:00:00","2020-04-28",2574,147,7,1182,234,4144
"Barnet","08:00:00","2020-04-28",1686,21,35,623,166,2531
"Croydon","08:00:00","2020-04-28",794,9,18,289,60,1170
"Havering","08:00:00","2020-04-28",1019,3,0,460,145,1627
"Hounslow","08:00:00","2020-04-28",304,3,31,83,24,445
"Lambeth","08:00:00","2020-04-28",275,9,47,120,19,470
"Southwark","08:00:00","2020-04-28",448,13,9,122,22,614
"Tower Hamlets","08:00:00","2020-04-28",2455,73,3,1045,306,3882
"Barnet","09:00:00","2020-04-28",1448,23,36,533,171,2211
"Croydon","09:00:00","2020-04-28",687,8,18,348,86,1147
"Havering","09:00:00","2020-04-28",730,1,1,409,135,1276
"Hounslow","09:00:00","2020-04-28",309,0,28,91,26,454
"Lambeth","09:00:00","2020-04-28",206,7,55,102,28,398
"Southwark","09:00:00","2020-04-28",322,5,11,103,22,463
"Tower Hamlets","09:00:00","2020-04-28",1979,45,7,894,364,3289
"Barnet","10:00:00","2020-04-28",1372,16,35,498,122,2043
"Croydon","10:00:00","2020-04-28",659,10,14,289,81,1053
"Havering","10:00:00","2020-04-28",773,3,1,408,120,1305
"Hounslow","10:00:00","2020-04-28",305,1,27,96,22,451
"Lambeth","10:00:00","2020-04-28",200,7,51,91,31,380
"Southwark","10:00:00","2020-04-28",303,8,10,124,15,460
"Tower Hamlets","10:00:00","2020-04-28",1569,37,0,891,343,2840
"Barnet","11:00:00","2020-04-28",1336,31,35,492,150,2044
"Croydon","11:00:00","2020-04-28",723,13,14,289,102,1141
"Havering","11:00:00","2020-04-28",871,3,0,413,120,1407
"Hounslow","11:00:00","2020-04-28",354,3,26,106,29,518
"Lambeth","11:00:00","2020-04-28",197,8,45,100,27,377
"Southwark","11:00:00","2020-04-28",313,8,10,139,20,490
"Tower Hamlets","11:00:00","2020-04-28",1644,48,0,914,352,2958
"Barnet","12:00:00","2020-04-28",1425,43,34,498,137,2137
"Croydon","12:00:00","2020-04-28",835,26,12,273,88,1234
"Havering","12:00:00","2020-04-28",937,3,0,445,88,1473
"Hounslow","12:00:00","2020-04-28",493,9,24,90,17,633
"Lambeth","12:00:00","2020-04-28",247,15,42,106,29,439
"Southwark","12:00:00","2020-04-28",356,15,9,113,21,514
"Tower Hamlets","12:00:00","2020-04-28",1887,77,1,900,306,3171
"Barnet","13:00:00","2020-04-28",1605,32,32,481,130,2280
"Croydon","13:00:00","2020-04-28",897,38,12,288,76,1311
"Havering","13:00:00","2020-04-28",1053,5,0,433,101,1592
"Hounslow","13:00:00","2020-04-28",531,6,27,95,20,679
"Lambeth","13:00:00","2020-04-28",264,22,46,94,20,446
"Southwark","13:00:00","2020-04-28",349,20,7,113,18,507
"Tower Hamlets","13:00:00","2020-04-28",2106,95,1,968,339,3509
"Barnet","14:00:00","2020-04-28",1784,35,38,537,108,2502
"Croydon","14:00:00","2020-04-28",921,38,11,265,68,1303
"Havering","14:00:00","2020-04-28",1146,5,2,421,90,1664
"Hounslow","14:00:00","2020-04-28",538,10,24,87,20,679
"Lambeth","14:00:00","2020-04-28",310,20,46,109,14,499
"Southwark","14:00:00","2020-04-28",403,14,11,111,11,550
"Tower Hamlets","14:00:00","2020-04-28",2442,101,0,1064,289,3896
"Barnet","15:00:00","2020-04-28",1916,39,33,627,98,2713
"Croydon","15:00:00","2020-04-28",985,32,14,281,58,1370
"Havering","15:00:00","2020-04-28",1142,6,3,419,56,1626
"Hounslow","15:00:00","2020-04-28",553,11,28,83,19,694
"Lambeth","15:00:00","2020-04-28",311,28,41,84,7,471
"Southwark","15:00:00","2020-04-28",475,22,8,127,18,650
"Tower Hamlets","15:00:00","2020-04-28",2929,106,1,1108,218,4362
"Barnet","16:00:00","2020-04-28",2120,55,35,619,70,2899
"Croydon","16:00:00","2020-04-28",1121,28,12,258,39,1458
"Havering","16:00:00","2020-04-28",1356,10,1,476,68,1911
"Hounslow","16:00:00","2020-04-28",597,12,25,66,12,712
"Lambeth","16:00:00","2020-04-28",356,27,46,71,6,506
"Southwark","16:00:00","2020-04-28",492,24,8,129,11,664
"Tower Hamlets","16:00:00","2020-04-28",3225,144,0,938,118,4425
"Barnet","17:00:00","2020-04-28",2383,59,30,516,45,3033
"Croydon","17:00:00","2020-04-28",1079,36,11,256,29,1411
"Havering","17:00:00","2020-04-28",1413,6,1,332,44,1796
"Hounslow","17:00:00","2020-04-28",559,9,25,65,9,667
"Lambeth","17:00:00","2020-04-28",325,46,43,62,5,481
"Southwark","17:00:00","2020-04-28",572,23,10,86,5,696
"Tower Hamlets","17:00:00","2020-04-28",3982,154,0,713,88,4937
"Barnet","18:00:00","2020-04-28",1900,44,18,266,27,2255
"Croydon","18:00:00","2020-04-28",915,26,12,144,21,1118
"Havering","18:00:00","2020-04-28",1023,4,0,180,36,1243
"Hounslow","18:00:00","2020-04-28",488,13,24,53,3,581
"Lambeth","18:00:00","2020-04-28",318,54,47,44,5,468
"Southwark","18:00:00","2020-04-28",506,23,8,64,6,607
"Tower Hamlets","18:00:00","2020-04-28",3613,137,3,445,54,4252
"Bexley","07:00:00","2020-04-29",2637,75,4,1470,341,4527
"Camden","07:00:00","2020-04-29",1387,85,63,548,125,2208
"City of London","07:00:00","2020-04-29",333,44,50,159,32,618
"Hackney","07:00:00","2020-04-29",549,25,20,264,49,907
"Hillingdon","07:00:00","2020-04-29",2876,22,1,1339,513,4751
"Wandsworth","07:00:00","2020-04-29",51,4,15,13,4,87
"Bexley","08:00:00","2020-04-29",2230,35,5,1044,310,3624
"Camden","08:00:00","2020-04-29",1189,56,62,479,144,1930
"City of London","08:00:00","2020-04-29",203,38,64,143,24,472
"Hackney","08:00:00","2020-04-29",576,11,30,223,66,906
"Hillingdon","08:00:00","2020-04-29",2370,11,1,982,518,3882
"Wandsworth","08:00:00","2020-04-29",54,3,18,19,9,103
"Bexley","09:00:00","2020-04-29",1564,21,5,768,378,2736
"Camden","09:00:00","2020-04-29",902,60,77,388,157,1584
"City of London","09:00:00","2020-04-29",134,26,66,86,19,331
"Hackney","09:00:00","2020-04-29",502,10,36,202,71,821
"Hillingdon","09:00:00","2020-04-29",1786,12,6,931,526,3261
"Wandsworth","09:00:00","2020-04-29",58,3,17,19,17,114
"Bexley","10:00:00","2020-04-29",1485,20,5,737,335,2582
"Camden","10:00:00","2020-04-29",816,58,64,426,168,1532
"City of London","10:00:00","2020-04-29",128,31,54,82,19,314
"Hackney","10:00:00","2020-04-29",513,17,43,186,52,811
"Hillingdon","10:00:00","2020-04-29",1646,10,1,925,564,3146
"Wandsworth","10:00:00","2020-04-29",46,2,19,29,9,105
"Bexley","11:00:00","2020-04-29",1687,22,4,799,328,2840
"Camden","11:00:00","2020-04-29",822,73,65,414,136,1510
"City of London","11:00:00","2020-04-29",118,41,47,82,24,312
"Hackney","11:00:00","2020-04-29",583,31,43,212,60,929
"Hillingdon","11:00:00","2020-04-29",1678,18,0,898,498,3092
"Wandsworth","11:00:00","2020-04-29",51,3,15,28,8,105
"Bexley","12:00:00","2020-04-29",1961,27,3,771,321,3083
"Camden","12:00:00","2020-04-29",877,94,62,389,116,1538
"City of London","12:00:00","2020-04-29",105,55,48,83,12,303
"Hackney","12:00:00","2020-04-29",649,31,40,194,58,972
"Hillingdon","12:00:00","2020-04-29",1937,11,2,857,437,3244
"Wandsworth","12:00:00","2020-04-29",78,17,15,30,8,148
"Bexley","13:00:00","2020-04-29",2192,20,2,929,316,3459
"Camden","13:00:00","2020-04-29",930,110,61,383,95,1579
"City of London","13:00:00","2020-04-29",156,57,47,62,14,336
"Hackney","13:00:00","2020-04-29",692,30,37,226,44,1029
"Hillingdon","13:00:00","2020-04-29",2278,10,2,897,459,3646
"Wandsworth","13:00:00","2020-04-29",71,20,12,24,11,138
"Bexley","14:00:00","2020-04-29",2372,24,1,943,267,3607
"Camden","14:00:00","2020-04-29",1007,100,59,359,78,1603
"City of London","14:00:00","2020-04-29",134,44,46,88,14,326
"Hackney","14:00:00","2020-04-29",746,33,40,193,33,1045
"Hillingdon","14:00:00","2020-04-29",2395,11,2,874,416,3698
"Wandsworth","14:00:00","2020-04-29",55,16,15,20,3,109
"Bexley","15:00:00","2020-04-29",2687,27,2,1160,226,4102
"Camden","15:00:00","2020-04-29",1174,127,64,396,55,1816
"City of London","15:00:00","2020-04-29",228,39,48,85,8,408
"Hackney","15:00:00","2020-04-29",788,31,37,195,30,1081
"Hillingdon","15:00:00","2020-04-29",2520,11,1,963,369,3864
"Wandsworth","15:00:00","2020-04-29",59,18,13,14,1,105
"Bexley","16:00:00","2020-04-29",3209,73,1,1119,135,4537
"Camden","16:00:00","2020-04-29",1429,145,62,364,63,2063
"City of London","16:00:00","2020-04-29",338,46,46,105,10,545
"Hackney","16:00:00","2020-04-29",888,52,35,183,28,1186
"Hillingdon","16:00:00","2020-04-29",2890,19,1,870,274,4054
"Wandsworth","16:00:00","2020-04-29",81,13,13,20,2,129
"Bexley","17:00:00","2020-04-29",3266,63,3,800,104,4236
"Camden","17:00:00","2020-04-29",1500,147,62,267,28,2004
"City of London","17:00:00","2020-04-29",317,47,46,37,5,452
"Hackney","17:00:00","2020-04-29",966,42,35,132,16,1191
"Hillingdon","17:00:00","2020-04-29",3133,14,1,750,212,4110
"Wandsworth","17:00:00","2020-04-29",76,16,14,13,5,124
"Bexley","18:00:00","2020-04-29",2490,41,2,458,70,3061
"Camden","18:00:00","2020-04-29",1398,150,65,137,31,1781
"City of London","18:00:00","2020-04-29",220,56,51,14,2,343
"Hackney","18:00:00","2020-04-29",810,42,40,106,15,1013
"Hillingdon","18:00:00","2020-04-29",2395,21,0,512,175,3103
"Wandsworth","18:00:00","2020-04-29",71,18,12,2,0,103
"Bexley","07:00:00","2020-04-30",2966,62,2,1549,320,4899
"Hounslow","07:00:00","2020-04-30",2896,99,45,1177,234,4451
"Lewisham","07:00:00","2020-04-30",806,18,28,427,57,1336
"Redbridge","07:00:00","2020-04-30",2523,59,2,1120,237,3941
"Bexley","08:00:00","2020-04-30",2454,29,8,1035,371,3897
"Hounslow","08:00:00","2020-04-30",2642,33,51,1010,240,3976
"Lewisham","08:00:00","2020-04-30",503,17,32,255,57,864
"Redbridge","08:00:00","2020-04-30",2042,41,7,878,240,3208
"Bexley","09:00:00","2020-04-30",1915,12,1,811,420,3159
"Hounslow","09:00:00","2020-04-30",2252,35,52,812,304,3455
"Lewisham","09:00:00","2020-04-30",471,24,33,224,68,820
"Redbridge","09:00:00","2020-04-30",1543,20,6,634,226,2429
"Bexley","10:00:00","2020-04-30",1839,13,1,808,402,3063
"Hounslow","10:00:00","2020-04-30",2098,41,48,792,293,3272
"Lewisham","10:00:00","2020-04-30",440,23,30,190,68,751
"Redbridge","10:00:00","2020-04-30",1125,21,3,515,183,1847
"Bexley","11:00:00","2020-04-30",2012,16,3,764,381,3176
"Hounslow","11:00:00","2020-04-30",2222,55,32,792,305,3406
"Lewisham","11:00:00","2020-04-30",532,27,25,247,64,895
"Redbridge","11:00:00","2020-04-30",1468,25,3,670,261,2427
"Bexley","12:00:00","2020-04-30",2221,19,2,831,368,3441
"Hounslow","12:00:00","2020-04-30",2537,52,31,856,232,3708
"Lewisham","12:00:00","2020-04-30",604,64,26,192,52,938
"Redbridge","12:00:00","2020-04-30",1728,34,2,692,216,2672
"Bexley","13:00:00","2020-04-30",2566,30,0,969,361,3926
"Hounslow","13:00:00","2020-04-30",2598,55,35,811,216,3715
"Lewisham","13:00:00","2020-04-30",641,67,27,211,58,1004
"Redbridge","13:00:00","2020-04-30",1930,25,2,834,177,2968
"Bexley","14:00:00","2020-04-30",2741,31,0,1087,276,4135
"Hounslow","14:00:00","2020-04-30",2869,49,28,839,213,3998
"Lewisham","14:00:00","2020-04-30",702,63,26,195,40,1026
"Redbridge","14:00:00","2020-04-30",2224,36,0,786,182,3228
"Bexley","15:00:00","2020-04-30",3041,28,0,1420,205,4694
"Hounslow","15:00:00","2020-04-30",3013,46,32,916,165,4172
"Lewisham","15:00:00","2020-04-30",725,65,28,220,31,1069
"Redbridge","15:00:00","2020-04-30",2523,24,2,941,161,3651
"Bexley","16:00:00","2020-04-30",3257,41,2,1317,132,4749
"Hounslow","16:00:00","2020-04-30",3315,79,34,745,133,4306
"Lewisham","16:00:00","2020-04-30",816,74,31,218,34,1173
"Redbridge","16:00:00","2020-04-30",2792,48,2,807,113,3762
"Bexley","17:00:00","2020-04-30",3334,50,1,904,98,4387
"Hounslow","17:00:00","2020-04-30",3407,113,36,672,101,4329
"Lewisham","17:00:00","2020-04-30",750,63,28,142,16,999
"Redbridge","17:00:00","2020-04-30",3015,56,1,589,92,3753
"Bexley","18:00:00","2020-04-30",2604,48,4,469,88,3213
"Hounslow","18:00:00","2020-04-30",2933,75,34,421,58,3521
"Lewisham","18:00:00","2020-04-30",673,82,31,95,16,897
"Redbridge","18:00:00","2020-04-30",2502,26,5,375,70,2978
"Bexley","07:00:00","2020-05-01",35,2,0,10,3,50
"Croydon","07:00:00","2020-05-01",51,0,0,24,4,79
"Bexley","08:00:00","2020-05-01",53,0,0,6,4,63
"Croydon","08:00:00","2020-05-01",50,1,0,10,7,68
"Bexley","09:00:00","2020-05-01",54,0,0,11,4,69
"Croydon","09:00:00","2020-05-01",49,0,0,10,7,66
"Bexley","10:00:00","2020-05-01",72,1,0,16,0,89
"Croydon","10:00:00","2020-05-01",66,1,0,15,1,83
"Bexley","11:00:00","2020-05-01",85,2,0,22,2,111
"Croydon","11:00:00","2020-05-01",82,1,0,20,3,106
"Bexley","12:00:00","2020-05-01",109,2,0,19,0,130
"Croydon","12:00:00","2020-05-01",81,0,0,27,1,109
"Bexley","13:00:00","2020-05-01",109,3,0,15,1,128
"Croydon","13:00:00","2020-05-01",73,0,0,17,0,90
"Bexley","14:00:00","2020-05-01",88,4,0,16,0,108
"Croydon","14:00:00","2020-05-01",73,0,0,25,0,98
"Bexley","15:00:00","2020-05-01",90,2,0,15,0,107
"Croydon","15:00:00","2020-05-01",87,0,0,23,1,111
"Bexley","16:00:00","2020-05-01",81,1,0,13,0,95
"Croydon","16:00:00","2020-05-01",78,0,0,16,2,96
"Bexley","17:00:00","2020-05-01",77,2,0,10,0,89
"Croydon","17:00:00","2020-05-01",116,0,0,10,3,129
"Bexley","18:00:00","2020-05-01",65,3,0,6,0,74
"Croydon","18:00:00","2020-05-01",71,4,0,8,1,84
"Barnet","07:00:00","2020-05-05",3924,101,19,1946,477,6467
"Barnet","08:00:00","2020-05-05",3318,56,22,1533,512,5441
"Barnet","09:00:00","2020-05-05",2547,52,32,1344,499,4474
"Barnet","10:00:00","2020-05-05",2593,55,22,1191,538,4399
"Barnet","11:00:00","2020-05-05",2730,55,25,1181,473,4464
"Barnet","12:00:00","2020-05-05",2968,75,22,1208,508,4781
"Barnet","13:00:00","2020-05-05",3365,87,20,1246,408,5126
"Barnet","14:00:00","2020-05-05",3604,76,21,1248,397,5346
"Barnet","15:00:00","2020-05-05",4021,107,23,1394,302,5847
"Barnet","16:00:00","2020-05-05",4615,115,19,1495,215,6459
"Barnet","17:00:00","2020-05-05",5022,122,22,1266,135,6567
"Barnet","18:00:00","2020-05-05",4311,101,22,775,119,5328
"Barnet","07:00:00","2020-05-06",1285,37,0,720,135,2177
"Bromley","07:00:00","2020-05-06",60,0,1,23,7,91
"Hackney","07:00:00","2020-05-06",1430,72,38,646,100,2286
"Havering","07:00:00","2020-05-06",196,2,6,95,21,320
"Kingston upon Thames","07:00:00","2020-05-06",571,15,4,360,59,1009
"Barnet","08:00:00","2020-05-06",1123,27,2,474,137,1763
"Bromley","08:00:00","2020-05-06",71,1,2,15,4,93
"Hackney","08:00:00","2020-05-06",1281,40,50,530,127,2028
"Havering","08:00:00","2020-05-06",185,0,8,77,18,288
"Kingston upon Thames","08:00:00","2020-05-06",548,15,5,229,54,851
"Barnet","09:00:00","2020-05-06",946,13,6,428,125,1518
"Bromley","09:00:00","2020-05-06",60,0,1,19,3,83
"Hackney","09:00:00","2020-05-06",902,26,51,433,126,1538
"Havering","09:00:00","2020-05-06",216,1,9,58,18,302
"Kingston upon Thames","09:00:00","2020-05-06",487,11,4,175,54,731
"Barnet","10:00:00","2020-05-06",955,14,0,407,129,1505
"Bromley","10:00:00","2020-05-06",72,0,2,16,6,96
"Hackney","10:00:00","2020-05-06",825,27,40,406,117,1415
"Havering","10:00:00","2020-05-06",240,3,10,69,7,329
"Kingston upon Thames","10:00:00","2020-05-06",489,7,5,165,64,730
"Barnet","11:00:00","2020-05-06",1058,29,0,429,138,1654
"Bromley","11:00:00","2020-05-06",79,0,2,28,7,116
"Hackney","11:00:00","2020-05-06",823,48,42,411,91,1415
"Havering","11:00:00","2020-05-06",276,5,11,75,21,388
"Kingston upon Thames","11:00:00","2020-05-06",532,4,4,183,54,777
"Barnet","12:00:00","2020-05-06",1161,31,0,448,119,1759
"Bromley","12:00:00","2020-05-06",108,5,1,24,5,143
"Hackney","12:00:00","2020-05-06",1016,46,36,362,89,1549
"Havering","12:00:00","2020-05-06",273,2,10,66,16,367
"Kingston upon Thames","12:00:00","2020-05-06",534,11,4,217,51,817
"Barnet","13:00:00","2020-05-06",1271,29,0,408,111,1819
"Bromley","13:00:00","2020-05-06",86,2,2,24,4,118
"Hackney","13:00:00","2020-05-06",1157,56,33,346,83,1675
"Havering","13:00:00","2020-05-06",320,9,10,81,21,441
"Kingston upon Thames","13:00:00","2020-05-06",536,18,4,174,56,788
"Barnet","14:00:00","2020-05-06",1273,25,1,411,110,1820
"Bromley","14:00:00","2020-05-06",113,2,2,23,5,145
"Hackney","14:00:00","2020-05-06",1231,57,36,337,89,1750
"Havering","14:00:00","2020-05-06",316,6,8,88,17,435
"Kingston upon Thames","14:00:00","2020-05-06",614,18,4,210,51,897
"Barnet","15:00:00","2020-05-06",1506,24,1,483,99,2113
"Bromley","15:00:00","2020-05-06",84,0,1,23,1,109
"Hackney","15:00:00","2020-05-06",1270,71,36,397,61,1835
"Havering","15:00:00","2020-05-06",301,4,10,89,13,417
"Kingston upon Thames","15:00:00","2020-05-06",676,20,4,267,45,1012
"Barnet","16:00:00","2020-05-06",1630,39,2,495,51,2217
"Bromley","16:00:00","2020-05-06",108,0,2,29,5,144
"Hackney","16:00:00","2020-05-06",1475,81,34,364,31,1985
"Havering","16:00:00","2020-05-06",326,4,9,106,13,458
"Kingston upon Thames","16:00:00","2020-05-06",734,18,4,283,19,1058
"Barnet","17:00:00","2020-05-06",1806,34,0,378,42,2260
"Bromley","17:00:00","2020-05-06",101,2,1,18,0,122
"Hackney","17:00:00","2020-05-06",1603,78,35,322,34,2072
"Havering","17:00:00","2020-05-06",321,8,8,62,5,404
"Kingston upon Thames","17:00:00","2020-05-06",722,21,5,175,8,931
"Barnet","18:00:00","2020-05-06",1607,38,0,259,43,1947
"Bromley","18:00:00","2020-05-06",56,0,2,13,1,72
"Hackney","18:00:00","2020-05-06",1487,77,38,202,23,1827
"Havering","18:00:00","2020-05-06",254,5,7,48,4,318
"Kingston upon Thames","18:00:00","2020-05-06",554,18,4,86,7,669
"Barnet","07:00:00","2020-05-07",237,4,9,110,12,372
"Greenwich","07:00:00","2020-05-07",20,0,0,8,1,29
"Haringey","07:00:00","2020-05-07",392,15,106,177,29,719
"Havering","07:00:00","2020-05-07",455,4,24,191,18,692
"Kingston upon Thames","07:00:00","2020-05-07",2796,82,6,1419,252,4555
"Richmond upon Thames","07:00:00","2020-05-07",131,4,50,37,19,241
"Southwark","07:00:00","2020-05-07",44,1,26,21,7,99
"Barnet","08:00:00","2020-05-07",289,0,8,101,10,408
"Greenwich","08:00:00","2020-05-07",37,0,0,8,4,49
"Haringey","08:00:00","2020-05-07",402,17,122,183,33,757
"Havering","08:00:00","2020-05-07",501,6,26,181,24,738
"Kingston upon Thames","08:00:00","2020-05-07",2477,57,10,1053,252,3849
"Richmond upon Thames","08:00:00","2020-05-07",139,10,62,39,11,261
"Southwark","08:00:00","2020-05-07",50,3,29,19,17,118
"Barnet","09:00:00","2020-05-07",295,2,8,87,12,404
"Greenwich","09:00:00","2020-05-07",37,0,0,3,0,40
"Haringey","09:00:00","2020-05-07",365,28,160,134,36,723
"Havering","09:00:00","2020-05-07",516,2,31,171,27,747
"Kingston upon Thames","09:00:00","2020-05-07",2216,52,12,833,251,3364
"Richmond upon Thames","09:00:00","2020-05-07",125,11,67,40,14,257
"Southwark","09:00:00","2020-05-07",25,2,38,16,5,86
"Barnet","10:00:00","2020-05-07",323,3,8,97,9,440
"Greenwich","10:00:00","2020-05-07",56,0,0,3,2,61
"Haringey","10:00:00","2020-05-07",386,46,137,150,17,736
"Havering","10:00:00","2020-05-07",618,3,29,156,23,829
"Kingston upon Thames","10:00:00","2020-05-07",2363,40,13,924,289,3629
"Richmond upon Thames","10:00:00","2020-05-07",155,23,73,44,15,310
"Southwark","10:00:00","2020-05-07",19,8,33,14,8,82
"Barnet","11:00:00","2020-05-07",393,4,8,80,9,494
"Greenwich","11:00:00","2020-05-07",42,0,0,5,2,49
"Haringey","11:00:00","2020-05-07",466,58,143,129,35,831
"Havering","11:00:00","2020-05-07",707,6,33,176,21,943
"Kingston upon Thames","11:00:00","2020-05-07",2452,63,14,798,239,3566
"Richmond upon Thames","11:00:00","2020-05-07",162,26,65,57,9,319
"Southwark","11:00:00","2020-05-07",26,5,28,17,4,80
"Barnet","12:00:00","2020-05-07",404,16,9,78,12,519
"Greenwich","12:00:00","2020-05-07",63,2,0,8,1,74
"Haringey","12:00:00","2020-05-07",528,100,139,117,20,904
"Havering","12:00:00","2020-05-07",878,15,28,236,25,1182
"Kingston upon Thames","12:00:00","2020-05-07",2746,64,12,867,258,3947
"Richmond upon Thames","12:00:00","2020-05-07",177,39,67,35,6,324
"Southwark","12:00:00","2020-05-07",20,9,31,15,7,82
"Barnet","13:00:00","2020-05-07",424,19,8,88,12,551
"Greenwich","13:00:00","2020-05-07",60,2,0,15,0,77
"Haringey","13:00:00","2020-05-07",568,96,132,88,30,914
"Havering","13:00:00","2020-05-07",872,9,28,208,19,1136
"Kingston upon Thames","13:00:00","2020-05-07",2959,71,9,846,226,4111
"Richmond upon Thames","13:00:00","2020-05-07",206,38,67,53,13,377
"Southwark","13:00:00","2020-05-07",21,11,33,13,8,86
"Barnet","14:00:00","2020-05-07",457,6,8,89,16,576
"Greenwich","14:00:00","2020-05-07",59,0,0,17,1,77
"Haringey","14:00:00","2020-05-07",618,100,129,115,22,984
"Havering","14:00:00","2020-05-07",881,17,29,228,21,1176
"Kingston upon Thames","14:00:00","2020-05-07",2977,110,13,854,226,4180
"Richmond upon Thames","14:00:00","2020-05-07",193,28,64,30,9,324
"Southwark","14:00:00","2020-05-07",17,4,28,6,7,62
"Barnet","15:00:00","2020-05-07",483,9,9,80,7,588
"Greenwich","15:00:00","2020-05-07",67,0,0,11,2,80
"Haringey","15:00:00","2020-05-07",627,90,136,116,23,992
"Havering","15:00:00","2020-05-07",849,8,34,187,17,1095
"Kingston upon Thames","15:00:00","2020-05-07",3290,88,10,961,144,4493
"Richmond upon Thames","15:00:00","2020-05-07",185,22,68,27,3,305
"Southwark","15:00:00","2020-05-07",14,11,30,11,3,69
"Barnet","16:00:00","2020-05-07",511,12,8,91,9,631
"Greenwich","16:00:00","2020-05-07",75,0,0,8,1,84
"Haringey","16:00:00","2020-05-07",673,106,133,100,16,1028
"Havering","16:00:00","2020-05-07",917,12,32,205,18,1184
"Kingston upon Thames","16:00:00","2020-05-07",3581,109,11,992,108,4801
"Richmond upon Thames","16:00:00","2020-05-07",188,39,68,40,8,343
"Southwark","16:00:00","2020-05-07",31,13,32,4,0,80
"Barnet","17:00:00","2020-05-07",555,19,8,80,2,664
"Greenwich","17:00:00","2020-05-07",65,3,0,10,0,78
"Haringey","17:00:00","2020-05-07",640,127,131,101,10,1009
"Havering","17:00:00","2020-05-07",858,16,30,135,8,1047
"Kingston upon Thames","17:00:00","2020-05-07",3689,115,10,755,82,4651
"Richmond upon Thames","17:00:00","2020-05-07",210,36,65,23,4,338
"Southwark","17:00:00","2020-05-07",35,13,30,3,2,83
"Barnet","18:00:00","2020-05-07",457,21,8,59,4,549
"Greenwich","18:00:00","2020-05-07",63,4,0,6,1,74
"Haringey","18:00:00","2020-05-07",677,120,136,89,15,1037
"Havering","18:00:00","2020-05-07",799,10,24,109,2,944
"Kingston upon Thames","18:00:00","2020-05-07",2993,81,9,468,48,3599
"Richmond upon Thames","18:00:00","2020-05-07",171,47,62,11,3,294
"Southwark","18:00:00","2020-05-07",31,13,28,4,3,79
"Bromley","07:00:00","2020-05-11",31,0,0,5,1,37
"Enfield","07:00:00","2020-05-11",43,0,0,3,3,49
"Haringey","07:00:00","2020-05-11",629,41,16,233,111,1030
"Hounslow","07:00:00","2020-05-11",107,5,0,28,4,144
"Merton","07:00:00","2020-05-11",72,5,0,22,4,103
"Tower Hamlets","07:00:00","2020-05-11",107,1,0,42,4,154
"Bromley","08:00:00","2020-05-11",44,0,0,13,4,61
"Enfield","08:00:00","2020-05-11",44,0,0,12,3,59
"Haringey","08:00:00","2020-05-11",537,18,24,238,112,929
"Hounslow","08:00:00","2020-05-11",102,3,0,35,4,144
"Merton","08:00:00","2020-05-11",76,4,0,18,5,103
"Tower Hamlets","08:00:00","2020-05-11",71,2,2,34,7,116
"Bromley","09:00:00","2020-05-11",34,0,0,10,6,50
"Enfield","09:00:00","2020-05-11",37,2,0,16,2,57
"Haringey","09:00:00","2020-05-11",518,13,33,253,131,948
"Hounslow","09:00:00","2020-05-11",110,2,0,22,6,140
"Merton","09:00:00","2020-05-11",66,1,0,25,5,97
"Tower Hamlets","09:00:00","2020-05-11",60,0,0,23,3,86
"Bromley","10:00:00","2020-05-11",44,0,0,9,7,60
"Enfield","10:00:00","2020-05-11",31,2,0,14,5,52
"Haringey","10:00:00","2020-05-11",499,13,21,261,160,954
"Hounslow","10:00:00","2020-05-11",120,5,0,25,4,154
"Merton","10:00:00","2020-05-11",64,4,0,26,6,100
"Tower Hamlets","10:00:00","2020-05-11",78,1,0,37,4,120
"Bromley","11:00:00","2020-05-11",42,0,0,9,2,53
"Enfield","11:00:00","2020-05-11",48,1,0,13,0,62
"Haringey","11:00:00","2020-05-11",609,10,20,289,126,1054
"Hounslow","11:00:00","2020-05-11",123,1,0,38,2,164
"Merton","11:00:00","2020-05-11",73,3,0,21,3,100
"Tower Hamlets","11:00:00","2020-05-11",68,1,0,22,9,100
"Bromley","12:00:00","2020-05-11",52,0,0,7,1,60
"Enfield","12:00:00","2020-05-11",68,2,0,15,3,88
"Haringey","12:00:00","2020-05-11",641,17,14,335,123,1130
"Hounslow","12:00:00","2020-05-11",168,5,0,24,3,200
"Merton","12:00:00","2020-05-11",75,3,0,28,0,106
"Tower Hamlets","12:00:00","2020-05-11",88,1,0,19,4,112
"Bromley","13:00:00","2020-05-11",49,0,0,10,6,65
"Enfield","13:00:00","2020-05-11",66,0,0,15,1,82
"Haringey","13:00:00","2020-05-11",700,24,19,235,130,1108
"Hounslow","13:00:00","2020-05-11",152,8,0,25,5,190
"Merton","13:00:00","2020-05-11",73,4,0,25,3,105
"Tower Hamlets","13:00:00","2020-05-11",110,4,0,34,3,151
"Bromley","14:00:00","2020-05-11",60,0,0,10,1,71
"Enfield","14:00:00","2020-05-11",71,3,0,20,5,99
"Haringey","14:00:00","2020-05-11",793,23,16,252,120,1204
"Hounslow","14:00:00","2020-05-11",169,4,0,27,3,203
"Merton","14:00:00","2020-05-11",61,2,0,14,4,81
"Tower Hamlets","14:00:00","2020-05-11",113,5,0,26,3,147
"Bromley","15:00:00","2020-05-11",61,1,0,13,1,76
"Enfield","15:00:00","2020-05-11",73,6,0,16,0,95
"Haringey","15:00:00","2020-05-11",844,38,16,213,88,1199
"Hounslow","15:00:00","2020-05-11",180,3,0,39,2,224
"Merton","15:00:00","2020-05-11",95,3,0,30,0,128
"Tower Hamlets","15:00:00","2020-05-11",158,7,2,32,2,201
"Bromley","16:00:00","2020-05-11",62,0,0,6,2,70
"Enfield","16:00:00","2020-05-11",61,5,0,15,0,81
"Haringey","16:00:00","2020-05-11",824,30,16,186,64,1120
"Hounslow","16:00:00","2020-05-11",175,6,0,35,2,218
"Merton","16:00:00","2020-05-11",99,3,0,21,7,130
"Tower Hamlets","16:00:00","2020-05-11",135,6,0,19,0,160
"Bromley","17:00:00","2020-05-11",73,0,0,4,0,77
"Enfield","17:00:00","2020-05-11",102,6,0,5,0,113
"Haringey","17:00:00","2020-05-11",928,32,19,183,58,1220
"Hounslow","17:00:00","2020-05-11",150,9,0,28,5,192
"Merton","17:00:00","2020-05-11",86,5,0,9,3,103
"Tower Hamlets","17:00:00","2020-05-11",151,11,0,20,3,185
"Bromley","18:00:00","2020-05-11",47,0,0,4,0,51
"Enfield","18:00:00","2020-05-11",72,5,0,10,0,87
"Haringey","18:00:00","2020-05-11",815,18,14,159,30,1036
"Hounslow","18:00:00","2020-05-11",122,10,0,12,5,149
"Merton","18:00:00","2020-05-11",76,14,0,6,0,96
"Tower Hamlets","18:00:00","2020-05-11",167,7,0,12,1,187
"Barnet","07:00:00","2020-05-12",85,3,18,26,12,144
"Bexley","07:00:00","2020-05-12",166,2,13,64,5,250
"Croydon","07:00:00","2020-05-12",870,16,25,432,132,1475
"Ealing","07:00:00","2020-05-12",2632,153,24,1162,265,4236
"Kensington and Chelsea","07:00:00","2020-05-12",416,27,26,162,28,659
"Westminster","07:00:00","2020-05-12",91,2,3,42,12,150
"Barnet","08:00:00","2020-05-12",138,2,21,37,17,215
"Bexley","08:00:00","2020-05-12",191,3,14,48,8,264
"Croydon","08:00:00","2020-05-12",736,6,23,349,123,1237
"Ealing","08:00:00","2020-05-12",2449,77,27,927,321,3801
"Kensington and Chelsea","08:00:00","2020-05-12",461,34,27,178,33,733
"Westminster","08:00:00","2020-05-12",88,4,1,40,13,146
"Barnet","09:00:00","2020-05-12",189,6,23,35,19,272
"Bexley","09:00:00","2020-05-12",220,3,15,58,13,309
"Croydon","09:00:00","2020-05-12",646,10,30,306,160,1152
"Ealing","09:00:00","2020-05-12",1987,56,33,938,374,3388
"Kensington and Chelsea","09:00:00","2020-05-12",384,36,30,168,47,665
"Westminster","09:00:00","2020-05-12",74,3,3,34,14,128
"Barnet","10:00:00","2020-05-12",230,29,26,48,6,339
"Bexley","10:00:00","2020-05-12",211,5,14,40,10,280
"Croydon","10:00:00","2020-05-12",625,10,29,251,146,1061
"Ealing","10:00:00","2020-05-12",1856,52,27,896,354,3185
"Kensington and Chelsea","10:00:00","2020-05-12",351,41,26,150,41,609
"Westminster","10:00:00","2020-05-12",111,8,0,53,14,186
"Barnet","11:00:00","2020-05-12",266,30,29,53,16,394
"Bexley","11:00:00","2020-05-12",330,2,13,70,8,423
"Croydon","11:00:00","2020-05-12",703,9,24,280,119,1135
"Ealing","11:00:00","2020-05-12",1970,91,25,883,395,3364
"Kensington and Chelsea","11:00:00","2020-05-12",394,49,28,162,35,668
"Westminster","11:00:00","2020-05-12",117,9,0,51,10,187
"Barnet","12:00:00","2020-05-12",288,40,31,48,10,417
"Bexley","12:00:00","2020-05-12",309,13,13,62,8,405
"Croydon","12:00:00","2020-05-12",862,16,27,297,131,1333
"Ealing","12:00:00","2020-05-12",2123,75,22,884,347,3451
"Kensington and Chelsea","12:00:00","2020-05-12",417,82,33,140,27,699
"Westminster","12:00:00","2020-05-12",141,22,0,51,13,227
"Barnet","13:00:00","2020-05-12",344,26,28,32,5,435
"Bexley","13:00:00","2020-05-12",326,7,13,65,8,419
"Croydon","13:00:00","2020-05-12",905,18,25,276,123,1347
"Ealing","13:00:00","2020-05-12",2269,88,24,844,326,3551
"Kensington and Chelsea","13:00:00","2020-05-12",418,74,26,123,25,666
"Westminster","13:00:00","2020-05-12",144,24,0,42,11,221
"Barnet","14:00:00","2020-05-12",326,28,33,45,7,439
"Bexley","14:00:00","2020-05-12",325,5,14,55,9,408
"Croydon","14:00:00","2020-05-12",939,18,25,262,97,1341
"Ealing","14:00:00","2020-05-12",2548,94,28,878,326,3874
"Kensington and Chelsea","14:00:00","2020-05-12",458,79,26,135,19,717
"Westminster","14:00:00","2020-05-12",156,25,0,43,4,228
"Barnet","15:00:00","2020-05-12",317,24,29,28,6,404
"Bexley","15:00:00","2020-05-12",299,3,12,59,4,377
"Croydon","15:00:00","2020-05-12",1024,21,26,319,97,1487
"Ealing","15:00:00","2020-05-12",2880,85,24,972,208,4169
"Kensington and Chelsea","15:00:00","2020-05-12",459,62,26,141,13,701
"Westminster","15:00:00","2020-05-12",167,22,0,45,6,240
"Barnet","16:00:00","2020-05-12",332,24,27,35,6,424
"Bexley","16:00:00","2020-05-12",332,8,14,63,9,426
"Croydon","16:00:00","2020-05-12",1144,26,26,361,60,1617
"Ealing","16:00:00","2020-05-12",3397,135,27,988,156,4703
"Kensington and Chelsea","16:00:00","2020-05-12",511,66,25,104,9,715
"Westminster","16:00:00","2020-05-12",191,22,0,37,6,256
"Barnet","17:00:00","2020-05-12",312,29,26,26,3,396
"Bexley","17:00:00","2020-05-12",303,6,13,41,5,368
"Croydon","17:00:00","2020-05-12",1157,25,26,279,46,1533
"Ealing","17:00:00","2020-05-12",3640,158,26,776,114,4714
"Kensington and Chelsea","17:00:00","2020-05-12",560,73,26,83,9,751
"Westminster","17:00:00","2020-05-12",168,32,0,32,5,237
"Barnet","18:00:00","2020-05-12",268,22,27,19,1,337
"Bexley","18:00:00","2020-05-12",219,2,15,22,2,260
"Croydon","18:00:00","2020-05-12",1005,18,27,145,34,1229
"Ealing","18:00:00","2020-05-12",3213,122,22,467,85,3909
"Kensington and Chelsea","18:00:00","2020-05-12",481,109,27,45,14,676
"Westminster","18:00:00","2020-05-12",188,39,0,17,4,248
"Croydon","07:00:00","2020-05-13",10,0,0,6,0,16
"Greenwich","07:00:00","2020-05-13",3,1,0,2,1,7
"Haringey","07:00:00","2020-05-13",439,10,69,185,53,756
"Hounslow","07:00:00","2020-05-13",77,1,0,11,2,91
"Lambeth","07:00:00","2020-05-13",500,72,81,183,31,867
"Wandsworth","07:00:00","2020-05-13",399,22,42,150,38,651
"Westminster","07:00:00","2020-05-13",187,14,23,94,35,353
"Croydon","08:00:00","2020-05-13",16,0,0,2,0,18
"Greenwich","08:00:00","2020-05-13",4,0,0,2,3,9
"Haringey","08:00:00","2020-05-13",504,15,71,166,50,806
"Hounslow","08:00:00","2020-05-13",109,2,0,28,5,144
"Lambeth","08:00:00","2020-05-13",445,30,91,167,36,769
"Wandsworth","08:00:00","2020-05-13",428,23,48,148,43,690
"Westminster","08:00:00","2020-05-13",279,19,23,100,47,468
"Croydon","09:00:00","2020-05-13",13,0,0,4,0,17
"Greenwich","09:00:00","2020-05-13",5,0,0,1,0,6
"Haringey","09:00:00","2020-05-13",463,19,80,147,47,756
"Hounslow","09:00:00","2020-05-13",138,3,0,31,3,175
"Lambeth","09:00:00","2020-05-13",372,38,97,150,45,702
"Wandsworth","09:00:00","2020-05-13",393,22,52,174,39,680
"Westminster","09:00:00","2020-05-13",248,39,30,138,43,498
"Croydon","10:00:00","2020-05-13",17,0,0,4,1,22
"Greenwich","10:00:00","2020-05-13",4,0,0,4,1,9
"Haringey","10:00:00","2020-05-13",533,24,80,164,69,870
"Hounslow","10:00:00","2020-05-13",163,3,1,19,6,192
"Lambeth","10:00:00","2020-05-13",351,47,94,136,47,675
"Wandsworth","10:00:00","2020-05-13",422,46,50,134,43,695
"Westminster","10:00:00","2020-05-13",297,42,29,145,56,569
"Croydon","11:00:00","2020-05-13",32,0,0,3,0,35
"Greenwich","11:00:00","2020-05-13",9,0,0,7,1,17
"Haringey","11:00:00","2020-05-13",587,26,67,152,44,876
"Hounslow","11:00:00","2020-05-13",239,2,0,48,2,291
"Lambeth","11:00:00","2020-05-13",311,47,82,171,25,636
"Wandsworth","11:00:00","2020-05-13",448,60,44,182,38,772
"Westminster","11:00:00","2020-05-13",321,54,26,136,38,575
"Croydon","12:00:00","2020-05-13",28,0,0,9,1,38
"Greenwich","12:00:00","2020-05-13",5,0,0,4,0,9
"Haringey","12:00:00","2020-05-13",710,39,69,158,37,1013
"Hounslow","12:00:00","2020-05-13",253,7,0,39,4,303
"Lambeth","12:00:00","2020-05-13",344,56,84,110,34,628
"Wandsworth","12:00:00","2020-05-13",512,92,44,157,32,837
"Westminster","12:00:00","2020-05-13",310,76,27,131,48,592
"Croydon","13:00:00","2020-05-13",30,0,0,4,1,35
"Greenwich","13:00:00","2020-05-13",3,0,0,2,0,5
"Haringey","13:00:00","2020-05-13",740,45,67,139,33,1024
"Hounslow","13:00:00","2020-05-13",290,6,0,32,2,330
"Lambeth","13:00:00","2020-05-13",344,69,83,138,38,672
"Wandsworth","13:00:00","2020-05-13",530,101,44,177,37,889
"Westminster","13:00:00","2020-05-13",355,98,27,111,30,621
"Croydon","14:00:00","2020-05-13",27,0,0,2,0,29
"Greenwich","14:00:00","2020-05-13",8,1,0,1,0,10
"Haringey","14:00:00","2020-05-13",741,35,65,150,27,1018
"Hounslow","14:00:00","2020-05-13",274,11,0,38,2,325
"Lambeth","14:00:00","2020-05-13",372,61,79,153,20,685
"Wandsworth","14:00:00","2020-05-13",548,88,37,134,26,833
"Westminster","14:00:00","2020-05-13",361,70,28,117,37,613
"Croydon","15:00:00","2020-05-13",28,2,0,5,2,37
"Greenwich","15:00:00","2020-05-13",8,0,1,2,1,12
"Haringey","15:00:00","2020-05-13",763,44,66,137,41,1051
"Hounslow","15:00:00","2020-05-13",252,5,0,24,2,283
"Lambeth","15:00:00","2020-05-13",452,61,82,178,28,801
"Wandsworth","15:00:00","2020-05-13",570,88,43,173,21,895
"Westminster","15:00:00","2020-05-13",365,82,26,93,37,603
"Croydon","16:00:00","2020-05-13",31,0,0,5,0,36
"Greenwich","16:00:00","2020-05-13",2,0,0,3,0,5
"Haringey","16:00:00","2020-05-13",824,47,67,129,16,1083
"Hounslow","16:00:00","2020-05-13",261,2,0,20,1,284
"Lambeth","16:00:00","2020-05-13",523,62,79,124,22,810
"Wandsworth","16:00:00","2020-05-13",596,99,40,134,16,885
"Westminster","16:00:00","2020-05-13",423,55,24,84,21,607
"Croydon","17:00:00","2020-05-13",23,0,0,7,0,30
"Greenwich","17:00:00","2020-05-13",7,0,0,3,1,11
"Haringey","17:00:00","2020-05-13",888,55,70,97,16,1126
"Hounslow","17:00:00","2020-05-13",267,7,0,25,1,300
"Lambeth","17:00:00","2020-05-13",520,77,81,86,17,781
"Wandsworth","17:00:00","2020-05-13",681,140,46,116,11,994
"Westminster","17:00:00","2020-05-13",459,86,27,51,17,640
"Croydon","18:00:00","2020-05-13",21,0,0,10,0,31
"Greenwich","18:00:00","2020-05-13",5,0,0,1,1,7
"Haringey","18:00:00","2020-05-13",771,53,68,96,10,998
"Hounslow","18:00:00","2020-05-13",198,8,0,14,2,222
"Lambeth","18:00:00","2020-05-13",536,58,80,64,11,749
"Wandsworth","18:00:00","2020-05-13",640,156,43,70,11,920
"Westminster","18:00:00","2020-05-13",414,113,27,38,10,602
"Brent","07:00:00","2020-05-14",393,25,37,213,15,683
"Croydon","07:00:00","2020-05-14",774,18,18,326,98,1234
"Greenwich","07:00:00","2020-05-14",2112,111,4,1183,320,3730
"Hillingdon","07:00:00","2020-05-14",160,0,5,41,2,208
"Hounslow","07:00:00","2020-05-14",939,48,12,301,66,1366
"Richmond upon Thames","07:00:00","2020-05-14",103,6,0,41,15,165
"Waltham Forest","07:00:00","2020-05-14",6,0,0,2,1,9
"Westminster","07:00:00","2020-05-14",8,0,0,3,2,13
"Brent","08:00:00","2020-05-14",361,28,37,158,8,592
"Croydon","08:00:00","2020-05-14",761,16,15,268,119,1179
"Greenwich","08:00:00","2020-05-14",1866,50,3,902,303,3124
"Hillingdon","08:00:00","2020-05-14",123,0,4,27,6,160
"Hounslow","08:00:00","2020-05-14",881,13,11,241,92,1238
"Richmond upon Thames","08:00:00","2020-05-14",145,7,2,50,21,225
"Waltham Forest","08:00:00","2020-05-14",4,0,0,0,1,5
"Westminster","08:00:00","2020-05-14",19,1,0,9,3,32
"Brent","09:00:00","2020-05-14",317,27,35,92,7,478
"Croydon","09:00:00","2020-05-14",664,8,14,229,116,1031
"Greenwich","09:00:00","2020-05-14",1564,34,2,731,397,2728
"Hillingdon","09:00:00","2020-05-14",106,3,3,22,10,144
"Hounslow","09:00:00","2020-05-14",767,14,13,220,96,1110
"Richmond upon Thames","09:00:00","2020-05-14",156,10,1,57,19,243
"Waltham Forest","09:00:00","2020-05-14",7,0,0,4,1,12
"Westminster","09:00:00","2020-05-14",18,1,0,6,3,28
"Brent","10:00:00","2020-05-14",309,36,34,120,12,511
"Croydon","10:00:00","2020-05-14",759,13,13,244,123,1152
"Greenwich","10:00:00","2020-05-14",1625,25,1,650,383,2684
"Hillingdon","10:00:00","2020-05-14",119,0,7,35,8,169
"Hounslow","10:00:00","2020-05-14",719,19,10,223,111,1082
"Richmond upon Thames","10:00:00","2020-05-14",197,22,1,52,14,286
"Waltham Forest","10:00:00","2020-05-14",8,0,0,2,1,11
"Westminster","10:00:00","2020-05-14",18,0,0,8,3,29
"Brent","11:00:00","2020-05-14",329,45,33,108,21,536
"Croydon","11:00:00","2020-05-14",862,8,18,237,99,1224
"Greenwich","11:00:00","2020-05-14",1768,33,5,697,354,2857
"Hillingdon","11:00:00","2020-05-14",128,1,6,38,3,176
"Hounslow","11:00:00","2020-05-14",808,27,12,212,81,1140
"Richmond upon Thames","11:00:00","2020-05-14",222,27,0,63,11,323
"Waltham Forest","11:00:00","2020-05-14",10,0,0,6,0,16
"Westminster","11:00:00","2020-05-14",18,1,0,11,2,32
"Brent","12:00:00","2020-05-14",346,46,32,92,11,527
"Croydon","12:00:00","2020-05-14",907,17,14,238,92,1268
"Greenwich","12:00:00","2020-05-14",1917,38,4,744,347,3050
"Hillingdon","12:00:00","2020-05-14",161,1,5,39,0,206
"Hounslow","12:00:00","2020-05-14",905,18,8,215,71,1217
"Richmond upon Thames","12:00:00","2020-05-14",263,47,2,63,20,395
"Waltham Forest","12:00:00","2020-05-14",11,0,0,0,0,11
"Westminster","12:00:00","2020-05-14",32,3,0,20,1,56
"Brent","13:00:00","2020-05-14",395,44,32,101,7,579
"Croydon","13:00:00","2020-05-14",993,26,14,240,99,1372
"Greenwich","13:00:00","2020-05-14",2047,45,0,797,333,3222
"Hillingdon","13:00:00","2020-05-14",166,6,8,42,1,223
"Hounslow","13:00:00","2020-05-14",1045,32,10,243,85,1415
"Richmond upon Thames","13:00:00","2020-05-14",315,36,2,87,15,455
"Waltham Forest","13:00:00","2020-05-14",13,0,0,2,0,15
"Westminster","13:00:00","2020-05-14",27,1,0,13,0,41
"Brent","14:00:00","2020-05-14",480,62,35,96,6,679
"Croydon","14:00:00","2020-05-14",1030,21,15,238,81,1385
"Greenwich","14:00:00","2020-05-14",2264,41,4,931,331,3571
"Hillingdon","14:00:00","2020-05-14",174,2,6,44,1,227
"Hounslow","14:00:00","2020-05-14",1110,32,8,220,58,1428
"Richmond upon Thames","14:00:00","2020-05-14",289,39,1,65,18,412
"Waltham Forest","14:00:00","2020-05-14",12,0,0,4,1,17
"Westminster","14:00:00","2020-05-14",35,1,0,13,1,50
"Brent","15:00:00","2020-05-14",471,47,34,115,4,671
"Croydon","15:00:00","2020-05-14",1109,29,14,256,83,1491
"Greenwich","15:00:00","2020-05-14",2613,50,4,1141,244,4052
"Hillingdon","15:00:00","2020-05-14",221,2,6,47,9,285
"Hounslow","15:00:00","2020-05-14",1211,45,8,228,72,1564
"Richmond upon Thames","15:00:00","2020-05-14",332,24,0,50,10,416
"Waltham Forest","15:00:00","2020-05-14",12,0,0,6,1,19
"Westminster","15:00:00","2020-05-14",37,2,0,7,0,46
"Brent","16:00:00","2020-05-14",510,54,31,121,4,720
"Croydon","16:00:00","2020-05-14",1203,19,13,297,46,1578
"Greenwich","16:00:00","2020-05-14",2848,96,0,1158,138,4240
"Hillingdon","16:00:00","2020-05-14",202,4,6,60,2,274
"Hounslow","16:00:00","2020-05-14",1371,38,8,199,36,1652
"Richmond upon Thames","16:00:00","2020-05-14",338,29,1,62,6,436
"Waltham Forest","16:00:00","2020-05-14",9,1,0,1,3,14
"Westminster","16:00:00","2020-05-14",53,0,0,10,0,63
"Brent","17:00:00","2020-05-14",559,62,33,98,2,754
"Croydon","17:00:00","2020-05-14",1150,49,15,206,38,1458
"Greenwich","17:00:00","2020-05-14",3069,89,3,866,106,4133
"Hillingdon","17:00:00","2020-05-14",185,3,6,30,1,225
"Hounslow","17:00:00","2020-05-14",1359,53,9,198,24,1643
"Richmond upon Thames","17:00:00","2020-05-14",298,40,2,45,4,389
"Waltham Forest","17:00:00","2020-05-14",9,2,0,3,0,14
"Westminster","17:00:00","2020-05-14",44,7,0,6,1,58
"Brent","18:00:00","2020-05-14",472,70,31,60,5,638
"Croydon","18:00:00","2020-05-14",1028,29,13,121,33,1224
"Greenwich","18:00:00","2020-05-14",2618,74,2,541,88,3323
"Hillingdon","18:00:00","2020-05-14",141,2,5,21,1,170
"Hounslow","18:00:00","2020-05-14",1267,26,9,150,27,1479
"Richmond upon Thames","18:00:00","2020-05-14",271,52,4,22,3,352
"Waltham Forest","18:00:00","2020-05-14",7,0,0,1,0,8
"Westminster","18:00:00","2020-05-14",39,9,0,5,1,54
"Hammersmith and Fulham","07:00:00","2020-05-15",264,25,13,131,24,457
"Newham","07:00:00","2020-05-15",3481,146,5,1431,429,5492
"Sutton","07:00:00","2020-05-15",1494,37,25,619,119,2294
"Tower Hamlets","07:00:00","2020-05-15",2997,96,14,1508,332,4947
"Hammersmith and Fulham","08:00:00","2020-05-15",366,33,14,123,25,561
"Newham","08:00:00","2020-05-15",3446,67,17,1321,526,5377
"Sutton","08:00:00","2020-05-15",1464,29,31,488,161,2173
"Tower Hamlets","08:00:00","2020-05-15",2499,61,18,1169,367,4114
"Hammersmith and Fulham","09:00:00","2020-05-15",404,30,13,114,36,597
"Newham","09:00:00","2020-05-15",2888,58,10,1121,598,4675
"Sutton","09:00:00","2020-05-15",1327,17,32,509,149,2034
"Tower Hamlets","09:00:00","2020-05-15",2204,74,27,1066,420,3791
"Hammersmith and Fulham","10:00:00","2020-05-15",392,28,14,135,31,600
"Newham","10:00:00","2020-05-15",2830,67,9,1106,581,4593
"Sutton","10:00:00","2020-05-15",1629,18,29,480,179,2335
"Tower Hamlets","10:00:00","2020-05-15",2230,98,9,953,380,3670
"Hammersmith and Fulham","11:00:00","2020-05-15",446,52,14,127,21,660
"Newham","11:00:00","2020-05-15",3176,62,4,1115,547,4904
"Tower Hamlets","11:00:00","2020-05-15",2451,109,10,1013,337,3920
"Hammersmith and Fulham","12:00:00","2020-05-15",460,75,12,124,18,689
"Newham","12:00:00","2020-05-15",3652,89,8,1216,525,5490
"Tower Hamlets","12:00:00","2020-05-15",2868,153,11,968,335,4335
"Hammersmith and Fulham","13:00:00","2020-05-15",484,92,12,141,15,744
"Newham","13:00:00","2020-05-15",4188,77,5,1262,500,6032
"Tower Hamlets","13:00:00","2020-05-15",3142,170,9,1004,316,4641
"Hammersmith and Fulham","14:00:00","2020-05-15",517,44,11,120,21,713
"Newham","14:00:00","2020-05-15",4819,106,8,1374,428,6735
"Tower Hamlets","14:00:00","2020-05-15",3504,134,13,1106,256,5013
"Hammersmith and Fulham","15:00:00","2020-05-15",549,63,12,123,16,763
"Newham","15:00:00","2020-05-15",5432,130,5,1416,367,7350
"Tower Hamlets","15:00:00","2020-05-15",3478,166,8,1009,201,4862
"Hammersmith and Fulham","16:00:00","2020-05-15",511,69,12,87,14,693
"Newham","16:00:00","2020-05-15",5831,150,7,1303,221,7512
"Tower Hamlets","16:00:00","2020-05-15",3616,170,10,880,166,4842
"Hammersmith and Fulham","17:00:00","2020-05-15",534,90,12,66,16,718
"Newham","17:00:00","2020-05-15",6534,175,8,986,161,7864
"Tower Hamlets","17:00:00","2020-05-15",3897,179,10,653,102,4841
"Hammersmith and Fulham","18:00:00","2020-05-15",497,113,14,28,9,661
"Newham","18:00:00","2020-05-15",6030,117,8,712,109,6976
"Sutton","18:00:00","2020-05-15",1890,28,28,264,43,2253
"Tower Hamlets","18:00:00","2020-05-15",4037,228,11,545,82,4903
"Hillingdon","07:00:00","2020-05-18",40,1,0,14,0,55
"Hounslow","07:00:00","2020-05-18",330,4,20,116,27,497
"Tower Hamlets","07:00:00","2020-05-18",37,0,17,30,7,91
"Hillingdon","08:00:00","2020-05-18",57,0,0,19,2,78
"Hounslow","08:00:00","2020-05-18",407,5,23,134,39,608
"Tower Hamlets","08:00:00","2020-05-18",52,2,18,26,2,100
"Hillingdon","09:00:00","2020-05-18",56,0,0,19,3,78
"Hounslow","09:00:00","2020-05-18",424,6,21,118,44,613
"Tower Hamlets","09:00:00","2020-05-18",72,5,14,24,10,125
"Hillingdon","10:00:00","2020-05-18",50,0,0,14,1,65
"Hounslow","10:00:00","2020-05-18",496,7,23,117,64,707
"Tower Hamlets","10:00:00","2020-05-18",76,4,15,29,10,134
"Hillingdon","11:00:00","2020-05-18",57,1,0,11,7,76
"Hounslow","11:00:00","2020-05-18",585,13,23,118,39,778
"Tower Hamlets","11:00:00","2020-05-18",93,2,13,27,11,146
"Hillingdon","12:00:00","2020-05-18",70,1,0,15,3,89
"Hounslow","12:00:00","2020-05-18",660,11,23,117,45,856
"Tower Hamlets","12:00:00","2020-05-18",87,9,13,22,7,138
"Hillingdon","13:00:00","2020-05-18",63,1,0,16,4,84
"Hounslow","13:00:00","2020-05-18",732,15,21,146,37,951
"Tower Hamlets","13:00:00","2020-05-18",100,15,15,27,7,164
"Hillingdon","14:00:00","2020-05-18",85,0,0,15,2,102
"Hounslow","14:00:00","2020-05-18",687,26,24,122,38,897
"Tower Hamlets","14:00:00","2020-05-18",136,13,13,33,4,199
"Hillingdon","15:00:00","2020-05-18",83,1,0,13,2,99
"Hounslow","15:00:00","2020-05-18",732,26,22,131,28,939
"Tower Hamlets","15:00:00","2020-05-18",127,8,12,27,10,184
"Hillingdon","16:00:00","2020-05-18",101,2,0,18,2,123
"Hounslow","16:00:00","2020-05-18",789,31,23,132,35,1010
"Tower Hamlets","16:00:00","2020-05-18",110,6,13,27,3,159
"Hillingdon","17:00:00","2020-05-18",79,0,0,20,0,99
"Hounslow","17:00:00","2020-05-18",784,31,21,121,18,975
"Tower Hamlets","17:00:00","2020-05-18",125,11,12,20,3,171
"Hillingdon","18:00:00","2020-05-18",60,0,0,9,1,70
"Hounslow","18:00:00","2020-05-18",756,20,23,95,11,905
"Tower Hamlets","18:00:00","2020-05-18",147,11,14,8,2,182
"Hammersmith and Fulham","07:00:00","2020-05-19",3616,212,46,1735,279,5888
"Haringey","07:00:00","2020-05-19",12,0,0,5,1,18
"Hillingdon","07:00:00","2020-05-19",21,0,0,6,0,27
"Lewisham","07:00:00","2020-05-19",33,0,0,5,1,39
"Waltham Forest","07:00:00","2020-05-19",70,1,0,25,0,96
"Hammersmith and Fulham","08:00:00","2020-05-19",3192,130,50,1210,353,4935
"Haringey","08:00:00","2020-05-19",21,4,0,12,1,38
"Hillingdon","08:00:00","2020-05-19",22,0,0,6,2,30
"Lewisham","08:00:00","2020-05-19",58,1,0,7,2,68
"Waltham Forest","08:00:00","2020-05-19",75,1,0,41,5,122
"Hammersmith and Fulham","09:00:00","2020-05-19",2794,125,59,1092,309,4379
"Haringey","09:00:00","2020-05-19",22,0,0,8,2,32
"Hillingdon","09:00:00","2020-05-19",17,0,0,6,1,24
"Lewisham","09:00:00","2020-05-19",85,0,0,9,0,94
"Waltham Forest","09:00:00","2020-05-19",117,3,0,21,6,147
"Hammersmith and Fulham","10:00:00","2020-05-19",2707,127,46,1086,329,4295
"Haringey","10:00:00","2020-05-19",30,2,0,12,1,45
"Hillingdon","10:00:00","2020-05-19",25,0,0,7,1,33
"Lewisham","10:00:00","2020-05-19",72,0,0,10,4,86
"Waltham Forest","10:00:00","2020-05-19",85,1,0,28,3,117
"Hammersmith and Fulham","11:00:00","2020-05-19",2815,164,40,1061,326,4406
"Haringey","11:00:00","2020-05-19",43,9,0,14,0,66
"Hillingdon","11:00:00","2020-05-19",25,0,1,9,2,37
"Lewisham","11:00:00","2020-05-19",81,1,0,8,1,91
"Waltham Forest","11:00:00","2020-05-19",112,2,0,34,5,153
"Hammersmith and Fulham","12:00:00","2020-05-19",2957,154,41,1087,281,4520
"Haringey","12:00:00","2020-05-19",49,3,0,12,3,67
"Hillingdon","12:00:00","2020-05-19",25,0,1,9,2,37
"Lewisham","12:00:00","2020-05-19",82,4,0,12,1,99
"Waltham Forest","12:00:00","2020-05-19",138,3,0,29,6,176
"Hammersmith and Fulham","13:00:00","2020-05-19",3093,197,45,1031,246,4612
"Haringey","13:00:00","2020-05-19",45,8,0,13,1,67
"Hillingdon","13:00:00","2020-05-19",30,0,0,7,2,39
"Lewisham","13:00:00","2020-05-19",81,1,0,7,4,93
"Waltham Forest","13:00:00","2020-05-19",142,3,0,30,1,176
"Hammersmith and Fulham","14:00:00","2020-05-19",3274,208,39,1106,233,4860
"Haringey","14:00:00","2020-05-19",54,8,0,10,2,74
"Hillingdon","14:00:00","2020-05-19",41,1,0,7,0,49
"Lewisham","14:00:00","2020-05-19",71,4,0,10,0,85
"Waltham Forest","14:00:00","2020-05-19",148,4,0,27,2,181
"Hammersmith and Fulham","15:00:00","2020-05-19",3491,190,41,1319,207,5248
"Haringey","15:00:00","2020-05-19",52,8,0,8,0,68
"Hillingdon","15:00:00","2020-05-19",28,1,0,8,3,40
"Lewisham","15:00:00","2020-05-19",102,1,0,10,1,114
"Waltham Forest","15:00:00","2020-05-19",122,4,0,21,5,152
"Hammersmith and Fulham","16:00:00","2020-05-19",3942,224,39,1161,150,5516
"Haringey","16:00:00","2020-05-19",69,13,0,17,2,101
"Hillingdon","16:00:00","2020-05-19",42,0,0,10,0,52
"Lewisham","16:00:00","2020-05-19",76,4,0,14,2,96
"Waltham Forest","16:00:00","2020-05-19",148,5,0,31,3,187
"Hammersmith and Fulham","17:00:00","2020-05-19",4318,305,37,893,101,5654
"Haringey","17:00:00","2020-05-19",66,7,0,9,0,82
"Hillingdon","17:00:00","2020-05-19",33,0,0,6,1,40
"Lewisham","17:00:00","2020-05-19",92,1,0,10,1,104
"Waltham Forest","17:00:00","2020-05-19",158,3,0,31,1,193
"Hammersmith and Fulham","18:00:00","2020-05-19",3615,233,42,482,49,4421
"Haringey","18:00:00","2020-05-19",53,10,0,7,0,70
"Hillingdon","18:00:00","2020-05-19",32,1,0,3,0,36
"Lewisham","18:00:00","2020-05-19",70,1,0,11,1,83
"Waltham Forest","18:00:00","2020-05-19",128,8,0,14,0,150
"Barnet","07:00:00","2020-05-20",11,1,0,6,1,19
"Bexley","07:00:00","2020-05-20",31,1,0,5,0,37
"Croydon","07:00:00","2020-05-20",669,31,28,295,39,1062
"Enfield","07:00:00","2020-05-20",2548,67,16,1071,333,4035
"Hounslow","07:00:00","2020-05-20",9,0,0,6,0,15
"Islington","07:00:00","2020-05-20",21,0,0,10,4,35
"Westminster","07:00:00","2020-05-20",28,3,0,17,6,54
"Barnet","08:00:00","2020-05-20",24,0,0,1,1,26
"Bexley","08:00:00","2020-05-20",37,0,0,6,1,44
"Croydon","08:00:00","2020-05-20",648,17,38,233,39,975
"Enfield","08:00:00","2020-05-20",2704,50,27,998,386,4165
"Hounslow","08:00:00","2020-05-20",11,0,0,6,2,19
"Islington","08:00:00","2020-05-20",25,0,0,10,0,35
"Westminster","08:00:00","2020-05-20",46,3,0,21,12,82
"Barnet","09:00:00","2020-05-20",34,0,0,10,0,44
"Bexley","09:00:00","2020-05-20",41,1,0,6,4,52
"Croydon","09:00:00","2020-05-20",612,14,37,218,41,922
"Enfield","09:00:00","2020-05-20",2566,52,29,1122,486,4255
"Hounslow","09:00:00","2020-05-20",16,0,0,8,0,24
"Islington","09:00:00","2020-05-20",18,0,0,16,3,37
"Westminster","09:00:00","2020-05-20",66,7,0,32,6,111
"Barnet","10:00:00","2020-05-20",30,0,0,7,1,38
"Bexley","10:00:00","2020-05-20",41,0,0,11,4,56
"Croydon","10:00:00","2020-05-20",678,19,36,209,42,984
"Enfield","10:00:00","2020-05-20",2695,57,35,1017,454,4258
"Hounslow","10:00:00","2020-05-20",22,2,0,10,1,35
"Islington","10:00:00","2020-05-20",25,1,0,9,4,39
"Westminster","10:00:00","2020-05-20",40,6,0,26,11,83
"Barnet","11:00:00","2020-05-20",39,0,0,9,1,49
"Bexley","11:00:00","2020-05-20",40,0,0,3,1,44
"Croydon","11:00:00","2020-05-20",787,17,32,215,44,1095
"Enfield","11:00:00","2020-05-20",2948,47,26,1090,442,4553
"Hounslow","11:00:00","2020-05-20",15,1,0,8,0,24
"Islington","11:00:00","2020-05-20",34,5,0,18,3,60
"Westminster","11:00:00","2020-05-20",41,8,0,22,5,76
"Barnet","12:00:00","2020-05-20",45,0,0,11,1,57
"Bexley","12:00:00","2020-05-20",55,2,0,5,3,65
"Croydon","12:00:00","2020-05-20",850,29,31,215,49,1174
"Enfield","12:00:00","2020-05-20",2986,62,24,949,448,4469
"Hounslow","12:00:00","2020-05-20",29,1,0,8,2,40
"Islington","12:00:00","2020-05-20",24,3,0,12,3,42
"Westminster","12:00:00","2020-05-20",51,7,0,22,4,84
"Barnet","13:00:00","2020-05-20",46,2,0,2,2,52
"Bexley","13:00:00","2020-05-20",31,1,0,6,0,38
"Croydon","13:00:00","2020-05-20",883,33,33,211,40,1200
"Enfield","13:00:00","2020-05-20",3183,63,21,1002,404,4673
"Hounslow","13:00:00","2020-05-20",28,0,0,5,0,33
"Islington","13:00:00","2020-05-20",34,3,0,19,3,59
"Westminster","13:00:00","2020-05-20",55,13,0,11,1,80
"Barnet","14:00:00","2020-05-20",37,0,0,5,1,43
"Bexley","14:00:00","2020-05-20",60,0,0,15,2,77
"Croydon","14:00:00","2020-05-20",931,45,32,184,36,1228
"Enfield","14:00:00","2020-05-20",3291,75,25,995,337,4723
"Hounslow","14:00:00","2020-05-20",23,0,0,4,3,30
"Islington","14:00:00","2020-05-20",43,3,0,20,3,69
"Westminster","14:00:00","2020-05-20",55,7,0,10,3,75
"Barnet","15:00:00","2020-05-20",47,2,0,4,1,54
"Bexley","15:00:00","2020-05-20",51,0,0,7,0,58
"Croydon","15:00:00","2020-05-20",1047,34,29,214,20,1344
"Enfield","15:00:00","2020-05-20",3340,76,26,1064,281,4787
"Hounslow","15:00:00","2020-05-20",25,2,0,5,1,33
"Islington","15:00:00","2020-05-20",38,4,0,16,0,58
"Westminster","15:00:00","2020-05-20",55,8,0,11,3,77
"Barnet","16:00:00","2020-05-20",56,0,0,10,3,69
"Bexley","16:00:00","2020-05-20",73,3,0,5,0,81
"Croydon","16:00:00","2020-05-20",1037,54,30,203,27,1351
"Enfield","16:00:00","2020-05-20",3645,118,21,979,187,4950
"Hounslow","16:00:00","2020-05-20",31,2,0,11,1,45
"Islington","16:00:00","2020-05-20",42,5,0,20,0,67
"Westminster","16:00:00","2020-05-20",59,9,0,8,3,79
"Barnet","17:00:00","2020-05-20",51,1,0,9,2,63
"Bexley","17:00:00","2020-05-20",68,0,0,4,1,73
"Croydon","17:00:00","2020-05-20",1148,50,34,179,12,1423
"Enfield","17:00:00","2020-05-20",3750,105,21,839,140,4855
"Hounslow","17:00:00","2020-05-20",27,3,0,1,0,31
"Islington","17:00:00","2020-05-20",40,2,0,4,2,48
"Westminster","17:00:00","2020-05-20",42,4,0,7,0,53
"Barnet","18:00:00","2020-05-20",37,3,0,2,1,43
"Bexley","18:00:00","2020-05-20",71,0,0,3,2,76
"Croydon","18:00:00","2020-05-20",1188,66,31,128,15,1428
"Enfield","18:00:00","2020-05-20",3797,83,26,683,104,4693
"Hounslow","18:00:00","2020-05-20",20,1,0,6,0,27
"Islington","18:00:00","2020-05-20",52,4,0,9,1,66
"Westminster","18:00:00","2020-05-20",55,6,0,3,3,67
"Bexley","07:00:00","2020-05-21",173,2,0,78,6,259
"Bromley","07:00:00","2020-05-21",179,4,2,86,12,283
"Enfield","07:00:00","2020-05-21",4,0,0,1,1,6
"Greenwich","07:00:00","2020-05-21",1269,48,14,646,173,2150
"Havering","07:00:00","2020-05-21",11,1,0,3,1,16
"Hillingdon","07:00:00","2020-05-21",545,4,21,72,30,672
"Bexley","08:00:00","2020-05-21",200,3,0,62,12,277
"Bromley","08:00:00","2020-05-21",243,2,1,66,16,328
"Enfield","08:00:00","2020-05-21",6,0,0,0,0,6
"Greenwich","08:00:00","2020-05-21",1216,26,10,546,186,1984
"Havering","08:00:00","2020-05-21",32,1,0,6,1,40
"Hillingdon","08:00:00","2020-05-21",688,3,19,96,23,829
"Bexley","09:00:00","2020-05-21",206,1,0,70,14,291
"Bromley","09:00:00","2020-05-21",238,4,2,67,10,321
"Enfield","09:00:00","2020-05-21",8,0,0,3,0,11
"Greenwich","09:00:00","2020-05-21",1045,11,10,452,207,1725
"Havering","09:00:00","2020-05-21",38,0,0,5,3,46
"Hillingdon","09:00:00","2020-05-21",666,3,24,98,36,827
"Bexley","10:00:00","2020-05-21",208,2,0,48,11,269
"Bromley","10:00:00","2020-05-21",259,2,1,58,9,329
"Enfield","10:00:00","2020-05-21",19,0,0,2,0,21
"Greenwich","10:00:00","2020-05-21",996,24,12,427,201,1660
"Havering","10:00:00","2020-05-21",38,0,0,9,1,48
"Hillingdon","10:00:00","2020-05-21",517,6,20,56,30,629
"Bexley","11:00:00","2020-05-21",250,7,0,57,10,324
"Bromley","11:00:00","2020-05-21",310,3,1,70,6,390
"Enfield","11:00:00","2020-05-21",14,0,0,3,0,17
"Greenwich","11:00:00","2020-05-21",1110,23,10,382,190,1715
"Havering","11:00:00","2020-05-21",33,0,0,2,5,40
"Hillingdon","11:00:00","2020-05-21",449,2,18,46,40,555
"Bexley","12:00:00","2020-05-21",278,10,0,56,19,363
"Bromley","12:00:00","2020-05-21",314,1,2,68,2,387
"Enfield","12:00:00","2020-05-21",19,1,0,6,0,26
"Greenwich","12:00:00","2020-05-21",1228,38,9,447,166,1888
"Havering","12:00:00","2020-05-21",53,0,0,10,0,63
"Hillingdon","12:00:00","2020-05-21",705,7,19,64,35,830
"Bexley","13:00:00","2020-05-21",257,6,0,63,14,340
"Bromley","13:00:00","2020-05-21",312,4,1,79,9,405
"Enfield","13:00:00","2020-05-21",9,0,0,4,0,13
"Greenwich","13:00:00","2020-05-21",1372,33,11,421,168,2005
"Havering","13:00:00","2020-05-21",49,0,0,9,0,58
"Hillingdon","13:00:00","2020-05-21",938,3,25,68,29,1063
"Bexley","14:00:00","2020-05-21",279,7,0,61,8,355
"Bromley","14:00:00","2020-05-21",327,3,2,99,14,445
"Enfield","14:00:00","2020-05-21",21,0,0,3,1,25
"Greenwich","14:00:00","2020-05-21",1471,37,11,452,152,2123
"Havering","14:00:00","2020-05-21",54,0,0,14,3,71
"Hillingdon","14:00:00","2020-05-21",901,7,18,73,24,1023
"Bexley","15:00:00","2020-05-21",306,4,0,85,5,400
"Bromley","15:00:00","2020-05-21",333,1,1,92,11,438
"Enfield","15:00:00","2020-05-21",19,2,0,7,0,28
"Greenwich","15:00:00","2020-05-21",1548,24,8,456,139,2175
"Havering","15:00:00","2020-05-21",41,0,0,8,0,49
"Hillingdon","15:00:00","2020-05-21",660,4,19,72,20,775
"Bexley","16:00:00","2020-05-21",288,2,0,79,4,373
"Bromley","16:00:00","2020-05-21",384,6,1,132,4,527
"Enfield","16:00:00","2020-05-21",15,0,0,3,0,18
"Greenwich","16:00:00","2020-05-21",1606,63,9,432,104,2214
"Havering","16:00:00","2020-05-21",48,0,0,11,2,61
"Hillingdon","16:00:00","2020-05-21",770,5,18,78,18,889
"Bexley","17:00:00","2020-05-21",270,5,0,62,2,339
"Bromley","17:00:00","2020-05-21",333,3,2,52,4,394
"Enfield","17:00:00","2020-05-21",21,0,0,2,0,23
"Greenwich","17:00:00","2020-05-21",1797,54,12,417,73,2353
"Havering","17:00:00","2020-05-21",45,0,0,5,1,51
"Hillingdon","17:00:00","2020-05-21",736,5,22,46,14,823
"Bexley","18:00:00","2020-05-21",192,12,0,26,2,232
"Bromley","18:00:00","2020-05-21",255,1,2,35,1,294
"Enfield","18:00:00","2020-05-21",15,1,0,2,1,19
"Greenwich","18:00:00","2020-05-21",1638,54,11,269,55,2027
"Havering","18:00:00","2020-05-21",38,0,0,2,1,41
"Hillingdon","18:00:00","2020-05-21",530,4,16,26,11,587
"Bromley","07:00:00","2020-05-22",8,0,0,6,3,17
"Camden","07:00:00","2020-05-22",59,12,1,20,6,98
"Kingston upon Thames","07:00:00","2020-05-22",3261,97,11,1597,322,5288
"Lambeth","07:00:00","2020-05-22",183,5,41,69,12,310
"Lewisham","07:00:00","2020-05-22",270,4,21,95,13,403
"Southwark","07:00:00","2020-05-22",826,58,19,402,106,1411
"Westminster","07:00:00","2020-05-22",237,27,73,191,39,567
"Bromley","08:00:00","2020-05-22",16,1,0,2,0,19
"Camden","08:00:00","2020-05-22",48,6,0,34,7,95
"Kingston upon Thames","08:00:00","2020-05-22",2973,60,11,1242,335,4621
"Lambeth","08:00:00","2020-05-22",218,6,51,68,35,378
"Lewisham","08:00:00","2020-05-22",306,4,22,99,12,443
"Southwark","08:00:00","2020-05-22",861,28,19,370,98,1376
"Westminster","08:00:00","2020-05-22",317,34,83,190,71,695
"Bromley","09:00:00","2020-05-22",14,2,0,4,2,22
"Camden","09:00:00","2020-05-22",33,3,0,17,7,60
"Kingston upon Thames","09:00:00","2020-05-22",2990,55,13,1024,319,4401
"Lambeth","09:00:00","2020-05-22",249,12,54,77,19,411
"Lewisham","09:00:00","2020-05-22",287,4,28,78,21,418
"Southwark","09:00:00","2020-05-22",785,22,24,341,100,1272
"Westminster","09:00:00","2020-05-22",321,36,87,177,66,687
"Bromley","10:00:00","2020-05-22",18,0,0,5,1,24
"Camden","10:00:00","2020-05-22",32,9,0,25,4,70
"Kingston upon Thames","10:00:00","2020-05-22",3555,61,11,997,323,4947
"Lambeth","10:00:00","2020-05-22",274,12,52,95,23,456
"Lewisham","10:00:00","2020-05-22",403,8,30,79,16,536
"Southwark","10:00:00","2020-05-22",848,16,22,332,87,1305
"Westminster","10:00:00","2020-05-22",265,43,83,187,47,625
"Bromley","11:00:00","2020-05-22",28,0,0,7,1,36
"Camden","11:00:00","2020-05-22",30,5,0,17,4,56
"Kingston upon Thames","11:00:00","2020-05-22",3843,65,15,985,292,5200
"Lambeth","11:00:00","2020-05-22",334,18,46,95,21,514
"Lewisham","11:00:00","2020-05-22",419,12,26,105,17,579
"Southwark","11:00:00","2020-05-22",898,30,20,271,82,1301
"Westminster","11:00:00","2020-05-22",287,77,81,138,50,633
"Bromley","12:00:00","2020-05-22",20,1,0,10,1,32
"Camden","12:00:00","2020-05-22",36,8,0,24,6,74
"Kingston upon Thames","12:00:00","2020-05-22",4074,82,12,1084,276,5528
"Lambeth","12:00:00","2020-05-22",429,28,45,94,21,617
"Lewisham","12:00:00","2020-05-22",496,11,31,80,16,634
"Southwark","12:00:00","2020-05-22",924,33,22,298,79,1356
"Westminster","12:00:00","2020-05-22",296,84,77,157,35,649
"Bromley","13:00:00","2020-05-22",27,3,0,8,4,42
"Camden","13:00:00","2020-05-22",55,7,0,23,5,90
"Kingston upon Thames","13:00:00","2020-05-22",4261,70,12,1088,268,5699
"Lambeth","13:00:00","2020-05-22",393,35,44,105,13,590
"Lewisham","13:00:00","2020-05-22",534,16,28,87,16,681
"Southwark","13:00:00","2020-05-22",1037,34,21,254,98,1444
"Westminster","13:00:00","2020-05-22",281,98,69,163,20,631
"Bromley","14:00:00","2020-05-22",24,0,0,3,4,31
"Camden","14:00:00","2020-05-22",51,14,0,17,7,89
"Kingston upon Thames","14:00:00","2020-05-22",4539,111,11,1062,276,5999
"Lambeth","14:00:00","2020-05-22",518,37,49,83,27,714
"Lewisham","14:00:00","2020-05-22",563,19,26,82,16,706
"Southwark","14:00:00","2020-05-22",1054,51,23,266,70,1464
"Westminster","14:00:00","2020-05-22",313,82,75,105,35,610
"Bromley","15:00:00","2020-05-22",27,1,0,2,1,31
"Camden","15:00:00","2020-05-22",69,9,0,25,5,108
"Kingston upon Thames","15:00:00","2020-05-22",4736,123,12,1154,210,6235
"Lambeth","15:00:00","2020-05-22",560,41,44,117,14,776
"Lewisham","15:00:00","2020-05-22",577,28,25,109,19,758
"Southwark","15:00:00","2020-05-22",1068,53,18,275,52,1466
"Westminster","15:00:00","2020-05-22",336,78,74,127,23,638
"Bromley","16:00:00","2020-05-22",36,4,0,8,2,50
"Camden","16:00:00","2020-05-22",46,4,0,16,2,68
"Kingston upon Thames","16:00:00","2020-05-22",5051,116,10,1184,118,6479
"Lambeth","16:00:00","2020-05-22",546,31,44,111,12,744
"Lewisham","16:00:00","2020-05-22",627,23,26,108,6,790
"Southwark","16:00:00","2020-05-22",1094,54,20,274,33,1475
"Westminster","16:00:00","2020-05-22",366,68,73,102,12,621
"Bromley","17:00:00","2020-05-22",42,2,0,7,2,53
"Camden","17:00:00","2020-05-22",68,13,0,12,4,97
"Kingston upon Thames","17:00:00","2020-05-22",5161,127,9,867,101,6265
"Lambeth","17:00:00","2020-05-22",554,50,46,89,13,752
"Lewisham","17:00:00","2020-05-22",612,29,26,85,10,762
"Southwark","17:00:00","2020-05-22",1196,57,20,207,28,1508
"Westminster","17:00:00","2020-05-22",343,81,72,55,7,558
"Bromley","18:00:00","2020-05-22",21,5,0,2,3,31
"Camden","18:00:00","2020-05-22",88,6,0,8,0,102
"Kingston upon Thames","18:00:00","2020-05-22",4353,111,14,479,67,5024
"Lambeth","18:00:00","2020-05-22",523,60,43,60,5,691
"Lewisham","18:00:00","2020-05-22",546,24,30,73,4,677
"Southwark","18:00:00","2020-05-22",1165,66,19,175,31,1456
"Westminster","18:00:00","2020-05-22",402,97,76,40,6,621
"Barnet","07:00:00","2020-06-01",220,4,6,80,3,313
"Hillingdon","07:00:00","2020-06-01",14,0,0,4,0,18
"Sutton","07:00:00","2020-06-01",553,8,31,194,31,817
"Tower Hamlets","07:00:00","2020-06-01",70,4,9,25,2,110
"Westminster","07:00:00","2020-06-01",1230,101,164,637,148,2280
"Barnet","08:00:00","2020-06-01",231,2,7,42,13,295
"Hillingdon","08:00:00","2020-06-01",47,0,0,4,0,51
"Sutton","08:00:00","2020-06-01",543,9,27,149,32,760
"Tower Hamlets","08:00:00","2020-06-01",68,1,8,30,5,112
"Westminster","08:00:00","2020-06-01",1298,63,169,532,160,2222
"Barnet","09:00:00","2020-06-01",212,4,9,51,8,284
"Hillingdon","09:00:00","2020-06-01",17,0,0,2,3,22
"Sutton","09:00:00","2020-06-01",492,11,28,124,38,693
"Tower Hamlets","09:00:00","2020-06-01",88,2,9,23,6,128
"Westminster","09:00:00","2020-06-01",1048,67,180,432,140,1867
"Barnet","10:00:00","2020-06-01",203,5,13,52,15,288
"Hillingdon","10:00:00","2020-06-01",16,0,0,2,2,20
"Sutton","10:00:00","2020-06-01",535,7,28,112,27,709
"Tower Hamlets","10:00:00","2020-06-01",106,2,7,35,13,163
"Westminster","10:00:00","2020-06-01",897,59,180,404,152,1692
"Barnet","11:00:00","2020-06-01",230,7,10,43,11,301
"Hillingdon","11:00:00","2020-06-01",18,0,0,5,1,24
"Sutton","11:00:00","2020-06-01",618,9,26,146,24,823
"Tower Hamlets","11:00:00","2020-06-01",109,3,8,30,11,161
"Westminster","11:00:00","2020-06-01",878,56,160,400,142,1636
"Barnet","12:00:00","2020-06-01",285,2,11,54,7,359
"Hillingdon","12:00:00","2020-06-01",15,0,0,4,0,19
"Sutton","12:00:00","2020-06-01",633,13,27,126,28,827
"Tower Hamlets","12:00:00","2020-06-01",124,1,7,29,11,172
"Westminster","12:00:00","2020-06-01",929,109,149,385,120,1692
"Barnet","13:00:00","2020-06-01",270,5,12,44,8,339
"Hillingdon","13:00:00","2020-06-01",24,0,0,4,1,29
"Sutton","13:00:00","2020-06-01",645,15,26,128,30,844
"Tower Hamlets","13:00:00","2020-06-01",132,6,8,37,9,192
"Westminster","13:00:00","2020-06-01",964,108,161,372,92,1697
"Barnet","14:00:00","2020-06-01",292,1,12,47,6,358
"Hillingdon","14:00:00","2020-06-01",34,0,0,14,0,48
"Sutton","14:00:00","2020-06-01",694,17,26,130,21,888
"Tower Hamlets","14:00:00","2020-06-01",178,3,10,29,5,225
"Westminster","14:00:00","2020-06-01",1082,111,155,403,94,1845
"Barnet","15:00:00","2020-06-01",313,9,12,51,2,387
"Hillingdon","15:00:00","2020-06-01",45,0,0,2,0,47
"Sutton","15:00:00","2020-06-01",741,19,29,153,15,957
"Tower Hamlets","15:00:00","2020-06-01",164,2,7,29,4,206
"Westminster","15:00:00","2020-06-01",1143,128,160,429,67,1927
"Barnet","16:00:00","2020-06-01",329,8,9,46,6,398
"Hillingdon","16:00:00","2020-06-01",21,1,0,6,0,28
"Sutton","16:00:00","2020-06-01",767,13,25,172,10,987
"Tower Hamlets","16:00:00","2020-06-01",174,7,9,19,2,211
"Westminster","16:00:00","2020-06-01",1245,111,162,400,49,1967
"Barnet","17:00:00","2020-06-01",360,4,11,45,2,422
"Hillingdon","17:00:00","2020-06-01",29,0,0,6,0,35
"Sutton","17:00:00","2020-06-01",807,23,28,111,10,979
"Tower Hamlets","17:00:00","2020-06-01",170,7,8,32,9,226
"Westminster","17:00:00","2020-06-01",1437,140,157,322,26,2082
"Barnet","18:00:00","2020-06-01",307,9,9,24,0,349
"Hillingdon","18:00:00","2020-06-01",19,1,0,0,0,20
"Sutton","18:00:00","2020-06-01",740,16,28,90,5,879
"Tower Hamlets","18:00:00","2020-06-01",173,10,6,20,4,213
"Westminster","18:00:00","2020-06-01",1449,128,162,195,21,1955
"Brent","07:00:00","2020-06-02",19,1,11,9,1,41
"Bromley","07:00:00","2020-06-02",3,0,0,0,0,3
"Hillingdon","07:00:00","2020-06-02",305,7,0,173,8,493
"Lambeth","07:00:00","2020-06-02",711,84,41,321,64,1221
"Lewisham","07:00:00","2020-06-02",680,19,48,255,51,1053
"Brent","08:00:00","2020-06-02",13,0,11,5,3,32
"Bromley","08:00:00","2020-06-02",6,0,0,0,2,8
"Hillingdon","08:00:00","2020-06-02",385,3,0,158,22,568
"Lambeth","08:00:00","2020-06-02",716,54,51,254,74,1149
"Lewisham","08:00:00","2020-06-02",807,22,50,231,64,1174
"Brent","09:00:00","2020-06-02",21,3,11,15,6,56
"Bromley","09:00:00","2020-06-02",10,0,0,3,0,13
"Hillingdon","09:00:00","2020-06-02",362,1,0,167,8,538
"Lambeth","09:00:00","2020-06-02",678,40,48,270,86,1122
"Lewisham","09:00:00","2020-06-02",785,15,51,189,67,1107
"Brent","10:00:00","2020-06-02",31,4,10,11,3,59
"Bromley","10:00:00","2020-06-02",6,0,0,3,0,9
"Hillingdon","10:00:00","2020-06-02",419,5,0,116,12,552
"Lambeth","10:00:00","2020-06-02",596,50,51,251,76,1024
"Lewisham","10:00:00","2020-06-02",874,19,49,199,55,1196
"Brent","11:00:00","2020-06-02",24,7,10,13,4,58
"Bromley","11:00:00","2020-06-02",7,0,0,2,0,9
"Hillingdon","11:00:00","2020-06-02",473,2,0,106,19,600
"Lambeth","11:00:00","2020-06-02",530,46,43,267,72,958
"Lewisham","11:00:00","2020-06-02",944,30,44,208,50,1276
"Brent","12:00:00","2020-06-02",31,2,9,19,0,61
"Bromley","12:00:00","2020-06-02",11,0,0,2,2,15
"Hillingdon","12:00:00","2020-06-02",504,11,1,143,17,676
"Lambeth","12:00:00","2020-06-02",604,63,47,245,54,1013
"Lewisham","12:00:00","2020-06-02",999,44,46,214,53,1356
"Brent","13:00:00","2020-06-02",33,1,11,14,1,60
"Bromley","13:00:00","2020-06-02",8,0,0,2,0,10
"Hillingdon","13:00:00","2020-06-02",564,6,0,134,18,722
"Lambeth","13:00:00","2020-06-02",675,72,40,259,56,1102
"Lewisham","13:00:00","2020-06-02",1056,46,45,168,45,1360
"Brent","14:00:00","2020-06-02",35,7,12,7,2,63
"Bromley","14:00:00","2020-06-02",8,0,0,3,0,11
"Hillingdon","14:00:00","2020-06-02",599,11,0,128,12,750
"Lambeth","14:00:00","2020-06-02",740,65,41,268,63,1177
"Lewisham","14:00:00","2020-06-02",1064,44,46,171,37,1362
"Brent","15:00:00","2020-06-02",32,4,9,15,0,60
"Bromley","15:00:00","2020-06-02",11,0,0,2,0,13
"Hillingdon","15:00:00","2020-06-02",510,11,0,132,16,669
"Lambeth","15:00:00","2020-06-02",786,85,41,243,33,1188
"Lewisham","15:00:00","2020-06-02",1076,33,51,195,32,1387
"Brent","16:00:00","2020-06-02",29,6,11,5,0,51
"Bromley","16:00:00","2020-06-02",5,0,0,1,0,6
"Hillingdon","16:00:00","2020-06-02",585,17,0,130,7,739
"Lambeth","16:00:00","2020-06-02",905,109,41,231,23,1309
"Lewisham","16:00:00","2020-06-02",1054,52,45,199,25,1375
"Brent","17:00:00","2020-06-02",31,3,10,6,0,50
"Bromley","17:00:00","2020-06-02",16,0,0,0,0,16
"Hillingdon","17:00:00","2020-06-02",521,12,0,90,8,631
"Lambeth","17:00:00","2020-06-02",930,86,45,179,13,1253
"Lewisham","17:00:00","2020-06-02",1113,52,45,150,17,1377
"Brent","18:00:00","2020-06-02",45,6,11,2,1,65
"Bromley","18:00:00","2020-06-02",10,0,0,2,0,12
"Hillingdon","18:00:00","2020-06-02",500,6,0,68,12,586
"Lambeth","18:00:00","2020-06-02",928,85,43,128,13,1197
"Lewisham","18:00:00","2020-06-02",1014,52,50,112,14,1242
"Barnet","07:00:00","2020-06-03",198,1,33,68,2,302
"Brent","07:00:00","2020-06-03",1107,43,87,352,47,1636
"Hammersmith and Fulham","07:00:00","2020-06-03",9,0,0,4,3,16
"Kensington and Chelsea","07:00:00","2020-06-03",1350,130,77,608,114,2279
"Richmond upon Thames","07:00:00","2020-06-03",43,0,24,23,5,95
"Waltham Forest","07:00:00","2020-06-03",4,0,0,2,0,6
"Wandsworth","07:00:00","2020-06-03",25,1,0,9,0,35
"Barnet","08:00:00","2020-06-03",253,6,30,42,6,337
"Brent","08:00:00","2020-06-03",1103,26,84,268,54,1535
"Hammersmith and Fulham","08:00:00","2020-06-03",8,0,0,1,0,9
"Kensington and Chelsea","08:00:00","2020-06-03",1522,120,84,727,122,2575
"Richmond upon Thames","08:00:00","2020-06-03",120,2,28,19,7,176
"Waltham Forest","08:00:00","2020-06-03",14,0,0,6,1,21
"Wandsworth","08:00:00","2020-06-03",44,2,0,23,4,73
"Barnet","09:00:00","2020-06-03",214,3,34,48,11,310
"Brent","09:00:00","2020-06-03",990,37,97,248,59,1431
"Hammersmith and Fulham","09:00:00","2020-06-03",12,1,0,10,0,23
"Kensington and Chelsea","09:00:00","2020-06-03",1443,110,95,549,145,2342
"Richmond upon Thames","09:00:00","2020-06-03",104,5,28,28,2,167
"Waltham Forest","09:00:00","2020-06-03",11,0,0,1,0,12
"Wandsworth","09:00:00","2020-06-03",51,2,0,14,9,76
"Barnet","10:00:00","2020-06-03",198,2,35,43,8,286
"Brent","10:00:00","2020-06-03",932,49,97,286,64,1428
"Hammersmith and Fulham","10:00:00","2020-06-03",16,0,0,4,1,21
"Kensington and Chelsea","10:00:00","2020-06-03",1321,114,81,537,123,2176
"Richmond upon Thames","10:00:00","2020-06-03",99,2,28,25,7,161
"Waltham Forest","10:00:00","2020-06-03",7,0,0,3,0,10
"Wandsworth","10:00:00","2020-06-03",63,8,0,21,4,96
"Barnet","11:00:00","2020-06-03",250,1,30,41,7,329
"Brent","11:00:00","2020-06-03",1084,54,104,265,84,1591
"Hammersmith and Fulham","11:00:00","2020-06-03",21,2,0,7,3,33
"Kensington and Chelsea","11:00:00","2020-06-03",1303,139,78,504,108,2132
"Richmond upon Thames","11:00:00","2020-06-03",111,3,26,31,6,177
"Waltham Forest","11:00:00","2020-06-03",12,0,0,5,1,18
"Wandsworth","11:00:00","2020-06-03",83,4,0,26,8,121
"Barnet","12:00:00","2020-06-03",262,7,32,55,5,361
"Brent","12:00:00","2020-06-03",1186,40,109,284,70,1689
"Hammersmith and Fulham","12:00:00","2020-06-03",26,0,0,5,2,33
"Kensington and Chelsea","12:00:00","2020-06-03",1370,218,74,493,94,2249
"Richmond upon Thames","12:00:00","2020-06-03",128,6,28,32,2,196
"Waltham Forest","12:00:00","2020-06-03",17,0,0,8,1,26
"Wandsworth","12:00:00","2020-06-03",99,5,0,16,6,126
"Barnet","13:00:00","2020-06-03",284,8,33,41,4,370
"Brent","13:00:00","2020-06-03",1363,64,104,267,67,1865
"Hammersmith and Fulham","13:00:00","2020-06-03",31,1,0,7,1,40
"Kensington and Chelsea","13:00:00","2020-06-03",1543,248,73,438,89,2391
"Richmond upon Thames","13:00:00","2020-06-03",128,8,28,31,13,208
"Waltham Forest","13:00:00","2020-06-03",15,2,0,2,1,20
"Wandsworth","13:00:00","2020-06-03",96,9,0,25,3,133
"Barnet","14:00:00","2020-06-03",315,4,34,47,5,405
"Brent","14:00:00","2020-06-03",1429,75,102,274,51,1931
"Hammersmith and Fulham","14:00:00","2020-06-03",19,2,0,1,1,23
"Kensington and Chelsea","14:00:00","2020-06-03",1521,203,79,407,116,2326
"Richmond upon Thames","14:00:00","2020-06-03",155,8,28,27,3,221
"Waltham Forest","14:00:00","2020-06-03",21,3,0,8,3,35
"Wandsworth","14:00:00","2020-06-03",89,6,0,12,3,110
"Barnet","15:00:00","2020-06-03",332,7,33,68,3,443
"Brent","15:00:00","2020-06-03",1445,65,101,271,54,1936
"Hammersmith and Fulham","15:00:00","2020-06-03",28,3,0,7,0,38
"Kensington and Chelsea","15:00:00","2020-06-03",1743,173,72,465,79,2532
"Richmond upon Thames","15:00:00","2020-06-03",186,3,29,23,1,242
"Waltham Forest","15:00:00","2020-06-03",25,2,0,8,0,35
"Wandsworth","15:00:00","2020-06-03",101,1,0,26,0,128
"Barnet","16:00:00","2020-06-03",319,10,30,57,2,418
"Brent","16:00:00","2020-06-03",1577,88,97,290,32,2084
"Hammersmith and Fulham","16:00:00","2020-06-03",26,7,0,5,3,41
"Kensington and Chelsea","16:00:00","2020-06-03",1787,204,82,400,48,2521
"Richmond upon Thames","16:00:00","2020-06-03",124,7,28,29,5,193
"Waltham Forest","16:00:00","2020-06-03",26,2,0,2,0,30
"Wandsworth","16:00:00","2020-06-03",95,8,0,16,3,122
"Barnet","17:00:00","2020-06-03",417,7,34,60,4,522
"Brent","17:00:00","2020-06-03",1769,89,101,258,21,2238
"Hammersmith and Fulham","17:00:00","2020-06-03",21,3,0,2,0,26
"Kensington and Chelsea","17:00:00","2020-06-03",1825,226,80,221,26,2378
"Richmond upon Thames","17:00:00","2020-06-03",133,2,29,18,0,182
"Waltham Forest","17:00:00","2020-06-03",32,3,0,7,0,42
"Wandsworth","17:00:00","2020-06-03",100,12,0,16,2,130
"Barnet","18:00:00","2020-06-03",344,9,30,40,2,425
"Brent","18:00:00","2020-06-03",1597,87,102,187,11,1984
"Hammersmith and Fulham","18:00:00","2020-06-03",23,6,0,3,0,32
"Kensington and Chelsea","18:00:00","2020-06-03",1753,269,75,152,23,2272
"Richmond upon Thames","18:00:00","2020-06-03",117,9,29,16,3,174
"Waltham Forest","18:00:00","2020-06-03",27,2,0,4,2,35
"Wandsworth","18:00:00","2020-06-03",102,16,0,5,1,124
"Enfield","07:00:00","2020-06-04",271,5,0,117,28,421
"Haringey","07:00:00","2020-06-04",150,8,0,74,7,239
"Hillingdon","07:00:00","2020-06-04",164,4,0,44,5,217
"Islington","07:00:00","2020-06-04",103,8,0,45,4,160
"Lewisham","07:00:00","2020-06-04",134,1,0,65,1,201
"Richmond upon Thames","07:00:00","2020-06-04",439,16,12,155,28,650
"Enfield","08:00:00","2020-06-04",328,4,0,103,17,452
"Haringey","08:00:00","2020-06-04",200,10,0,60,9,279
"Hillingdon","08:00:00","2020-06-04",218,0,1,24,6,249
"Islington","08:00:00","2020-06-04",106,5,0,31,11,153
"Lewisham","08:00:00","2020-06-04",95,1,0,45,3,144
"Richmond upon Thames","08:00:00","2020-06-04",535,6,15,142,26,724
"Enfield","09:00:00","2020-06-04",349,2,1,113,18,483
"Haringey","09:00:00","2020-06-04",170,8,0,55,4,237
"Hillingdon","09:00:00","2020-06-04",148,0,0,30,5,183
"Islington","09:00:00","2020-06-04",62,4,0,28,7,101
"Lewisham","09:00:00","2020-06-04",84,2,0,36,4,126
"Richmond upon Thames","09:00:00","2020-06-04",478,7,14,137,35,671
"Enfield","10:00:00","2020-06-04",383,3,2,93,26,507
"Haringey","10:00:00","2020-06-04",152,12,1,55,11,231
"Hillingdon","10:00:00","2020-06-04",147,2,1,39,10,199
"Islington","10:00:00","2020-06-04",52,5,0,24,5,86
"Lewisham","10:00:00","2020-06-04",76,4,0,33,1,114
"Richmond upon Thames","10:00:00","2020-06-04",495,7,11,136,39,688
"Enfield","11:00:00","2020-06-04",491,2,2,87,20,602
"Haringey","11:00:00","2020-06-04",182,18,0,82,14,296
"Hillingdon","11:00:00","2020-06-04",165,1,0,28,9,203
"Islington","11:00:00","2020-06-04",63,5,0,32,12,112
"Lewisham","11:00:00","2020-06-04",95,4,0,32,3,134
"Richmond upon Thames","11:00:00","2020-06-04",568,5,10,142,31,756
"Enfield","12:00:00","2020-06-04",543,0,2,70,22,637
"Haringey","12:00:00","2020-06-04",211,16,0,65,19,311
"Hillingdon","12:00:00","2020-06-04",183,4,0,25,5,217
"Islington","12:00:00","2020-06-04",69,11,0,24,8,112
"Lewisham","12:00:00","2020-06-04",127,2,0,41,0,170
"Richmond upon Thames","12:00:00","2020-06-04",577,4,9,136,35,761
"Enfield","13:00:00","2020-06-04",555,9,2,92,19,677
"Haringey","13:00:00","2020-06-04",248,29,0,71,10,358
"Hillingdon","13:00:00","2020-06-04",178,3,0,31,4,216
"Islington","13:00:00","2020-06-04",89,11,0,35,2,137
"Lewisham","13:00:00","2020-06-04",121,7,0,44,1,173
"Richmond upon Thames","13:00:00","2020-06-04",615,8,11,133,24,791
"Enfield","14:00:00","2020-06-04",590,3,0,95,11,699
"Haringey","14:00:00","2020-06-04",273,22,1,76,12,384
"Hillingdon","14:00:00","2020-06-04",214,2,0,19,11,246
"Islington","14:00:00","2020-06-04",100,13,0,34,6,153
"Lewisham","14:00:00","2020-06-04",133,3,0,64,1,201
"Richmond upon Thames","14:00:00","2020-06-04",665,11,9,143,27,855
"Enfield","15:00:00","2020-06-04",512,1,0,109,23,645
"Haringey","15:00:00","2020-06-04",316,12,1,73,12,414
"Hillingdon","15:00:00","2020-06-04",260,4,0,34,5,303
"Islington","15:00:00","2020-06-04",103,18,0,23,4,148
"Lewisham","15:00:00","2020-06-04",184,4,0,67,1,256
"Richmond upon Thames","15:00:00","2020-06-04",727,17,9,138,19,910
"Enfield","16:00:00","2020-06-04",553,6,0,129,17,705
"Haringey","16:00:00","2020-06-04",361,20,0,86,16,483
"Hillingdon","16:00:00","2020-06-04",258,4,0,35,5,302
"Islington","16:00:00","2020-06-04",107,15,0,24,5,151
"Lewisham","16:00:00","2020-06-04",226,2,0,77,0,305
"Richmond upon Thames","16:00:00","2020-06-04",768,20,9,165,16,978
"Enfield","17:00:00","2020-06-04",481,6,0,95,12,594
"Haringey","17:00:00","2020-06-04",381,36,0,76,7,500
"Hillingdon","17:00:00","2020-06-04",279,5,0,35,0,319
"Islington","17:00:00","2020-06-04",100,16,0,16,2,134
"Lewisham","17:00:00","2020-06-04",212,7,0,55,2,276
"Richmond upon Thames","17:00:00","2020-06-04",701,25,10,107,18,861
"Enfield","18:00:00","2020-06-04",313,4,0,29,4,350
"Haringey","18:00:00","2020-06-04",329,33,0,51,5,418
"Hillingdon","18:00:00","2020-06-04",207,4,0,16,5,232
"Islington","18:00:00","2020-06-04",96,19,0,14,0,129
"Lewisham","18:00:00","2020-06-04",136,7,0,22,2,167
"Richmond upon Thames","18:00:00","2020-06-04",587,23,11,74,11,706
"Camden","07:00:00","2020-06-05",211,8,20,100,9,348
"Newham","07:00:00","2020-06-05",144,0,11,40,6,201
"Richmond upon Thames","07:00:00","2020-06-05",13,0,0,13,2,28
"Southwark","07:00:00","2020-06-05",454,9,48,88,30,629
"Wandsworth","07:00:00","2020-06-05",1900,124,7,865,103,2999
"Camden","08:00:00","2020-06-05",274,9,19,90,18,410
"Newham","08:00:00","2020-06-05",170,0,9,39,18,236
"Richmond upon Thames","08:00:00","2020-06-05",26,0,0,5,0,31
"Southwark","08:00:00","2020-06-05",480,11,46,72,41,650
"Wandsworth","08:00:00","2020-06-05",2080,77,1,584,123,2865
"Camden","09:00:00","2020-06-05",274,7,18,91,20,410
"Newham","09:00:00","2020-06-05",211,4,11,45,10,281
"Richmond upon Thames","09:00:00","2020-06-05",27,1,0,8,0,36
"Southwark","09:00:00","2020-06-05",379,26,42,78,28,553
"Wandsworth","09:00:00","2020-06-05",1990,58,0,595,140,2783
"Camden","10:00:00","2020-06-05",250,11,21,87,29,398
"Newham","10:00:00","2020-06-05",199,3,10,60,11,283
"Richmond upon Thames","10:00:00","2020-06-05",44,2,0,10,3,59
"Southwark","10:00:00","2020-06-05",370,24,43,68,36,541
"Wandsworth","10:00:00","2020-06-05",2164,55,1,528,144,2892
"Camden","11:00:00","2020-06-05",243,17,23,63,13,359
"Newham","11:00:00","2020-06-05",261,8,10,45,7,331
"Richmond upon Thames","11:00:00","2020-06-05",43,0,0,14,2,59
"Southwark","11:00:00","2020-06-05",378,17,37,85,34,551
"Wandsworth","11:00:00","2020-06-05",2268,68,1,575,144,3056
"Camden","12:00:00","2020-06-05",256,32,20,58,23,389
"Newham","12:00:00","2020-06-05",305,7,9,67,17,405
"Richmond upon Thames","12:00:00","2020-06-05",37,1,0,8,1,47
"Southwark","12:00:00","2020-06-05",393,29,36,70,33,561
"Wandsworth","12:00:00","2020-06-05",2481,73,1,515,124,3194
"Camden","13:00:00","2020-06-05",332,31,21,91,20,495
"Newham","13:00:00","2020-06-05",348,13,10,55,5,431
"Richmond upon Thames","13:00:00","2020-06-05",25,1,0,9,0,35
"Southwark","13:00:00","2020-06-05",452,26,34,95,26,633
"Wandsworth","13:00:00","2020-06-05",2449,74,1,622,98,3244
"Camden","14:00:00","2020-06-05",330,22,19,87,10,468
"Newham","14:00:00","2020-06-05",419,15,10,50,5,499
"Richmond upon Thames","14:00:00","2020-06-05",51,0,0,18,1,70
"Southwark","14:00:00","2020-06-05",457,48,36,87,25,653
"Wandsworth","14:00:00","2020-06-05",2736,87,0,601,92,3516
"Camden","15:00:00","2020-06-05",417,34,22,91,12,576
"Newham","15:00:00","2020-06-05",391,14,11,61,12,489
"Richmond upon Thames","15:00:00","2020-06-05",47,1,0,12,0,60
"Southwark","15:00:00","2020-06-05",517,34,39,107,20,717
"Wandsworth","15:00:00","2020-06-05",2935,97,1,626,74,3733
"Camden","16:00:00","2020-06-05",406,43,21,85,19,574
"Newham","16:00:00","2020-06-05",449,19,11,57,8,544
"Richmond upon Thames","16:00:00","2020-06-05",48,1,0,7,0,56
"Southwark","16:00:00","2020-06-05",565,38,34,79,16,732
"Wandsworth","16:00:00","2020-06-05",3034,121,1,552,48,3756
"Camden","17:00:00","2020-06-05",423,48,21,62,9,563
"Newham","17:00:00","2020-06-05",502,21,9,53,3,588
"Richmond upon Thames","17:00:00","2020-06-05",55,0,0,3,2,60
"Southwark","17:00:00","2020-06-05",590,43,34,64,10,741
"Wandsworth","17:00:00","2020-06-05",3230,127,1,475,54,3887
"Camden","18:00:00","2020-06-05",408,54,20,46,5,533
"Newham","18:00:00","2020-06-05",478,11,9,52,2,552
"Richmond upon Thames","18:00:00","2020-06-05",52,5,0,0,3,60
"Southwark","18:00:00","2020-06-05",558,70,38,46,12,724
"Wandsworth","18:00:00","2020-06-05",2973,121,2,269,43,3408
"Barking and Dagenham","07:00:00","2020-06-08",2906,110,3,1380,716,5115
"Croydon","07:00:00","2020-06-08",104,2,0,26,1,133
"Havering","07:00:00","2020-06-08",273,0,1,141,21,436
"Westminster","07:00:00","2020-06-08",648,65,82,286,54,1135
"Barking and Dagenham","08:00:00","2020-06-08",2696,43,3,1156,775,4673
"Croydon","08:00:00","2020-06-08",139,1,0,33,2,175
"Havering","08:00:00","2020-06-08",329,2,1,104,22,458
"Westminster","08:00:00","2020-06-08",645,32,79,237,81,1074
"Barking and Dagenham","09:00:00","2020-06-08",2183,33,1,1061,879,4157
"Croydon","09:00:00","2020-06-08",99,0,0,23,6,128
"Havering","09:00:00","2020-06-08",195,0,1,96,23,315
"Westminster","09:00:00","2020-06-08",643,35,82,193,84,1037
"Barking and Dagenham","10:00:00","2020-06-08",2092,27,1,994,826,3940
"Croydon","10:00:00","2020-06-08",91,0,0,27,1,119
"Havering","10:00:00","2020-06-08",242,1,3,79,23,348
"Westminster","10:00:00","2020-06-08",642,43,77,228,102,1092
"Barking and Dagenham","11:00:00","2020-06-08",2403,23,0,1040,856,4322
"Croydon","11:00:00","2020-06-08",103,1,0,18,5,127
"Havering","11:00:00","2020-06-08",283,2,1,82,18,386
"Westminster","11:00:00","2020-06-08",638,86,73,218,81,1096
"Barking and Dagenham","12:00:00","2020-06-08",2677,27,3,1165,895,4767
"Croydon","12:00:00","2020-06-08",147,5,0,24,4,180
"Havering","12:00:00","2020-06-08",303,6,1,105,21,436
"Westminster","12:00:00","2020-06-08",698,96,78,226,62,1160
"Barking and Dagenham","13:00:00","2020-06-08",3051,47,3,1198,843,5142
"Croydon","13:00:00","2020-06-08",135,6,0,35,1,177
"Havering","13:00:00","2020-06-08",341,4,3,88,21,457
"Westminster","13:00:00","2020-06-08",768,100,66,219,61,1214
"Barking and Dagenham","14:00:00","2020-06-08",3258,55,1,1356,841,5511
"Croydon","14:00:00","2020-06-08",151,1,0,28,3,183
"Havering","14:00:00","2020-06-08",326,1,1,93,19,440
"Westminster","14:00:00","2020-06-08",787,89,69,206,51,1202
"Barking and Dagenham","15:00:00","2020-06-08",3561,78,6,1505,704,5854
"Croydon","15:00:00","2020-06-08",163,2,0,36,1,202
"Havering","15:00:00","2020-06-08",374,5,1,101,16,497
"Westminster","15:00:00","2020-06-08",834,98,72,251,36,1291
"Barking and Dagenham","16:00:00","2020-06-08",4194,112,4,1473,491,6274
"Croydon","16:00:00","2020-06-08",154,2,0,37,3,196
"Havering","16:00:00","2020-06-08",404,5,2,149,9,569
"Westminster","16:00:00","2020-06-08",875,101,77,224,19,1296
"Barking and Dagenham","17:00:00","2020-06-08",4606,129,3,1198,333,6269
"Croydon","17:00:00","2020-06-08",138,6,0,29,1,174
"Havering","17:00:00","2020-06-08",421,5,1,119,9,555
"Westminster","17:00:00","2020-06-08",909,117,74,155,27,1282
"Barking and Dagenham","18:00:00","2020-06-08",4043,89,2,803,262,5199
"Croydon","18:00:00","2020-06-08",94,4,0,13,2,113
"Havering","18:00:00","2020-06-08",296,4,1,57,8,366
"Westminster","18:00:00","2020-06-08",977,121,72,120,19,1309
"Bexley","07:00:00","2020-06-09",93,2,0,10,31,136
"Brent","07:00:00","2020-06-09",762,35,25,368,43,1233
"Bromley","07:00:00","2020-06-09",56,0,0,16,3,75
"Ealing","07:00:00","2020-06-09",1152,22,103,324,92,1693
"Newham","07:00:00","2020-06-09",452,17,37,117,31,654
"Sutton","07:00:00","2020-06-09",6,0,0,1,0,7
"Bexley","08:00:00","2020-06-09",86,0,0,16,31,133
"Brent","08:00:00","2020-06-09",836,50,21,276,57,1240
"Bromley","08:00:00","2020-06-09",66,0,1,20,6,93
"Ealing","08:00:00","2020-06-09",1252,17,83,277,75,1704
"Newham","08:00:00","2020-06-09",524,19,44,119,34,740
"Sutton","08:00:00","2020-06-09",9,2,0,2,0,13
"Bexley","09:00:00","2020-06-09",98,1,0,29,31,159
"Brent","09:00:00","2020-06-09",807,56,27,283,44,1217
"Bromley","09:00:00","2020-06-09",83,1,0,24,4,112
"Ealing","09:00:00","2020-06-09",1056,19,92,322,113,1602
"Newham","09:00:00","2020-06-09",513,18,39,108,22,700
"Sutton","09:00:00","2020-06-09",5,0,0,1,0,6
"Bexley","10:00:00","2020-06-09",93,2,0,23,42,160
"Brent","10:00:00","2020-06-09",842,59,29,245,56,1231
"Bromley","10:00:00","2020-06-09",82,0,0,14,2,98
"Ealing","10:00:00","2020-06-09",1122,17,88,297,113,1637
"Newham","10:00:00","2020-06-09",499,20,39,126,29,713
"Sutton","10:00:00","2020-06-09",5,0,0,3,0,8
"Bexley","11:00:00","2020-06-09",102,2,0,34,57,195
"Brent","11:00:00","2020-06-09",863,87,25,242,53,1270
"Bromley","11:00:00","2020-06-09",92,0,0,27,5,124
"Ealing","11:00:00","2020-06-09",1209,35,90,297,115,1746
"Newham","11:00:00","2020-06-09",605,42,41,112,29,829
"Sutton","11:00:00","2020-06-09",9,0,0,6,0,15
"Bexley","12:00:00","2020-06-09",146,1,0,39,80,266
"Brent","12:00:00","2020-06-09",946,79,24,249,38,1336
"Bromley","12:00:00","2020-06-09",95,0,0,18,2,115
"Ealing","12:00:00","2020-06-09",1430,42,81,320,140,2013
"Newham","12:00:00","2020-06-09",665,34,36,118,37,890
"Sutton","12:00:00","2020-06-09",8,1,0,6,0,15
"Bexley","13:00:00","2020-06-09",169,4,0,24,58,255
"Brent","13:00:00","2020-06-09",1039,107,24,243,49,1462
"Bromley","13:00:00","2020-06-09",86,2,0,14,2,104
"Ealing","13:00:00","2020-06-09",1802,50,85,270,134,2341
"Newham","13:00:00","2020-06-09",625,43,40,97,25,830
"Sutton","13:00:00","2020-06-09",7,0,0,2,0,9
"Bexley","14:00:00","2020-06-09",112,2,0,16,44,174
"Brent","14:00:00","2020-06-09",1172,96,24,272,30,1594
"Bromley","14:00:00","2020-06-09",82,1,0,20,3,106
"Ealing","14:00:00","2020-06-09",1674,45,84,293,81,2177
"Newham","14:00:00","2020-06-09",693,45,37,121,13,909
"Sutton","14:00:00","2020-06-09",7,0,0,6,0,13
"Bexley","15:00:00","2020-06-09",167,2,0,28,28,225
"Brent","15:00:00","2020-06-09",1195,91,24,282,28,1620
"Bromley","15:00:00","2020-06-09",91,2,1,19,0,113
"Ealing","15:00:00","2020-06-09",1823,59,84,275,92,2333
"Newham","15:00:00","2020-06-09",728,48,44,113,14,947
"Sutton","15:00:00","2020-06-09",12,0,0,6,0,18
"Bexley","16:00:00","2020-06-09",162,2,0,40,34,238
"Brent","16:00:00","2020-06-09",1096,99,22,308,37,1562
"Bromley","16:00:00","2020-06-09",126,1,0,22,1,150
"Ealing","16:00:00","2020-06-09",1974,55,79,331,60,2499
"Newham","16:00:00","2020-06-09",814,43,43,76,14,990
"Sutton","16:00:00","2020-06-09",14,1,0,3,0,18
"Bexley","17:00:00","2020-06-09",210,2,0,13,40,265
"Brent","17:00:00","2020-06-09",1148,110,24,229,16,1527
"Bromley","17:00:00","2020-06-09",105,4,0,15,2,126
"Ealing","17:00:00","2020-06-09",1916,71,77,316,43,2423
"Newham","17:00:00","2020-06-09",806,34,47,103,12,1002
"Sutton","17:00:00","2020-06-09",3,3,0,3,0,9
"Bexley","18:00:00","2020-06-09",218,2,0,13,33,266
"Brent","18:00:00","2020-06-09",1240,133,23,182,14,1592
"Bromley","18:00:00","2020-06-09",101,0,0,7,0,108
"Ealing","18:00:00","2020-06-09",1727,55,81,227,42,2132
"Newham","18:00:00","2020-06-09",841,45,39,84,9,1018
"Sutton","18:00:00","2020-06-09",11,0,0,3,0,14
"Bromley","07:00:00","2020-06-10",31,0,0,7,0,38
"City of London","07:00:00","2020-06-10",26,2,0,5,6,39
"Greenwich","07:00:00","2020-06-10",375,11,14,126,15,541
"Haringey","07:00:00","2020-06-10",5,0,0,1,0,6
"Newham","07:00:00","2020-06-10",197,9,38,52,18,314
"Redbridge","07:00:00","2020-06-10",150,5,7,49,4,215
"Tower Hamlets","07:00:00","2020-06-10",329,25,23,340,39,756
"Wandsworth","07:00:00","2020-06-10",637,36,44,220,62,999
"Bromley","08:00:00","2020-06-10",44,0,0,5,0,49
"City of London","08:00:00","2020-06-10",21,2,0,8,3,34
"Greenwich","08:00:00","2020-06-10",440,1,15,89,16,561
"Haringey","08:00:00","2020-06-10",5,0,0,1,2,8
"Newham","08:00:00","2020-06-10",251,14,38,49,16,368
"Redbridge","08:00:00","2020-06-10",196,3,10,34,4,247
"Tower Hamlets","08:00:00","2020-06-10",324,16,29,207,38,614
"Wandsworth","08:00:00","2020-06-10",731,35,43,235,59,1103
"Bromley","09:00:00","2020-06-10",36,0,0,6,0,42
"City of London","09:00:00","2020-06-10",14,0,0,15,6,35
"Greenwich","09:00:00","2020-06-10",384,5,11,100,16,516
"Haringey","09:00:00","2020-06-10",5,0,0,3,4,12
"Newham","09:00:00","2020-06-10",264,18,33,81,23,419
"Redbridge","09:00:00","2020-06-10",162,2,11,37,2,214
"Tower Hamlets","09:00:00","2020-06-10",288,20,22,182,48,560
"Wandsworth","09:00:00","2020-06-10",652,26,49,244,92,1063
"Bromley","10:00:00","2020-06-10",42,0,0,12,0,54
"City of London","10:00:00","2020-06-10",11,1,0,10,4,26
"Greenwich","10:00:00","2020-06-10",418,2,12,131,24,587
"Haringey","10:00:00","2020-06-10",7,0,0,1,0,8
"Newham","10:00:00","2020-06-10",230,29,44,69,21,393
"Redbridge","10:00:00","2020-06-10",138,1,10,31,8,188
"Tower Hamlets","10:00:00","2020-06-10",261,18,24,159,43,505
"Wandsworth","10:00:00","2020-06-10",652,33,41,222,77,1025
"Bromley","11:00:00","2020-06-10",47,0,0,10,0,57
"City of London","11:00:00","2020-06-10",21,1,0,10,4,36
"Greenwich","11:00:00","2020-06-10",488,9,12,95,17,621
"Haringey","11:00:00","2020-06-10",8,0,0,5,0,13
"Newham","11:00:00","2020-06-10",254,25,46,98,23,446
"Redbridge","11:00:00","2020-06-10",150,3,8,29,4,194
"Tower Hamlets","11:00:00","2020-06-10",265,15,22,174,46,522
"Wandsworth","11:00:00","2020-06-10",722,46,47,256,75,1146
"Bromley","12:00:00","2020-06-10",57,0,0,3,2,62
"City of London","12:00:00","2020-06-10",13,0,0,10,1,24
"Greenwich","12:00:00","2020-06-10",482,11,12,124,21,650
"Haringey","12:00:00","2020-06-10",7,0,0,5,1,13
"Newham","12:00:00","2020-06-10",309,38,39,62,21,469
"Redbridge","12:00:00","2020-06-10",160,1,11,43,2,217
"Tower Hamlets","12:00:00","2020-06-10",272,26,24,148,44,514
"Wandsworth","12:00:00","2020-06-10",749,59,40,226,72,1146
"Bromley","13:00:00","2020-06-10",53,0,0,3,0,56
"City of London","13:00:00","2020-06-10",9,1,0,8,1,19
"Greenwich","13:00:00","2020-06-10",519,8,12,101,13,653
"Haringey","13:00:00","2020-06-10",4,0,0,2,0,6
"Newham","13:00:00","2020-06-10",352,36,39,79,19,525
"Redbridge","13:00:00","2020-06-10",183,3,8,26,4,224
"Tower Hamlets","13:00:00","2020-06-10",291,35,22,166,34,548
"Wandsworth","13:00:00","2020-06-10",822,58,45,268,57,1250
"Bromley","14:00:00","2020-06-10",58,0,0,2,0,60
"City of London","14:00:00","2020-06-10",35,0,0,3,3,41
"Greenwich","14:00:00","2020-06-10",491,10,14,118,27,660
"Haringey","14:00:00","2020-06-10",16,0,0,4,1,21
"Newham","14:00:00","2020-06-10",436,33,44,80,16,609
"Redbridge","14:00:00","2020-06-10",167,2,11,17,3,200
"Tower Hamlets","14:00:00","2020-06-10",344,20,22,183,34,603
"Wandsworth","14:00:00","2020-06-10",784,50,40,238,60,1172
"Bromley","15:00:00","2020-06-10",67,0,0,7,1,75
"City of London","15:00:00","2020-06-10",22,0,0,9,2,33
"Greenwich","15:00:00","2020-06-10",602,16,13,121,13,765
"Haringey","15:00:00","2020-06-10",10,0,0,4,0,14
"Newham","15:00:00","2020-06-10",451,25,44,82,8,610
"Redbridge","15:00:00","2020-06-10",206,4,11,33,4,258
"Tower Hamlets","15:00:00","2020-06-10",381,32,23,196,18,650
"Wandsworth","15:00:00","2020-06-10",846,36,38,233,32,1185
"Bromley","16:00:00","2020-06-10",47,0,0,16,0,63
"City of London","16:00:00","2020-06-10",38,2,0,3,0,43
"Greenwich","16:00:00","2020-06-10",590,16,12,144,11,773
"Haringey","16:00:00","2020-06-10",8,0,0,0,2,10
"Newham","16:00:00","2020-06-10",437,25,38,65,10,575
"Redbridge","16:00:00","2020-06-10",186,5,9,34,1,235
"Tower Hamlets","16:00:00","2020-06-10",465,41,21,192,18,737
"Wandsworth","16:00:00","2020-06-10",959,68,43,245,36,1351
"Bromley","17:00:00","2020-06-10",60,0,0,3,0,63
"City of London","17:00:00","2020-06-10",54,0,0,3,0,57
"Greenwich","17:00:00","2020-06-10",573,26,13,95,4,711
"Haringey","17:00:00","2020-06-10",6,0,0,1,2,9
"Newham","17:00:00","2020-06-10",486,37,45,54,6,628
"Redbridge","17:00:00","2020-06-10",184,2,11,24,2,223
"Tower Hamlets","17:00:00","2020-06-10",483,56,21,133,13,706
"Wandsworth","17:00:00","2020-06-10",996,69,36,191,14,1306
"Bromley","18:00:00","2020-06-10",33,0,0,4,0,37
"City of London","18:00:00","2020-06-10",73,5,0,0,1,79
"Greenwich","18:00:00","2020-06-10",536,24,14,58,9,641
"Haringey","18:00:00","2020-06-10",9,0,0,0,0,9
"Newham","18:00:00","2020-06-10",490,37,45,55,10,637
"Redbridge","18:00:00","2020-06-10",146,0,10,19,0,175
"Tower Hamlets","18:00:00","2020-06-10",481,43,21,70,17,632
"Wandsworth","18:00:00","2020-06-10",987,77,40,96,19,1219
"Camden","07:00:00","2020-06-11",454,14,34,169,63,734
"Croydon","07:00:00","2020-06-11",38,0,0,8,0,46
"Ealing","07:00:00","2020-06-11",3513,82,8,1387,512,5502
"Lambeth","07:00:00","2020-06-11",998,143,122,492,122,1877
"Redbridge","07:00:00","2020-06-11",3,0,0,4,0,7
"Southwark","07:00:00","2020-06-11",42,1,9,12,2,66
"Tower Hamlets","07:00:00","2020-06-11",433,81,39,256,62,871
"Camden","08:00:00","2020-06-11",506,11,23,146,82,768
"Croydon","08:00:00","2020-06-11",58,0,0,10,1,69
"Ealing","08:00:00","2020-06-11",3196,43,16,1098,533,4886
"Lambeth","08:00:00","2020-06-11",1048,105,138,427,135,1853
"Redbridge","08:00:00","2020-06-11",23,0,0,1,0,24
"Southwark","08:00:00","2020-06-11",102,1,11,12,2,128
"Tower Hamlets","08:00:00","2020-06-11",486,63,40,243,80,912
"Camden","09:00:00","2020-06-11",535,20,32,109,58,754
"Croydon","09:00:00","2020-06-11",54,1,0,10,0,65
"Ealing","09:00:00","2020-06-11",2915,34,8,916,618,4491
"Lambeth","09:00:00","2020-06-11",962,123,133,372,128,1718
"Redbridge","09:00:00","2020-06-11",20,0,0,2,0,22
"Southwark","09:00:00","2020-06-11",77,1,10,18,2,108
"Tower Hamlets","09:00:00","2020-06-11",460,54,41,246,67,868
"Camden","10:00:00","2020-06-11",394,21,34,125,57,631
"Croydon","10:00:00","2020-06-11",43,1,0,14,2,60
"Ealing","10:00:00","2020-06-11",2790,29,9,971,543,4342
"Lambeth","10:00:00","2020-06-11",836,91,126,348,120,1521
"Redbridge","10:00:00","2020-06-11",27,0,1,4,2,34
"Southwark","10:00:00","2020-06-11",53,1,8,24,3,89
"Tower Hamlets","10:00:00","2020-06-11",449,76,44,245,71,885
"Camden","11:00:00","2020-06-11",370,36,25,127,27,585
"Croydon","11:00:00","2020-06-11",39,0,0,12,2,53
"Ealing","11:00:00","2020-06-11",2960,37,6,959,592,4554
"Lambeth","11:00:00","2020-06-11",863,97,119,367,123,1569
"Redbridge","11:00:00","2020-06-11",37,0,0,3,3,43
"Southwark","11:00:00","2020-06-11",85,3,12,25,3,128
"Tower Hamlets","11:00:00","2020-06-11",438,82,39,218,72,849
"Camden","12:00:00","2020-06-11",445,44,28,118,42,677
"Croydon","12:00:00","2020-06-11",34,0,0,10,1,45
"Ealing","12:00:00","2020-06-11",3145,42,8,972,509,4676
"Lambeth","12:00:00","2020-06-11",830,122,118,346,110,1526
"Redbridge","12:00:00","2020-06-11",31,1,0,6,0,38
"Southwark","12:00:00","2020-06-11",71,3,9,32,1,116
"Tower Hamlets","12:00:00","2020-06-11",479,137,42,187,64,909
"Camden","13:00:00","2020-06-11",432,56,27,129,32,676
"Croydon","13:00:00","2020-06-11",37,0,0,9,2,48
"Ealing","13:00:00","2020-06-11",3437,45,11,1040,530,5063
"Lambeth","13:00:00","2020-06-11",975,141,120,327,98,1661
"Redbridge","13:00:00","2020-06-11",42,1,0,2,1,46
"Southwark","13:00:00","2020-06-11",92,3,10,27,5,137
"Tower Hamlets","13:00:00","2020-06-11",486,137,37,187,48,895
"Camden","14:00:00","2020-06-11",484,54,28,112,23,701
"Croydon","14:00:00","2020-06-11",53,0,0,11,0,64
"Ealing","14:00:00","2020-06-11",3574,43,7,1051,494,5169
"Lambeth","14:00:00","2020-06-11",1005,162,119,352,113,1751
"Redbridge","14:00:00","2020-06-11",42,1,0,3,0,46
"Southwark","14:00:00","2020-06-11",87,3,9,24,2,125
"Tower Hamlets","14:00:00","2020-06-11",561,136,35,195,38,965
"Camden","15:00:00","2020-06-11",535,37,33,126,22,753
"Croydon","15:00:00","2020-06-11",73,0,0,9,1,83
"Ealing","15:00:00","2020-06-11",4144,53,12,1184,487,5880
"Lambeth","15:00:00","2020-06-11",1077,164,124,390,83,1838
"Redbridge","15:00:00","2020-06-11",32,0,0,1,0,33
"Southwark","15:00:00","2020-06-11",135,10,10,51,4,210
"Tower Hamlets","15:00:00","2020-06-11",621,116,40,192,39,1008
"Camden","16:00:00","2020-06-11",632,39,26,111,12,820
"Croydon","16:00:00","2020-06-11",57,0,0,13,0,70
"Ealing","16:00:00","2020-06-11",4797,90,5,1333,329,6554
"Lambeth","16:00:00","2020-06-11",1108,177,127,321,40,1773
"Redbridge","16:00:00","2020-06-11",22,0,0,1,0,23
"Southwark","16:00:00","2020-06-11",193,5,10,47,4,259
"Tower Hamlets","16:00:00","2020-06-11",688,135,38,192,26,1079
"Camden","17:00:00","2020-06-11",493,53,29,72,11,658
"Croydon","17:00:00","2020-06-11",66,1,0,13,0,80
"Ealing","17:00:00","2020-06-11",5269,96,7,1082,224,6678
"Lambeth","17:00:00","2020-06-11",1214,192,121,249,49,1825
"Redbridge","17:00:00","2020-06-11",40,1,0,3,0,44
"Southwark","17:00:00","2020-06-11",174,9,9,51,3,246
"Tower Hamlets","17:00:00","2020-06-11",709,175,38,122,34,1078
"Camden","18:00:00","2020-06-11",573,80,26,43,13,735
"Croydon","18:00:00","2020-06-11",37,2,0,10,0,49
"Ealing","18:00:00","2020-06-11",4487,67,3,667,174,5398
"Lambeth","18:00:00","2020-06-11",1580,238,127,186,26,2157
"Redbridge","18:00:00","2020-06-11",34,0,0,2,0,36
"Southwark","18:00:00","2020-06-11",120,5,10,21,4,160
"Tower Hamlets","18:00:00","2020-06-11",844,179,43,95,25,1186
"Bromley","07:00:00","2020-06-12",876,11,8,423,99,1417
"Croydon","07:00:00","2020-06-12",821,17,154,293,51,1336
"Ealing","07:00:00","2020-06-12",1573,41,4,614,186,2418
"Hammersmith and Fulham","07:00:00","2020-06-12",2015,170,1,866,174,3226
"Hounslow","07:00:00","2020-06-12",2346,38,6,1140,311,3841
"Kingston upon Thames","07:00:00","2020-06-12",71,0,15,28,0,114
"Southwark","07:00:00","2020-06-12",23,1,0,7,3,34
"Westminster","07:00:00","2020-06-12",654,145,0,571,193,1563
"Bromley","08:00:00","2020-06-12",853,14,7,309,119,1302
"Croydon","08:00:00","2020-06-12",885,13,148,270,46,1362
"Ealing","08:00:00","2020-06-12",1415,22,6,557,227,2227
"Hammersmith and Fulham","08:00:00","2020-06-12",1978,78,0,817,221,3094
"Hounslow","08:00:00","2020-06-12",2181,29,5,766,263,3244
"Kingston upon Thames","08:00:00","2020-06-12",123,1,13,34,7,178
"Southwark","08:00:00","2020-06-12",42,3,0,8,4,57
"Westminster","08:00:00","2020-06-12",663,63,2,505,173,1406
"Bromley","09:00:00","2020-06-12",730,6,6,256,104,1102
"Croydon","09:00:00","2020-06-12",753,19,155,218,66,1211
"Ealing","09:00:00","2020-06-12",1308,20,1,560,217,2106
"Hammersmith and Fulham","09:00:00","2020-06-12",1829,55,4,774,219,2881
"Hounslow","09:00:00","2020-06-12",2077,15,4,698,304,3098
"Kingston upon Thames","09:00:00","2020-06-12",88,1,13,25,8,135
"Southwark","09:00:00","2020-06-12",51,0,0,15,5,71
"Westminster","09:00:00","2020-06-12",603,50,1,348,166,1168
"Bromley","10:00:00","2020-06-12",824,9,5,220,92,1150
"Croydon","10:00:00","2020-06-12",760,24,151,235,51,1221
"Ealing","10:00:00","2020-06-12",1504,12,3,516,226,2261
"Hammersmith and Fulham","10:00:00","2020-06-12",1818,78,3,684,235,2818
"Hounslow","10:00:00","2020-06-12",2019,20,6,618,312,2975
"Kingston upon Thames","10:00:00","2020-06-12",104,3,14,22,3,146
"Southwark","10:00:00","2020-06-12",43,0,0,13,3,59
"Westminster","10:00:00","2020-06-12",615,49,0,400,172,1236
"Bromley","11:00:00","2020-06-12",959,10,4,241,95,1309
"Croydon","11:00:00","2020-06-12",872,52,158,234,51,1367
"Ealing","11:00:00","2020-06-12",1671,18,4,532,215,2440
"Hammersmith and Fulham","11:00:00","2020-06-12",1890,78,0,689,198,2855
"Hounslow","11:00:00","2020-06-12",2203,19,0,641,280,3143
"Kingston upon Thames","11:00:00","2020-06-12",123,4,12,29,7,175
"Southwark","11:00:00","2020-06-12",55,0,0,18,0,73
"Westminster","11:00:00","2020-06-12",575,64,0,341,152,1132
"Bromley","12:00:00","2020-06-12",991,4,4,225,94,1318
"Croydon","12:00:00","2020-06-12",990,42,152,215,44,1443
"Ealing","12:00:00","2020-06-12",1982,28,3,520,208,2741
"Hammersmith and Fulham","12:00:00","2020-06-12",2117,89,0,673,171,3050
"Hounslow","12:00:00","2020-06-12",2316,15,2,701,301,3335
"Kingston upon Thames","12:00:00","2020-06-12",154,1,13,36,6,210
"Southwark","12:00:00","2020-06-12",72,5,0,6,1,84
"Westminster","12:00:00","2020-06-12",513,55,0,338,141,1047
"Bromley","13:00:00","2020-06-12",1029,16,3,233,97,1378
"Croydon","13:00:00","2020-06-12",1066,64,144,218,42,1534
"Ealing","13:00:00","2020-06-12",1969,31,1,557,204,2762
"Hammersmith and Fulham","13:00:00","2020-06-12",2146,110,0,705,178,3139
"Hounslow","13:00:00","2020-06-12",2672,28,4,718,262,3684
"Kingston upon Thames","13:00:00","2020-06-12",115,2,12,31,3,163
"Southwark","13:00:00","2020-06-12",62,4,0,16,1,83
"Westminster","13:00:00","2020-06-12",569,63,0,326,134,1092
"Bromley","14:00:00","2020-06-12",1066,13,4,323,91,1497
"Croydon","14:00:00","2020-06-12",1094,54,156,249,39,1592
"Ealing","14:00:00","2020-06-12",2025,19,3,499,183,2729
"Hammersmith and Fulham","14:00:00","2020-06-12",2223,102,0,641,165,3131
"Hounslow","14:00:00","2020-06-12",2730,22,2,838,224,3816
"Kingston upon Thames","14:00:00","2020-06-12",147,1,13,46,2,209
"Southwark","14:00:00","2020-06-12",69,6,0,14,1,90
"Westminster","14:00:00","2020-06-12",541,67,0,328,89,1025
"Bromley","15:00:00","2020-06-12",1159,16,5,304,49,1533
"Croydon","15:00:00","2020-06-12",1110,53,154,229,40,1586
"Ealing","15:00:00","2020-06-12",2107,28,3,480,123,2741
"Hammersmith and Fulham","15:00:00","2020-06-12",2364,95,0,626,123,3208
"Hounslow","15:00:00","2020-06-12",3105,36,5,897,197,4240
"Kingston upon Thames","15:00:00","2020-06-12",176,5,11,36,4,232
"Southwark","15:00:00","2020-06-12",74,2,0,9,2,87
"Westminster","15:00:00","2020-06-12",562,82,0,315,73,1032
"Bromley","16:00:00","2020-06-12",1236,18,5,286,36,1581
"Croydon","16:00:00","2020-06-12",1233,50,154,217,28,1682
"Ealing","16:00:00","2020-06-12",1919,38,0,408,96,2461
"Hammersmith and Fulham","16:00:00","2020-06-12",2720,130,1,608,84,3543
"Hounslow","16:00:00","2020-06-12",3330,25,2,761,142,4260
"Kingston upon Thames","16:00:00","2020-06-12",182,3,13,36,2,236
"Southwark","16:00:00","2020-06-12",65,8,0,4,0,77
"Westminster","16:00:00","2020-06-12",579,93,1,248,48,969
"Bromley","17:00:00","2020-06-12",1202,18,4,199,33,1456
"Croydon","17:00:00","2020-06-12",1271,74,145,173,16,1679
"Ealing","17:00:00","2020-06-12",2090,32,0,385,69,2576
"Hammersmith and Fulham","17:00:00","2020-06-12",2876,167,0,465,62,3570
"Hounslow","17:00:00","2020-06-12",3518,44,0,574,93,4229
"Kingston upon Thames","17:00:00","2020-06-12",160,9,11,35,2,217
"Southwark","17:00:00","2020-06-12",95,10,0,10,0,115
"Westminster","17:00:00","2020-06-12",810,102,1,203,30,1146
"Bromley","18:00:00","2020-06-12",1035,15,5,147,16,1218
"Croydon","18:00:00","2020-06-12",1113,74,159,117,10,1473
"Ealing","18:00:00","2020-06-12",2052,38,1,296,38,2425
"Hammersmith and Fulham","18:00:00","2020-06-12",2829,167,1,298,37,3332
"Hounslow","18:00:00","2020-06-12",2982,27,1,384,66,3460
"Kingston upon Thames","18:00:00","2020-06-12",166,5,12,19,1,203
"Southwark","18:00:00","2020-06-12",91,14,0,6,1,112
"Westminster","18:00:00","2020-06-12",1116,100,0,104,17,1337
"Brent","07:00:00","2020-06-15",3562,153,7,1613,434,5769
"Ealing","07:00:00","2020-06-15",3044,198,27,1156,326,4751
"Hammersmith and Fulham","07:00:00","2020-06-15",2766,217,15,1062,304,4364
"Southwark","07:00:00","2020-06-15",41,4,0,35,20,100
"Brent","08:00:00","2020-06-15",3257,77,7,1362,465,5168
"Ealing","08:00:00","2020-06-15",3245,131,32,1083,350,4841
"Hammersmith and Fulham","08:00:00","2020-06-15",2986,143,18,1017,376,4540
"Havering","08:00:00","2020-06-15",3367,22,1,1850,1648,6888
"Southwark","08:00:00","2020-06-15",82,5,3,36,14,140
"Waltham Forest","08:00:00","2020-06-15",4939,64,7,1811,606,7427
"Brent","09:00:00","2020-06-15",3123,61,8,1188,506,4886
"Ealing","09:00:00","2020-06-15",3132,127,31,1113,432,4835
"Hammersmith and Fulham","09:00:00","2020-06-15",2832,126,20,956,428,4362
"Havering","09:00:00","2020-06-15",3025,22,2,1376,1612,6037
"Southwark","09:00:00","2020-06-15",71,5,2,45,29,152
"Waltham Forest","09:00:00","2020-06-15",4290,45,11,1655,648,6649
"Brent","10:00:00","2020-06-15",2969,66,1,1122,518,4676
"Ealing","10:00:00","2020-06-15",2979,120,27,1018,449,4593
"Hammersmith and Fulham","10:00:00","2020-06-15",2602,113,17,869,423,4024
"Havering","10:00:00","2020-06-15",3135,17,6,1258,1752,6168
"Southwark","10:00:00","2020-06-15",54,7,0,42,19,122
"Waltham Forest","10:00:00","2020-06-15",4318,49,7,1553,617,6544
"Brent","11:00:00","2020-06-15",3222,58,3,1158,527,4968
"Ealing","11:00:00","2020-06-15",3105,129,29,994,449,4706
"Hammersmith and Fulham","11:00:00","2020-06-15",2708,97,15,842,449,4111
"Havering","11:00:00","2020-06-15",3199,18,4,1262,1772,6255
"Southwark","11:00:00","2020-06-15",60,6,2,35,17,120
"Waltham Forest","11:00:00","2020-06-15",4633,54,4,1554,644,6889
"Brent","12:00:00","2020-06-15",3220,58,0,1103,455,4836
"Ealing","12:00:00","2020-06-15",3123,156,27,1075,430,4811
"Hammersmith and Fulham","12:00:00","2020-06-15",2742,121,20,921,426,4230
"Havering","12:00:00","2020-06-15",2949,17,1,1319,1868,6154
"Southwark","12:00:00","2020-06-15",50,9,2,29,12,102
"Waltham Forest","12:00:00","2020-06-15",4942,48,3,1548,638,7179
"Brent","13:00:00","2020-06-15",3448,81,3,1123,453,5108
"Ealing","13:00:00","2020-06-15",3285,148,21,1061,411,4926
"Hammersmith and Fulham","13:00:00","2020-06-15",2750,107,14,909,372,4152
"Havering","13:00:00","2020-06-15",3183,17,1,1441,1956,6598
"Southwark","13:00:00","2020-06-15",49,10,2,27,22,110
"Waltham Forest","13:00:00","2020-06-15",5120,60,4,1634,563,7381
"Brent","14:00:00","2020-06-15",3448,59,1,1118,394,5020
"Ealing","14:00:00","2020-06-15",3326,145,27,1065,380,4943
"Hammersmith and Fulham","14:00:00","2020-06-15",2866,120,11,884,361,4242
"Havering","14:00:00","2020-06-15",3295,26,9,1650,1936,6916
"Southwark","14:00:00","2020-06-15",58,14,0,34,13,119
"Brent","15:00:00","2020-06-15",3669,82,2,1124,295,5172
"Ealing","15:00:00","2020-06-15",3656,212,23,1010,265,5166
"Hammersmith and Fulham","15:00:00","2020-06-15",3021,161,21,827,277,4307
"Havering","15:00:00","2020-06-15",3728,22,0,1976,1852,7578
"Southwark","15:00:00","2020-06-15",55,18,1,26,1,101
"Brent","16:00:00","2020-06-15",4197,149,3,1183,224,5756
"Ealing","16:00:00","2020-06-15",3908,237,28,950,211,5334
"Hammersmith and Fulham","16:00:00","2020-06-15",3182,171,11,765,204,4333
"Southwark","16:00:00","2020-06-15",63,16,4,22,5,110
"Brent","17:00:00","2020-06-15",4529,177,1,1079,162,5948
"Ealing","17:00:00","2020-06-15",4201,245,21,860,121,5448
"Hammersmith and Fulham","17:00:00","2020-06-15",3417,188,13,682,113,4413
"Southwark","17:00:00","2020-06-15",84,15,0,18,3,120
"Brent","18:00:00","2020-06-15",4599,106,3,772,124,5604
"Ealing","18:00:00","2020-06-15",4386,203,26,556,113,5284
"Hammersmith and Fulham","18:00:00","2020-06-15",3734,160,11,440,84,4429
"Havering","18:00:00","2020-06-15",3613,27,0,960,1015,5615
"Southwark","18:00:00","2020-06-15",95,11,3,5,1,115
"Croydon","07:00:00","2020-06-16",880,17,34,378,47,1356
"Greenwich","07:00:00","2020-06-16",23,0,0,14,0,37
"Islington","07:00:00","2020-06-16",459,39,62,217,42,819
"Croydon","08:00:00","2020-06-16",1116,14,29,283,80,1522
"Greenwich","08:00:00","2020-06-16",29,0,0,7,4,40
"Islington","08:00:00","2020-06-16",533,31,59,227,42,892
"Croydon","09:00:00","2020-06-16",989,9,30,210,56,1294
"Greenwich","09:00:00","2020-06-16",33,0,0,9,2,44
"Islington","09:00:00","2020-06-16",468,36,69,197,36,806
"Croydon","10:00:00","2020-06-16",964,8,35,214,58,1279
"Greenwich","10:00:00","2020-06-16",36,0,0,11,3,50
"Islington","10:00:00","2020-06-16",411,43,77,211,44,786
"Croydon","11:00:00","2020-06-16",973,18,28,211,65,1295
"Greenwich","11:00:00","2020-06-16",42,0,0,10,3,55
"Islington","11:00:00","2020-06-16",499,55,71,199,51,875
"Croydon","12:00:00","2020-06-16",1156,17,29,232,73,1507
"Greenwich","12:00:00","2020-06-16",61,0,0,12,0,73
"Islington","12:00:00","2020-06-16",494,86,71,228,41,920
"Croydon","13:00:00","2020-06-16",1241,23,28,263,48,1603
"Greenwich","13:00:00","2020-06-16",36,0,0,11,2,49
"Islington","13:00:00","2020-06-16",536,94,74,179,30,913
"Croydon","14:00:00","2020-06-16",1267,24,27,250,64,1632
"Greenwich","14:00:00","2020-06-16",42,1,0,8,1,52
"Islington","14:00:00","2020-06-16",549,103,69,203,27,951
"Croydon","15:00:00","2020-06-16",1297,27,27,294,53,1698
"Greenwich","15:00:00","2020-06-16",63,1,0,9,2,75
"Islington","15:00:00","2020-06-16",609,64,71,229,18,991
"Croydon","16:00:00","2020-06-16",1323,30,29,316,28,1726
"Greenwich","16:00:00","2020-06-16",47,2,0,5,1,55
"Islington","16:00:00","2020-06-16",629,71,74,198,11,983
"Croydon","17:00:00","2020-06-16",1371,37,26,249,25,1708
"Greenwich","17:00:00","2020-06-16",49,1,0,4,0,54
"Islington","17:00:00","2020-06-16",697,106,69,162,10,1044
"Croydon","18:00:00","2020-06-16",1176,23,29,169,17,1414
"Greenwich","18:00:00","2020-06-16",30,2,0,7,0,39
"Islington","18:00:00","2020-06-16",689,139,73,98,13,1012
"Bexley","07:00:00","2020-06-17",660,5,52,211,26,954
"Hammersmith and Fulham","07:00:00","2020-06-17",729,76,87,305,51,1248
"Hounslow","07:00:00","2020-06-17",3418,193,23,1510,253,5397
"Kensington and Chelsea","07:00:00","2020-06-17",308,20,21,126,18,493
"Bexley","08:00:00","2020-06-17",749,4,57,205,59,1074
"Hammersmith and Fulham","08:00:00","2020-06-17",805,66,94,244,51,1260
"Hounslow","08:00:00","2020-06-17",3595,132,15,1163,334,5239
"Kensington and Chelsea","08:00:00","2020-06-17",437,14,23,129,21,624
"Bexley","09:00:00","2020-06-17",695,5,60,198,52,1010
"Hammersmith and Fulham","09:00:00","2020-06-17",728,71,85,210,54,1148
"Hounslow","09:00:00","2020-06-17",3486,95,21,996,319,4917
"Kensington and Chelsea","09:00:00","2020-06-17",406,36,23,144,17,626
"Bexley","10:00:00","2020-06-17",739,1,59,171,43,1013
"Hammersmith and Fulham","10:00:00","2020-06-17",742,88,82,216,57,1185
"Hounslow","10:00:00","2020-06-17",3312,90,17,960,298,4677
"Kensington and Chelsea","10:00:00","2020-06-17",362,23,21,140,20,566
"Bexley","11:00:00","2020-06-17",866,3,61,166,43,1139
"Hammersmith and Fulham","11:00:00","2020-06-17",757,126,80,249,40,1252
"Hounslow","11:00:00","2020-06-17",3403,86,13,987,278,4767
"Kensington and Chelsea","11:00:00","2020-06-17",337,47,22,98,21,525
"Bexley","12:00:00","2020-06-17",979,6,62,191,42,1280
"Hammersmith and Fulham","12:00:00","2020-06-17",824,175,84,199,42,1324
"Hounslow","12:00:00","2020-06-17",3564,107,15,933,259,4878
"Kensington and Chelsea","12:00:00","2020-06-17",455,62,17,135,13,682
"Bexley","13:00:00","2020-06-17",1010,5,57,181,73,1326
"Hammersmith and Fulham","13:00:00","2020-06-17",976,140,84,162,30,1392
"Hounslow","13:00:00","2020-06-17",3700,102,15,1076,272,5165
"Kensington and Chelsea","13:00:00","2020-06-17",521,56,22,125,18,742
"Bexley","14:00:00","2020-06-17",1092,6,60,174,47,1379
"Hammersmith and Fulham","14:00:00","2020-06-17",925,137,84,184,39,1369
"Hounslow","14:00:00","2020-06-17",3919,116,16,1131,254,5436
"Kensington and Chelsea","14:00:00","2020-06-17",494,70,20,140,8,732
"Bexley","15:00:00","2020-06-17",1129,14,67,202,37,1449
"Hammersmith and Fulham","15:00:00","2020-06-17",972,125,89,161,19,1366
"Kensington and Chelsea","15:00:00","2020-06-17",508,58,19,99,11,695
"Bexley","16:00:00","2020-06-17",1215,15,59,199,26,1514
"Hammersmith and Fulham","16:00:00","2020-06-17",1076,180,82,155,18,1511
"Kensington and Chelsea","16:00:00","2020-06-17",573,76,20,114,9,792
"Bexley","17:00:00","2020-06-17",1287,18,53,142,20,1520
"Hammersmith and Fulham","17:00:00","2020-06-17",1113,178,82,111,18,1502
"Kensington and Chelsea","17:00:00","2020-06-17",571,64,19,81,10,745
"Bexley","18:00:00","2020-06-17",1005,17,55,84,9,1170
"Hammersmith and Fulham","18:00:00","2020-06-17",1174,194,88,84,18,1558
"Hounslow","18:00:00","2020-06-17",4495,209,12,568,65,5349
"Kensington and Chelsea","18:00:00","2020-06-17",502,104,20,42,12,680
"Brent","07:00:00","2020-06-18",4641,117,27,2084,715,7584
"Harrow","07:00:00","2020-06-18",112,3,0,16,0,131
"Lewisham","07:00:00","2020-06-18",529,9,42,234,33,847
"Merton","07:00:00","2020-06-18",2920,92,3,1241,188,4444
"Newham","07:00:00","2020-06-18",7435,130,20,3007,1261,11853
"Waltham Forest","07:00:00","2020-06-18",281,4,0,94,45,424
"Wandsworth","07:00:00","2020-06-18",704,57,74,336,70,1241
"Brent","08:00:00","2020-06-18",4437,87,17,1871,715,7127
"Harrow","08:00:00","2020-06-18",174,2,0,15,0,191
"Lewisham","08:00:00","2020-06-18",623,7,38,182,35,885
"Merton","08:00:00","2020-06-18",3214,69,2,1020,239,4544
"Newham","08:00:00","2020-06-18",7364,78,41,2750,1290,11523
"Waltham Forest","08:00:00","2020-06-18",324,4,1,72,19,420
"Wandsworth","08:00:00","2020-06-18",731,44,71,249,55,1150
"Brent","09:00:00","2020-06-18",3987,52,29,1663,748,6479
"Harrow","09:00:00","2020-06-18",119,1,0,11,0,131
"Lewisham","09:00:00","2020-06-18",569,14,41,182,55,861
"Merton","09:00:00","2020-06-18",2946,45,1,869,222,4083
"Newham","09:00:00","2020-06-18",6460,57,26,2516,1436,10495
"Waltham Forest","09:00:00","2020-06-18",328,0,0,64,25,417
"Wandsworth","09:00:00","2020-06-18",658,55,70,237,87,1107
"Brent","10:00:00","2020-06-18",3995,47,18,1556,793,6409
"Harrow","10:00:00","2020-06-18",73,0,0,7,1,81
"Lewisham","10:00:00","2020-06-18",616,10,35,193,45,899
"Merton","10:00:00","2020-06-18",2947,49,3,925,246,4170
"Newham","10:00:00","2020-06-18",6307,45,18,2519,1585,10474
"Waltham Forest","10:00:00","2020-06-18",336,0,0,63,22,421
"Wandsworth","10:00:00","2020-06-18",638,40,78,251,97,1104
"Brent","11:00:00","2020-06-18",4088,53,18,1468,810,6437
"Harrow","11:00:00","2020-06-18",101,3,0,16,0,120
"Lewisham","11:00:00","2020-06-18",672,22,38,191,43,966
"Merton","11:00:00","2020-06-18",2949,39,1,892,270,4151
"Newham","11:00:00","2020-06-18",7151,63,11,2687,1450,11362
"Waltham Forest","11:00:00","2020-06-18",346,2,1,59,24,432
"Wandsworth","11:00:00","2020-06-18",612,55,62,227,84,1040
"Brent","12:00:00","2020-06-18",4206,66,17,1412,776,6477
"Harrow","12:00:00","2020-06-18",97,3,0,14,0,114
"Lewisham","12:00:00","2020-06-18",729,22,37,159,37,984
"Merton","12:00:00","2020-06-18",3166,38,1,877,257,4339
"Newham","12:00:00","2020-06-18",8001,43,9,2577,1436,12066
"Waltham Forest","12:00:00","2020-06-18",390,3,0,54,15,462
"Wandsworth","12:00:00","2020-06-18",691,76,69,219,73,1128
"Brent","13:00:00","2020-06-18",4465,62,20,1332,640,6519
"Harrow","13:00:00","2020-06-18",99,0,0,12,0,111
"Lewisham","13:00:00","2020-06-18",737,23,34,141,43,978
"Merton","13:00:00","2020-06-18",3171,39,1,927,221,4359
"Waltham Forest","13:00:00","2020-06-18",411,1,0,75,15,502
"Wandsworth","13:00:00","2020-06-18",643,89,73,219,77,1101
"Brent","14:00:00","2020-06-18",4733,47,15,1359,608,6762
"Harrow","14:00:00","2020-06-18",144,1,0,11,0,156
"Lewisham","14:00:00","2020-06-18",790,31,38,153,39,1051
"Merton","14:00:00","2020-06-18",3405,41,2,949,247,4644
"Waltham Forest","14:00:00","2020-06-18",440,2,0,66,16,524
"Wandsworth","14:00:00","2020-06-18",683,101,70,216,48,1118
"Brent","15:00:00","2020-06-18",5431,100,17,1570,510,7628
"Harrow","15:00:00","2020-06-18",164,1,0,17,0,182
"Lewisham","15:00:00","2020-06-18",822,22,38,176,24,1082
"Merton","15:00:00","2020-06-18",3799,63,2,1056,181,5101
"Waltham Forest","15:00:00","2020-06-18",498,7,0,67,19,591
"Wandsworth","15:00:00","2020-06-18",804,84,69,226,58,1241
"Brent","16:00:00","2020-06-18",5791,106,15,1541,373,7826
"Harrow","16:00:00","2020-06-18",159,0,0,14,0,173
"Lewisham","16:00:00","2020-06-18",866,33,35,154,14,1102
"Waltham Forest","16:00:00","2020-06-18",512,9,0,76,9,606
"Wandsworth","16:00:00","2020-06-18",845,118,82,184,33,1262
"Brent","17:00:00","2020-06-18",6254,152,14,1335,267,8022
"Harrow","17:00:00","2020-06-18",167,2,0,21,0,190
"Lewisham","17:00:00","2020-06-18",856,45,34,140,10,1085
"Waltham Forest","17:00:00","2020-06-18",545,7,0,45,5,602
"Wandsworth","17:00:00","2020-06-18",975,117,67,142,12,1313
"Brent","18:00:00","2020-06-18",6147,131,17,947,209,7451
"Harrow","18:00:00","2020-06-18",134,2,0,8,0,144
"Lewisham","18:00:00","2020-06-18",855,31,32,99,14,1031
"Merton","18:00:00","2020-06-18",4056,97,1,533,64,4751
"Waltham Forest","18:00:00","2020-06-18",433,6,0,35,1,475
"Wandsworth","18:00:00","2020-06-18",1048,163,79,120,11,1421
"Barking and Dagenham","07:00:00","2020-06-19",40,0,0,3,0,43
"Bromley","07:00:00","2020-06-19",204,2,0,149,8,363
"Hackney","07:00:00","2020-06-19",863,25,25,442,159,1514
"Kingston upon Thames","07:00:00","2020-06-19",3,0,0,0,1,4
"Barking and Dagenham","08:00:00","2020-06-19",45,0,0,9,1,55
"Bromley","08:00:00","2020-06-19",261,1,0,154,8,424
"Hackney","08:00:00","2020-06-19",860,16,27,380,149,1432
"Kingston upon Thames","08:00:00","2020-06-19",15,0,0,8,1,24
"Barking and Dagenham","09:00:00","2020-06-19",61,0,0,15,1,77
"Bromley","09:00:00","2020-06-19",269,0,0,140,6,415
"Hackney","09:00:00","2020-06-19",879,22,29,339,173,1442
"Kingston upon Thames","09:00:00","2020-06-19",15,0,0,6,0,21
"Barking and Dagenham","10:00:00","2020-06-19",52,0,1,11,0,64
"Bromley","10:00:00","2020-06-19",268,0,0,145,12,425
"Hackney","10:00:00","2020-06-19",905,21,25,300,182,1433
"Kingston upon Thames","10:00:00","2020-06-19",27,0,0,6,0,33
"Barking and Dagenham","11:00:00","2020-06-19",56,0,0,14,0,70
"Bromley","11:00:00","2020-06-19",305,2,0,142,8,457
"Hackney","11:00:00","2020-06-19",1000,18,22,306,156,1502
"Kingston upon Thames","11:00:00","2020-06-19",18,0,0,5,2,25
"Barking and Dagenham","12:00:00","2020-06-19",63,0,0,16,1,80
"Bromley","12:00:00","2020-06-19",378,1,0,137,8,524
"Hackney","12:00:00","2020-06-19",1016,23,26,277,156,1498
"Kingston upon Thames","12:00:00","2020-06-19",24,2,0,4,0,30
"Barking and Dagenham","13:00:00","2020-06-19",57,0,0,11,0,68
"Bromley","13:00:00","2020-06-19",403,4,0,123,5,535
"Hackney","13:00:00","2020-06-19",1186,38,32,264,152,1672
"Kingston upon Thames","13:00:00","2020-06-19",25,1,0,7,2,35
"Barking and Dagenham","14:00:00","2020-06-19",69,0,0,11,1,81
"Bromley","14:00:00","2020-06-19",381,5,0,137,10,533
"Hackney","14:00:00","2020-06-19",1214,28,35,240,104,1621
"Kingston upon Thames","14:00:00","2020-06-19",21,0,0,3,0,24
"Barking and Dagenham","15:00:00","2020-06-19",63,3,0,3,0,69
"Bromley","15:00:00","2020-06-19",390,6,0,116,6,518
"Hackney","15:00:00","2020-06-19",1323,38,27,255,101,1744
"Kingston upon Thames","15:00:00","2020-06-19",22,1,0,3,0,26
"Barking and Dagenham","16:00:00","2020-06-19",68,2,0,14,1,85
"Bromley","16:00:00","2020-06-19",383,3,0,132,9,527
"Hackney","16:00:00","2020-06-19",1227,49,34,233,78,1621
"Kingston upon Thames","16:00:00","2020-06-19",37,1,0,6,1,45
"Barking and Dagenham","17:00:00","2020-06-19",95,5,0,11,0,111
"Bromley","17:00:00","2020-06-19",376,5,0,58,3,442
"Hackney","17:00:00","2020-06-19",1398,52,27,173,54,1704
"Kingston upon Thames","17:00:00","2020-06-19",23,1,0,3,0,27
"Barking and Dagenham","18:00:00","2020-06-19",85,2,0,7,1,95
"Bromley","18:00:00","2020-06-19",208,3,0,28,1,240
"Hackney","18:00:00","2020-06-19",1457,61,23,170,48,1759
"Kingston upon Thames","18:00:00","2020-06-19",27,0,0,1,0,28
"Havering","07:00:00","2020-06-22",450,4,0,142,13,609
"Westminster","07:00:00","2020-06-22",611,43,43,256,73,1026
"Havering","08:00:00","2020-06-22",624,1,1,122,12,760
"Westminster","08:00:00","2020-06-22",675,44,48,229,95,1091
"Havering","09:00:00","2020-06-22",624,4,6,87,18,739
"Westminster","09:00:00","2020-06-22",794,37,51,231,92,1205
"Havering","10:00:00","2020-06-22",673,5,1,88,27,794
"Westminster","10:00:00","2020-06-22",735,41,48,228,72,1124
"Havering","11:00:00","2020-06-22",706,6,0,103,20,835
"Westminster","11:00:00","2020-06-22",710,62,43,216,79,1110
"Havering","12:00:00","2020-06-22",763,6,0,98,12,879
"Westminster","12:00:00","2020-06-22",774,72,45,219,71,1181
"Havering","13:00:00","2020-06-22",717,7,0,120,17,861
"Westminster","13:00:00","2020-06-22",818,89,45,209,53,1214
"Havering","14:00:00","2020-06-22",859,4,6,96,23,988
"Westminster","14:00:00","2020-06-22",775,67,47,184,61,1134
"Havering","15:00:00","2020-06-22",801,9,1,137,13,961
"Westminster","15:00:00","2020-06-22",880,75,44,243,46,1288
"Havering","16:00:00","2020-06-22",848,6,0,171,14,1039
"Westminster","16:00:00","2020-06-22",874,85,54,169,40,1222
"Havering","17:00:00","2020-06-22",795,9,0,132,6,942
"Westminster","17:00:00","2020-06-22",983,74,52,131,20,1260
"Havering","18:00:00","2020-06-22",554,6,0,76,4,640
"Westminster","18:00:00","2020-06-22",928,107,42,64,33,1174
"Kensington and Chelsea","07:00:00","2020-06-23",2442,212,4,1061,216,3935
"Kingston upon Thames","07:00:00","2020-06-23",9,0,0,2,0,11
"Newham","07:00:00","2020-06-23",4088,316,35,1841,423,6703
"Richmond upon Thames","07:00:00","2020-06-23",41,1,0,12,3,57
"Southwark","07:00:00","2020-06-23",219,15,18,180,17,449
"Sutton","07:00:00","2020-06-23",691,20,19,194,29,953
"Westminster","07:00:00","2020-06-23",665,74,100,364,113,1316
"Kensington and Chelsea","08:00:00","2020-06-23",2664,144,5,976,266,4055
"Kingston upon Thames","08:00:00","2020-06-23",17,0,0,1,0,18
"Newham","08:00:00","2020-06-23",4198,173,42,1584,587,6584
"Richmond upon Thames","08:00:00","2020-06-23",113,1,0,10,3,127
"Southwark","08:00:00","2020-06-23",320,17,23,140,15,515
"Sutton","08:00:00","2020-06-23",732,13,22,138,27,932
"Westminster","08:00:00","2020-06-23",716,53,115,329,129,1342
"Kensington and Chelsea","09:00:00","2020-06-23",2590,117,10,862,266,3845
"Kingston upon Thames","09:00:00","2020-06-23",11,0,0,5,1,17
"Newham","09:00:00","2020-06-23",3906,134,34,1579,643,6296
"Richmond upon Thames","09:00:00","2020-06-23",106,0,0,13,3,122
"Southwark","09:00:00","2020-06-23",285,24,21,108,15,453
"Sutton","09:00:00","2020-06-23",653,14,17,127,34,845
"Westminster","09:00:00","2020-06-23",694,59,122,319,146,1340
"Kensington and Chelsea","10:00:00","2020-06-23",2292,112,8,875,291,3578
"Kingston upon Thames","10:00:00","2020-06-23",14,0,0,2,0,16
"Newham","10:00:00","2020-06-23",3609,148,32,1451,610,5850
"Richmond upon Thames","10:00:00","2020-06-23",91,0,0,18,1,110
"Southwark","10:00:00","2020-06-23",251,14,20,100,17,402
"Sutton","10:00:00","2020-06-23",601,14,18,140,34,807
"Westminster","10:00:00","2020-06-23",664,66,115,298,131,1274
"Kensington and Chelsea","11:00:00","2020-06-23",2335,123,2,902,288,3650
"Kingston upon Thames","11:00:00","2020-06-23",11,0,0,1,2,14
"Newham","11:00:00","2020-06-23",3864,196,35,1354,558,6007
"Richmond upon Thames","11:00:00","2020-06-23",75,1,0,15,1,92
"Southwark","11:00:00","2020-06-23",262,23,23,81,19,408
"Sutton","11:00:00","2020-06-23",609,24,19,120,30,802
"Westminster","11:00:00","2020-06-23",673,75,111,348,100,1307
"Kensington and Chelsea","12:00:00","2020-06-23",2479,104,2,887,260,3732
"Kingston upon Thames","12:00:00","2020-06-23",11,0,0,3,0,14
"Newham","12:00:00","2020-06-23",4206,205,30,1380,567,6388
"Richmond upon Thames","12:00:00","2020-06-23",95,0,0,18,5,118
"Southwark","12:00:00","2020-06-23",283,28,18,108,23,460
"Sutton","12:00:00","2020-06-23",756,28,18,129,30,961
"Westminster","12:00:00","2020-06-23",719,101,111,312,88,1331
"Kensington and Chelsea","13:00:00","2020-06-23",2606,124,3,870,252,3855
"Kingston upon Thames","13:00:00","2020-06-23",11,0,0,2,1,14
"Newham","13:00:00","2020-06-23",4488,244,30,1414,624,6800
"Richmond upon Thames","13:00:00","2020-06-23",93,3,0,20,0,116
"Southwark","13:00:00","2020-06-23",299,33,22,110,16,480
"Sutton","13:00:00","2020-06-23",656,25,18,126,34,859
"Westminster","13:00:00","2020-06-23",756,93,107,296,74,1326
"Kensington and Chelsea","14:00:00","2020-06-23",2750,155,4,845,224,3978
"Kingston upon Thames","14:00:00","2020-06-23",8,1,0,5,0,14
"Newham","14:00:00","2020-06-23",4702,216,26,1393,536,6873
"Richmond upon Thames","14:00:00","2020-06-23",89,2,0,13,5,109
"Southwark","14:00:00","2020-06-23",364,42,19,103,13,541
"Sutton","14:00:00","2020-06-23",744,25,22,171,24,986
"Westminster","14:00:00","2020-06-23",795,88,109,290,65,1347
"Kensington and Chelsea","15:00:00","2020-06-23",2830,165,8,842,169,4014
"Kingston upon Thames","15:00:00","2020-06-23",12,0,0,0,0,12
"Newham","15:00:00","2020-06-23",4972,259,30,1541,380,7182
"Richmond upon Thames","15:00:00","2020-06-23",138,2,0,13,0,153
"Southwark","15:00:00","2020-06-23",442,36,22,128,8,636
"Sutton","15:00:00","2020-06-23",779,20,19,176,21,1015
"Westminster","15:00:00","2020-06-23",817,88,112,283,48,1348
"Kingston upon Thames","16:00:00","2020-06-23",8,0,0,2,0,10
"Newham","16:00:00","2020-06-23",5244,345,29,1371,248,7237
"Richmond upon Thames","16:00:00","2020-06-23",93,1,0,18,1,113
"Southwark","16:00:00","2020-06-23",449,49,20,136,7,661
"Sutton","16:00:00","2020-06-23",866,24,17,209,17,1133
"Westminster","16:00:00","2020-06-23",826,112,111,296,30,1375
"Kingston upon Thames","17:00:00","2020-06-23",12,0,0,3,0,15
"Newham","17:00:00","2020-06-23",6041,404,27,1261,163,7896
"Richmond upon Thames","17:00:00","2020-06-23",71,2,0,8,0,81
"Southwark","17:00:00","2020-06-23",450,57,20,95,8,630
"Sutton","17:00:00","2020-06-23",902,28,18,125,14,1087
"Westminster","17:00:00","2020-06-23",930,110,120,176,30,1366
"Kensington and Chelsea","18:00:00","2020-06-23",3434,205,2,411,77,4129
"Kingston upon Thames","18:00:00","2020-06-23",13,0,0,2,0,15
"Newham","18:00:00","2020-06-23",6389,337,32,993,130,7881
"Richmond upon Thames","18:00:00","2020-06-23",102,5,0,5,1,113
"Southwark","18:00:00","2020-06-23",478,73,22,56,6,635
"Sutton","18:00:00","2020-06-23",782,19,19,95,7,922
"Westminster","18:00:00","2020-06-23",932,112,110,116,28,1298
"City of London","07:00:00","2020-06-24",337,38,41,219,57,692
"Enfield","07:00:00","2020-06-24",5172,119,36,2275,557,8159
"Greenwich","07:00:00","2020-06-24",2760,175,18,1392,356,4701
"Islington","07:00:00","2020-06-24",342,25,44,166,37,614
"Kensington and Chelsea","07:00:00","2020-06-24",47,1,0,18,0,66
"Kingston upon Thames","07:00:00","2020-06-24",1296,40,35,542,80,1993
"Lewisham","07:00:00","2020-06-24",25,1,0,4,4,34
"City of London","08:00:00","2020-06-24",323,38,43,196,57,657
"Enfield","08:00:00","2020-06-24",5249,75,36,1732,592,7684
"Greenwich","08:00:00","2020-06-24",3039,86,21,1092,398,4636
"Islington","08:00:00","2020-06-24",459,21,40,199,45,764
"Kensington and Chelsea","08:00:00","2020-06-24",57,3,0,22,1,83
"Kingston upon Thames","08:00:00","2020-06-24",1571,44,27,447,77,2166
"Lewisham","08:00:00","2020-06-24",41,0,0,12,0,53
"City of London","09:00:00","2020-06-24",330,37,42,192,59,660
"Enfield","09:00:00","2020-06-24",5044,87,43,1534,623,7331
"Greenwich","09:00:00","2020-06-24",3431,77,20,1078,483,5089
"Islington","09:00:00","2020-06-24",432,32,55,199,55,773
"Kensington and Chelsea","09:00:00","2020-06-24",80,4,0,21,6,111
"Kingston upon Thames","09:00:00","2020-06-24",1619,27,28,335,90,2099
"Lewisham","09:00:00","2020-06-24",56,0,0,15,2,73
"City of London","10:00:00","2020-06-24",330,33,44,194,64,665
"Enfield","10:00:00","2020-06-24",4964,73,43,1630,642,7352
"Greenwich","10:00:00","2020-06-24",3761,82,16,1020,486,5365
"Islington","10:00:00","2020-06-24",424,21,44,188,54,731
"Kensington and Chelsea","10:00:00","2020-06-24",67,6,0,36,4,113
"Kingston upon Thames","10:00:00","2020-06-24",1563,29,32,304,80,2008
"Lewisham","10:00:00","2020-06-24",52,0,0,9,7,68
"City of London","11:00:00","2020-06-24",296,37,45,220,60,658
"Enfield","11:00:00","2020-06-24",5123,69,38,1596,553,7379
"Greenwich","11:00:00","2020-06-24",3831,87,12,1042,428,5400
"Islington","11:00:00","2020-06-24",431,33,39,171,48,722
"Kensington and Chelsea","11:00:00","2020-06-24",71,11,0,41,8,131
"Kingston upon Thames","11:00:00","2020-06-24",1561,45,32,328,69,2035
"Lewisham","11:00:00","2020-06-24",29,2,0,19,5,55
"City of London","12:00:00","2020-06-24",325,49,42,217,64,697
"Enfield","12:00:00","2020-06-24",5547,84,40,1468,585,7724
"Greenwich","12:00:00","2020-06-24",3852,83,16,1050,431,5432
"Islington","12:00:00","2020-06-24",474,53,37,195,58,817
"Kensington and Chelsea","12:00:00","2020-06-24",70,5,0,28,5,108
"Kingston upon Thames","12:00:00","2020-06-24",1558,43,31,305,81,2018
"Lewisham","12:00:00","2020-06-24",45,0,0,8,0,53
"City of London","13:00:00","2020-06-24",344,42,40,205,44,675
"Enfield","13:00:00","2020-06-24",5488,119,42,1418,506,7573
"Greenwich","13:00:00","2020-06-24",3865,86,14,1098,466,5529
"Islington","13:00:00","2020-06-24",429,57,39,173,38,736
"Kensington and Chelsea","13:00:00","2020-06-24",87,14,0,28,6,135
"Kingston upon Thames","13:00:00","2020-06-24",1571,58,31,357,75,2092
"Lewisham","13:00:00","2020-06-24",54,3,0,15,3,75
"City of London","14:00:00","2020-06-24",388,45,41,214,52,740
"Enfield","14:00:00","2020-06-24",5494,113,43,1609,458,7717
"Greenwich","14:00:00","2020-06-24",3912,95,16,1189,397,5609
"Islington","14:00:00","2020-06-24",481,40,55,177,33,786
"Kensington and Chelsea","14:00:00","2020-06-24",83,5,0,32,5,125
"Kingston upon Thames","14:00:00","2020-06-24",1585,42,28,374,49,2078
"Lewisham","14:00:00","2020-06-24",46,0,0,8,1,55
"City of London","15:00:00","2020-06-24",373,57,41,242,38,751
"Enfield","15:00:00","2020-06-24",6063,128,40,1709,435,8375
"Greenwich","15:00:00","2020-06-24",4172,128,13,1258,325,5896
"Islington","15:00:00","2020-06-24",547,45,43,172,28,835
"Kensington and Chelsea","15:00:00","2020-06-24",128,12,0,41,6,187
"Kingston upon Thames","15:00:00","2020-06-24",1734,45,28,420,52,2279
"Lewisham","15:00:00","2020-06-24",74,2,0,13,0,89
"City of London","16:00:00","2020-06-24",441,52,32,209,24,758
"Enfield","16:00:00","2020-06-24",6485,161,36,1604,310,8596
"Islington","16:00:00","2020-06-24",529,39,38,173,32,811
"Kensington and Chelsea","16:00:00","2020-06-24",128,10,0,35,5,178
"Kingston upon Thames","16:00:00","2020-06-24",1894,44,24,449,28,2439
"Lewisham","16:00:00","2020-06-24",91,3,0,19,2,115
"City of London","17:00:00","2020-06-24",472,69,43,130,13,727
"Enfield","17:00:00","2020-06-24",6896,182,33,1379,201,8691
"Greenwich","17:00:00","2020-06-24",4713,201,15,1016,118,6063
"Islington","17:00:00","2020-06-24",544,47,38,91,22,742
"Kensington and Chelsea","17:00:00","2020-06-24",150,21,0,22,1,194
"Kingston upon Thames","17:00:00","2020-06-24",1947,64,25,309,22,2367
"Lewisham","17:00:00","2020-06-24",64,3,0,14,1,82
"City of London","18:00:00","2020-06-24",464,50,38,75,20,647
"Enfield","18:00:00","2020-06-24",6488,136,39,1022,121,7806
"Greenwich","18:00:00","2020-06-24",4565,159,20,662,104,5510
"Islington","18:00:00","2020-06-24",567,80,43,66,18,774
"Kensington and Chelsea","18:00:00","2020-06-24",133,19,0,13,0,165
"Kingston upon Thames","18:00:00","2020-06-24",1674,69,26,161,23,1953
"Lewisham","18:00:00","2020-06-24",69,5,0,5,2,81
"Greenwich","07:00:00","2020-06-25",6,0,0,4,0,10
"Hillingdon","07:00:00","2020-06-25",802,17,16,235,60,1130
"Southwark","07:00:00","2020-06-25",736,148,74,411,116,1485
"Barnet","08:00:00","2020-06-25",5640,114,22,2100,709,8585
"Greenwich","08:00:00","2020-06-25",15,0,0,6,1,22
"Hillingdon","08:00:00","2020-06-25",1109,8,21,229,49,1416
"Southwark","08:00:00","2020-06-25",883,88,80,360,154,1565
"Barnet","09:00:00","2020-06-25",5697,101,17,1794,735,8344
"Greenwich","09:00:00","2020-06-25",28,0,0,6,3,37
"Hillingdon","09:00:00","2020-06-25",902,8,14,177,45,1146
"Southwark","09:00:00","2020-06-25",1016,70,69,360,162,1677
"Barnet","10:00:00","2020-06-25",5436,105,14,1660,750,7965
"Greenwich","10:00:00","2020-06-25",32,0,0,6,0,38
"Hillingdon","10:00:00","2020-06-25",880,7,18,215,65,1185
"Southwark","10:00:00","2020-06-25",1087,81,71,392,204,1835
"Barnet","11:00:00","2020-06-25",5574,101,15,1701,761,8152
"Greenwich","11:00:00","2020-06-25",25,1,0,5,2,33
"Hillingdon","11:00:00","2020-06-25",932,14,13,199,54,1212
"Southwark","11:00:00","2020-06-25",1213,72,59,412,185,1941
"Barnet","12:00:00","2020-06-25",5920,96,10,1731,735,8492
"Greenwich","12:00:00","2020-06-25",34,1,0,2,1,38
"Hillingdon","12:00:00","2020-06-25",1026,15,13,176,39,1269
"Southwark","12:00:00","2020-06-25",1214,98,64,413,145,1934
"Barnet","13:00:00","2020-06-25",5989,135,18,1784,707,8633
"Greenwich","13:00:00","2020-06-25",33,1,0,10,3,47
"Hillingdon","13:00:00","2020-06-25",1021,20,18,197,25,1281
"Southwark","13:00:00","2020-06-25",1236,110,60,440,148,1994
"Barnet","14:00:00","2020-06-25",6352,129,15,1827,665,8988
"Greenwich","14:00:00","2020-06-25",36,1,0,11,0,48
"Hillingdon","14:00:00","2020-06-25",1128,8,20,229,46,1431
"Southwark","14:00:00","2020-06-25",1334,130,65,437,116,2082
"Greenwich","15:00:00","2020-06-25",41,2,0,13,0,56
"Hillingdon","15:00:00","2020-06-25",1245,14,16,220,29,1524
"Southwark","15:00:00","2020-06-25",1307,126,63,428,90,2014
"Greenwich","16:00:00","2020-06-25",47,4,0,8,1,60
"Hillingdon","16:00:00","2020-06-25",1157,24,14,232,31,1458
"Southwark","16:00:00","2020-06-25",1339,174,70,364,67,2014
"Greenwich","17:00:00","2020-06-25",26,0,0,9,1,36
"Hillingdon","17:00:00","2020-06-25",1254,18,14,216,14,1516
"Southwark","17:00:00","2020-06-25",1404,205,68,286,50,2013
"Barnet","18:00:00","2020-06-25",7259,159,16,1264,207,8905
"Greenwich","18:00:00","2020-06-25",43,3,0,4,0,50
"Hillingdon","18:00:00","2020-06-25",1067,27,15,128,6,1243
"Southwark","18:00:00","2020-06-25",1497,153,75,211,43,1979
"Barnet","07:00:00","2020-06-26",4014,128,25,2085,535,6787
"Brent","07:00:00","2020-06-26",1440,49,56,549,81,2175
"Camden","07:00:00","2020-06-26",273,16,14,142,27,472
"Westminster","07:00:00","2020-06-26",188,9,14,93,21,325
"Barnet","08:00:00","2020-06-26",4189,81,25,1428,526,6249
"Brent","08:00:00","2020-06-26",1712,39,58,473,96,2378
"Camden","08:00:00","2020-06-26",354,11,19,125,26,535
"Westminster","08:00:00","2020-06-26",229,9,11,91,22,362
"Barnet","09:00:00","2020-06-26",3964,65,20,1176,481,5706
"Brent","09:00:00","2020-06-26",1677,56,55,440,114,2342
"Camden","09:00:00","2020-06-26",280,13,18,113,30,454
"Westminster","09:00:00","2020-06-26",227,7,12,82,14,342
"Barnet","10:00:00","2020-06-26",3974,61,30,1140,452,5657
"Brent","10:00:00","2020-06-26",1649,42,54,432,96,2273
"Camden","10:00:00","2020-06-26",294,22,13,152,41,522
"Westminster","10:00:00","2020-06-26",206,16,15,80,15,332
"Barnet","11:00:00","2020-06-26",4030,61,22,1094,451,5658
"Brent","11:00:00","2020-06-26",1816,69,56,465,85,2491
"Camden","11:00:00","2020-06-26",350,25,17,167,39,598
"Westminster","11:00:00","2020-06-26",199,23,12,60,18,312
"Barnet","12:00:00","2020-06-26",4279,69,21,1150,419,5938
"Brent","12:00:00","2020-06-26",2070,72,62,403,89,2696
"Camden","12:00:00","2020-06-26",437,54,15,164,40,710
"Westminster","12:00:00","2020-06-26",234,26,12,74,15,361
"Barnet","13:00:00","2020-06-26",4590,88,20,1212,399,6309
"Brent","13:00:00","2020-06-26",2205,83,50,418,84,2840
"Camden","13:00:00","2020-06-26",433,54,18,161,26,692
"Westminster","13:00:00","2020-06-26",244,22,13,74,12,365
"Barnet","14:00:00","2020-06-26",4832,94,25,1298,346,6595
"Brent","14:00:00","2020-06-26",2268,70,57,438,72,2905
"Camden","14:00:00","2020-06-26",469,61,18,149,26,723
"Westminster","14:00:00","2020-06-26",240,24,11,68,15,358
"Barnet","15:00:00","2020-06-26",5087,96,19,1415,359,6976
"Brent","15:00:00","2020-06-26",2309,97,48,408,81,2943
"Camden","15:00:00","2020-06-26",503,51,14,167,41,776
"Westminster","15:00:00","2020-06-26",215,24,12,56,7,314
"Barnet","16:00:00","2020-06-26",5775,149,32,1401,245,7602
"Brent","16:00:00","2020-06-26",2306,85,51,471,44,2957
"Camden","16:00:00","2020-06-26",605,51,16,147,27,846
"Westminster","16:00:00","2020-06-26",257,27,13,34,10,341
"Barnet","17:00:00","2020-06-26",6224,129,18,1109,207,7687
"Brent","17:00:00","2020-06-26",2354,136,47,428,31,2996
"Camden","17:00:00","2020-06-26",590,77,15,100,22,804
"Westminster","17:00:00","2020-06-26",339,45,12,66,1,463
"Barnet","18:00:00","2020-06-26",5975,117,30,725,147,6994
"Brent","18:00:00","2020-06-26",2361,116,53,333,43,2906
"Camden","18:00:00","2020-06-26",526,79,15,69,13,702
"Westminster","18:00:00","2020-06-26",375,44,12,37,7,475
"Lewisham","07:00:00","2020-06-29",1,0,0,2,0,3
"Merton","07:00:00","2020-06-29",141,4,0,67,3,215
"Newham","07:00:00","2020-06-29",1266,69,81,389,85,1890
"Southwark","07:00:00","2020-06-29",817,90,40,744,89,1780
"Waltham Forest","07:00:00","2020-06-29",354,14,42,95,15,520
"Lewisham","08:00:00","2020-06-29",4,0,0,2,1,7
"Merton","08:00:00","2020-06-29",161,4,0,34,5,204
"Newham","08:00:00","2020-06-29",1222,47,93,302,84,1748
"Southwark","08:00:00","2020-06-29",883,65,41,650,99,1738
"Waltham Forest","08:00:00","2020-06-29",428,13,45,114,19,619
"Lewisham","09:00:00","2020-06-29",6,0,0,0,0,6
"Merton","09:00:00","2020-06-29",123,7,0,35,5,170
"Newham","09:00:00","2020-06-29",1205,39,83,338,85,1750
"Southwark","09:00:00","2020-06-29",853,53,41,544,103,1594
"Waltham Forest","09:00:00","2020-06-29",458,13,40,111,25,647
"Lewisham","10:00:00","2020-06-29",6,1,0,3,0,10
"Merton","10:00:00","2020-06-29",128,10,0,25,3,166
"Newham","10:00:00","2020-06-29",1129,63,79,346,107,1724
"Southwark","10:00:00","2020-06-29",784,53,43,483,96,1459
"Waltham Forest","10:00:00","2020-06-29",492,17,49,121,21,700
"Lewisham","11:00:00","2020-06-29",5,0,0,0,0,5
"Merton","11:00:00","2020-06-29",160,4,0,43,1,208
"Newham","11:00:00","2020-06-29",1251,89,86,345,119,1890
"Southwark","11:00:00","2020-06-29",788,64,38,480,116,1486
"Waltham Forest","11:00:00","2020-06-29",543,39,44,119,20,765
"Lewisham","12:00:00","2020-06-29",8,0,0,3,1,12
"Merton","12:00:00","2020-06-29",152,2,0,36,0,190
"Newham","12:00:00","2020-06-29",1404,122,83,327,94,2030
"Southwark","12:00:00","2020-06-29",763,55,40,482,97,1437
"Waltham Forest","12:00:00","2020-06-29",587,55,41,104,26,813
"Lewisham","13:00:00","2020-06-29",7,0,0,1,0,8
"Merton","13:00:00","2020-06-29",151,3,0,34,1,189
"Newham","13:00:00","2020-06-29",1488,107,83,338,98,2114
"Southwark","13:00:00","2020-06-29",854,79,43,475,97,1548
"Waltham Forest","13:00:00","2020-06-29",634,68,45,108,19,874
"Lewisham","14:00:00","2020-06-29",17,1,0,1,0,19
"Merton","14:00:00","2020-06-29",164,13,0,40,4,221
"Newham","14:00:00","2020-06-29",1632,98,77,335,72,2214
"Southwark","14:00:00","2020-06-29",888,88,35,534,86,1631
"Waltham Forest","14:00:00","2020-06-29",638,33,43,102,13,829
"Lewisham","15:00:00","2020-06-29",17,1,0,3,0,21
"Merton","15:00:00","2020-06-29",188,9,0,62,3,262
"Newham","15:00:00","2020-06-29",1751,112,79,305,69,2316
"Southwark","15:00:00","2020-06-29",854,92,38,578,69,1631
"Waltham Forest","15:00:00","2020-06-29",758,32,44,91,14,939
"Lewisham","16:00:00","2020-06-29",10,1,0,3,0,14
"Merton","16:00:00","2020-06-29",212,7,0,69,2,290
"Newham","16:00:00","2020-06-29",1838,125,88,317,59,2427
"Southwark","16:00:00","2020-06-29",1025,109,34,515,48,1731
"Waltham Forest","16:00:00","2020-06-29",756,55,42,101,17,971
"Lewisham","17:00:00","2020-06-29",8,1,0,2,0,11
"Merton","17:00:00","2020-06-29",230,8,0,58,1,297
"Newham","17:00:00","2020-06-29",2040,102,82,296,24,2544
"Southwark","17:00:00","2020-06-29",1129,117,38,444,26,1754
"Waltham Forest","17:00:00","2020-06-29",745,65,43,75,8,936
"Lewisham","18:00:00","2020-06-29",11,0,0,1,0,12
"Merton","18:00:00","2020-06-29",176,11,0,31,1,219
"Newham","18:00:00","2020-06-29",1947,137,78,219,30,2411
"Southwark","18:00:00","2020-06-29",1289,102,39,299,32,1761
"Waltham Forest","18:00:00","2020-06-29",748,70,40,70,6,934
"Bexley","07:00:00","2020-06-30",837,19,5,278,130,1269
"Brent","07:00:00","2020-06-30",1429,37,34,726,212,2438
"Croydon","07:00:00","2020-06-30",912,34,37,335,173,1491
"Ealing","07:00:00","2020-06-30",327,19,17,114,23,500
"Westminster","07:00:00","2020-06-30",520,70,51,231,50,922
"Bexley","08:00:00","2020-06-30",833,7,5,356,141,1342
"Brent","08:00:00","2020-06-30",1351,30,31,621,232,2265
"Croydon","08:00:00","2020-06-30",1082,16,38,389,148,1673
"Ealing","08:00:00","2020-06-30",415,18,12,98,26,569
"Westminster","08:00:00","2020-06-30",684,65,49,229,78,1105
"Bexley","09:00:00","2020-06-30",695,7,2,344,136,1184
"Brent","09:00:00","2020-06-30",1275,30,31,526,267,2129
"Croydon","09:00:00","2020-06-30",1118,24,33,364,163,1702
"Ealing","09:00:00","2020-06-30",389,18,15,116,39,577
"Westminster","09:00:00","2020-06-30",622,46,48,230,73,1019
"Bexley","10:00:00","2020-06-30",665,3,2,316,138,1124
"Brent","10:00:00","2020-06-30",1278,21,28,519,269,2115
"Croydon","10:00:00","2020-06-30",1300,18,34,316,136,1804
"Ealing","10:00:00","2020-06-30",351,14,14,147,34,560
"Westminster","10:00:00","2020-06-30",561,46,43,240,70,960
"Bexley","11:00:00","2020-06-30",720,2,2,311,116,1151
"Brent","11:00:00","2020-06-30",1382,23,27,478,252,2162
"Croydon","11:00:00","2020-06-30",1410,16,33,264,133,1856
"Ealing","11:00:00","2020-06-30",357,17,11,142,42,569
"Westminster","11:00:00","2020-06-30",543,57,45,228,62,935
"Bexley","12:00:00","2020-06-30",782,7,3,242,131,1165
"Brent","12:00:00","2020-06-30",1418,30,24,431,232,2135
"Croydon","12:00:00","2020-06-30",1523,35,32,248,136,1974
"Ealing","12:00:00","2020-06-30",426,38,12,134,48,658
"Westminster","12:00:00","2020-06-30",628,63,45,170,75,981
"Bexley","13:00:00","2020-06-30",934,6,5,246,131,1322
"Brent","13:00:00","2020-06-30",1476,34,25,436,207,2178
"Croydon","13:00:00","2020-06-30",1554,42,32,260,109,1997
"Ealing","13:00:00","2020-06-30",431,48,17,137,35,668
"Westminster","13:00:00","2020-06-30",576,95,42,153,62,928
"Bexley","14:00:00","2020-06-30",1017,9,4,225,165,1420
"Brent","14:00:00","2020-06-30",1478,23,24,429,209,2163
"Croydon","14:00:00","2020-06-30",1547,30,35,228,116,1956
"Ealing","14:00:00","2020-06-30",446,43,15,150,37,691
"Westminster","14:00:00","2020-06-30",640,82,42,160,45,969
"Bexley","15:00:00","2020-06-30",1052,12,2,206,118,1390
"Brent","15:00:00","2020-06-30",1518,35,27,497,199,2276
"Croydon","15:00:00","2020-06-30",1610,42,37,230,118,2037
"Ealing","15:00:00","2020-06-30",519,31,13,160,37,760
"Westminster","15:00:00","2020-06-30",695,92,46,169,45,1047
"Bexley","16:00:00","2020-06-30",1236,16,0,223,90,1565
"Brent","16:00:00","2020-06-30",1619,42,25,441,159,2286
"Croydon","16:00:00","2020-06-30",1563,60,36,241,79,1979
"Ealing","16:00:00","2020-06-30",504,34,10,125,19,692
"Westminster","16:00:00","2020-06-30",636,86,47,154,29,952
"Bexley","17:00:00","2020-06-30",1333,15,0,208,83,1639
"Brent","17:00:00","2020-06-30",1736,40,27,344,91,2238
"Croydon","17:00:00","2020-06-30",1672,56,32,226,57,2043
"Ealing","17:00:00","2020-06-30",537,64,15,108,14,738
"Westminster","17:00:00","2020-06-30",733,82,47,114,15,991
"Bexley","18:00:00","2020-06-30",1209,9,6,112,58,1394
"Brent","18:00:00","2020-06-30",1699,42,26,256,84,2107
"Croydon","18:00:00","2020-06-30",1564,58,35,217,36,1910
"Ealing","18:00:00","2020-06-30",572,56,17,106,8,759
"Westminster","18:00:00","2020-06-30",773,107,45,72,12,1009
"Barnet","07:00:00","2020-07-01",4392,185,16,2076,492,7161
"Brent","07:00:00","2020-07-01",330,28,75,132,53,618
"Hackney","07:00:00","2020-07-01",880,56,50,352,62,1400
"Havering","07:00:00","2020-07-01",183,6,10,52,9,260
"Hounslow","07:00:00","2020-07-01",1782,64,18,727,159,2750
"Westminster","07:00:00","2020-07-01",402,63,118,202,53,838
"Barnet","08:00:00","2020-07-01",4679,97,18,1718,570,7082
"Brent","08:00:00","2020-07-01",392,20,82,167,50,711
"Hackney","08:00:00","2020-07-01",863,34,49,314,71,1331
"Havering","08:00:00","2020-07-01",205,1,11,48,5,270
"Hounslow","08:00:00","2020-07-01",1736,43,14,514,182,2489
"Westminster","08:00:00","2020-07-01",392,37,118,192,75,814
"Barnet","09:00:00","2020-07-01",4519,100,13,1604,601,6837
"Brent","09:00:00","2020-07-01",302,28,76,172,57,635
"Hackney","09:00:00","2020-07-01",854,25,45,281,59,1264
"Havering","09:00:00","2020-07-01",200,2,9,35,8,254
"Hounslow","09:00:00","2020-07-01",1533,34,17,390,195,2169
"Westminster","09:00:00","2020-07-01",414,49,108,201,73,845
"Barnet","10:00:00","2020-07-01",4355,92,19,1596,621,6683
"Brent","10:00:00","2020-07-01",371,33,76,128,53,661
"Hackney","10:00:00","2020-07-01",815,44,45,235,66,1205
"Havering","10:00:00","2020-07-01",165,3,10,33,8,219
"Hounslow","10:00:00","2020-07-01",1406,28,14,381,179,2008
"Westminster","10:00:00","2020-07-01",434,39,115,241,58,887
"Barnet","11:00:00","2020-07-01",4732,86,18,1542,598,6976
"Brent","11:00:00","2020-07-01",362,48,70,129,47,656
"Hackney","11:00:00","2020-07-01",872,52,46,259,62,1291
"Havering","11:00:00","2020-07-01",205,3,11,36,7,262
"Hounslow","11:00:00","2020-07-01",1556,32,16,377,194,2175
"Westminster","11:00:00","2020-07-01",408,50,100,191,56,805
"Barnet","12:00:00","2020-07-01",4887,78,16,1465,579,7025
"Brent","12:00:00","2020-07-01",427,72,76,132,47,754
"Hackney","12:00:00","2020-07-01",876,51,47,253,75,1302
"Havering","12:00:00","2020-07-01",238,1,10,40,7,296
"Hounslow","12:00:00","2020-07-01",1495,51,11,421,157,2135
"Westminster","12:00:00","2020-07-01",397,64,114,190,53,818
"Barnet","13:00:00","2020-07-01",5025,80,13,1413,547,7078
"Brent","13:00:00","2020-07-01",470,71,78,132,38,789
"Hackney","13:00:00","2020-07-01",894,69,44,221,54,1282
"Havering","13:00:00","2020-07-01",228,5,10,47,4,294
"Hounslow","13:00:00","2020-07-01",1635,49,13,404,142,2243
"Westminster","13:00:00","2020-07-01",438,69,101,176,49,833
"Barnet","14:00:00","2020-07-01",5231,99,18,1472,429,7249
"Brent","14:00:00","2020-07-01",499,61,78,133,36,807
"Hackney","14:00:00","2020-07-01",900,54,50,202,38,1244
"Havering","14:00:00","2020-07-01",267,1,11,56,7,342
"Hounslow","14:00:00","2020-07-01",1665,49,13,411,160,2298
"Westminster","14:00:00","2020-07-01",413,46,112,205,38,814
"Barnet","15:00:00","2020-07-01",5215,97,18,1518,349,7197
"Brent","15:00:00","2020-07-01",557,77,74,123,35,866
"Hackney","15:00:00","2020-07-01",943,59,44,217,34,1297
"Havering","15:00:00","2020-07-01",234,10,10,64,7,325
"Hounslow","15:00:00","2020-07-01",1814,35,18,424,119,2410
"Westminster","15:00:00","2020-07-01",496,73,104,187,28,888
"Barnet","16:00:00","2020-07-01",5718,157,9,1590,277,7751
"Brent","16:00:00","2020-07-01",532,51,83,122,35,823
"Hackney","16:00:00","2020-07-01",898,61,49,184,30,1222
"Havering","16:00:00","2020-07-01",297,4,10,54,5,370
"Hounslow","16:00:00","2020-07-01",2050,75,15,387,90,2617
"Westminster","16:00:00","2020-07-01",497,67,112,164,12,852
"Barnet","17:00:00","2020-07-01",6106,176,12,1283,169,7746
"Brent","17:00:00","2020-07-01",637,80,75,116,14,922
"Hackney","17:00:00","2020-07-01",991,64,45,167,13,1280
"Havering","17:00:00","2020-07-01",294,12,10,50,3,369
"Hounslow","17:00:00","2020-07-01",2177,81,15,297,46,2616
"Westminster","17:00:00","2020-07-01",455,52,111,100,13,731
"Barnet","18:00:00","2020-07-01",6294,126,15,1046,173,7654
"Brent","18:00:00","2020-07-01",543,84,81,77,17,802
"Hackney","18:00:00","2020-07-01",1118,67,45,132,16,1378
"Havering","18:00:00","2020-07-01",282,5,11,41,0,339
"Hounslow","18:00:00","2020-07-01",1823,64,15,208,38,2148
"Westminster","18:00:00","2020-07-01",476,65,108,60,12,721
"Barking and Dagenham","07:00:00","2020-07-02",27,2,0,4,1,34
"Camden","07:00:00","2020-07-02",463,27,1,307,66,864
"Greenwich","07:00:00","2020-07-02",43,1,12,10,3,69
"Haringey","07:00:00","2020-07-02",6,0,0,2,0,8
"Hounslow","07:00:00","2020-07-02",33,0,0,14,1,48
"Lewisham","07:00:00","2020-07-02",274,7,12,93,8,394
"Waltham Forest","07:00:00","2020-07-02",9,0,0,1,0,10
"Barking and Dagenham","08:00:00","2020-07-02",30,0,0,5,1,36
"Camden","08:00:00","2020-07-02",563,18,0,222,52,855
"Greenwich","08:00:00","2020-07-02",65,0,11,11,2,89
"Haringey","08:00:00","2020-07-02",9,0,0,0,1,10
"Hounslow","08:00:00","2020-07-02",56,0,0,9,1,66
"Lewisham","08:00:00","2020-07-02",425,9,14,105,8,561
"Waltham Forest","08:00:00","2020-07-02",14,0,0,3,2,19
"Barking and Dagenham","09:00:00","2020-07-02",21,0,0,1,1,23
"Camden","09:00:00","2020-07-02",506,23,0,210,48,787
"Greenwich","09:00:00","2020-07-02",65,2,10,14,5,96
"Haringey","09:00:00","2020-07-02",24,1,0,3,0,28
"Hounslow","09:00:00","2020-07-02",40,3,0,12,3,58
"Lewisham","09:00:00","2020-07-02",359,8,10,63,13,453
"Waltham Forest","09:00:00","2020-07-02",14,0,0,1,0,15
"Barking and Dagenham","10:00:00","2020-07-02",39,0,0,10,2,51
"Camden","10:00:00","2020-07-02",464,35,0,195,64,758
"Greenwich","10:00:00","2020-07-02",46,1,10,16,4,77
"Haringey","10:00:00","2020-07-02",29,0,0,3,2,34
"Hounslow","10:00:00","2020-07-02",45,2,0,6,1,54
"Lewisham","10:00:00","2020-07-02",345,7,10,81,10,453
"Waltham Forest","10:00:00","2020-07-02",14,1,0,7,0,22
"Barking and Dagenham","11:00:00","2020-07-02",41,1,0,4,1,47
"Camden","11:00:00","2020-07-02",508,31,1,214,56,810
"Greenwich","11:00:00","2020-07-02",59,1,10,14,3,87
"Haringey","11:00:00","2020-07-02",35,0,0,6,0,41
"Hounslow","11:00:00","2020-07-02",46,0,0,15,3,64
"Lewisham","11:00:00","2020-07-02",332,11,10,68,11,432
"Waltham Forest","11:00:00","2020-07-02",17,0,0,4,0,21
"Barking and Dagenham","12:00:00","2020-07-02",37,0,0,5,0,42
"Camden","12:00:00","2020-07-02",527,49,1,176,49,802
"Greenwich","12:00:00","2020-07-02",53,0,11,16,5,85
"Haringey","12:00:00","2020-07-02",28,2,0,5,0,35
"Hounslow","12:00:00","2020-07-02",56,1,0,13,2,72
"Lewisham","12:00:00","2020-07-02",337,10,8,59,9,423
"Waltham Forest","12:00:00","2020-07-02",24,0,0,2,1,27
"Barking and Dagenham","13:00:00","2020-07-02",45,1,0,4,1,51
"Camden","13:00:00","2020-07-02",566,63,0,204,55,888
"Greenwich","13:00:00","2020-07-02",65,5,9,13,5,97
"Haringey","13:00:00","2020-07-02",26,3,0,5,0,34
"Hounslow","13:00:00","2020-07-02",61,0,0,13,0,74
"Lewisham","13:00:00","2020-07-02",350,11,9,71,5,446
"Waltham Forest","13:00:00","2020-07-02",19,0,0,1,0,20
"Barking and Dagenham","14:00:00","2020-07-02",53,0,0,5,0,58
"Camden","14:00:00","2020-07-02",518,53,0,179,53,803
"Greenwich","14:00:00","2020-07-02",83,3,10,11,0,107
"Haringey","14:00:00","2020-07-02",20,3,0,2,0,25
"Hounslow","14:00:00","2020-07-02",60,1,0,12,1,74
"Lewisham","14:00:00","2020-07-02",388,17,13,64,2,484
"Waltham Forest","14:00:00","2020-07-02",13,1,0,5,0,19
"Barking and Dagenham","15:00:00","2020-07-02",52,1,0,9,0,62
"Camden","15:00:00","2020-07-02",579,43,0,168,40,830
"Greenwich","15:00:00","2020-07-02",75,1,13,12,2,103
"Haringey","15:00:00","2020-07-02",18,3,0,1,1,23
"Hounslow","15:00:00","2020-07-02",61,2,0,8,4,75
"Lewisham","15:00:00","2020-07-02",463,16,14,70,6,569
"Waltham Forest","15:00:00","2020-07-02",21,0,0,11,0,32
"Barking and Dagenham","16:00:00","2020-07-02",53,0,0,6,0,59
"Camden","16:00:00","2020-07-02",583,48,1,162,24,818
"Greenwich","16:00:00","2020-07-02",87,3,9,8,1,108
"Haringey","16:00:00","2020-07-02",18,2,0,1,1,22
"Hounslow","16:00:00","2020-07-02",72,3,0,16,3,94
"Lewisham","16:00:00","2020-07-02",440,15,10,92,6,563
"Waltham Forest","16:00:00","2020-07-02",25,1,0,3,1,30
"Barking and Dagenham","17:00:00","2020-07-02",57,1,0,6,0,64
"Camden","17:00:00","2020-07-02",630,47,0,124,25,826
"Greenwich","17:00:00","2020-07-02",92,6,11,9,0,118
"Haringey","17:00:00","2020-07-02",24,0,0,0,0,24
"Hounslow","17:00:00","2020-07-02",81,3,0,15,0,99
"Lewisham","17:00:00","2020-07-02",459,19,9,70,12,569
"Waltham Forest","17:00:00","2020-07-02",31,0,0,5,1,37
"Barking and Dagenham","18:00:00","2020-07-02",52,3,0,5,0,60
"Camden","18:00:00","2020-07-02",697,68,0,97,19,881
"Greenwich","18:00:00","2020-07-02",76,0,11,13,1,101
"Haringey","18:00:00","2020-07-02",26,2,0,0,0,28
"Hounslow","18:00:00","2020-07-02",76,2,0,8,0,86
"Lewisham","18:00:00","2020-07-02",496,20,10,39,5,570
"Waltham Forest","18:00:00","2020-07-02",20,0,0,1,2,23
"Barnet","07:00:00","2020-07-03",1051,33,46,667,122,1919
"Hillingdon","07:00:00","2020-07-03",633,9,70,265,65,1042
"Lambeth","07:00:00","2020-07-03",169,13,12,50,18,262
"Barnet","08:00:00","2020-07-03",1176,24,46,489,122,1857
"Hillingdon","08:00:00","2020-07-03",736,6,74,217,80,1113
"Lambeth","08:00:00","2020-07-03",207,6,9,62,12,296
"Barnet","09:00:00","2020-07-03",1330,24,42,410,163,1969
"Hillingdon","09:00:00","2020-07-03",827,12,73,218,69,1199
"Lambeth","09:00:00","2020-07-03",171,5,16,52,14,258
"Barnet","10:00:00","2020-07-03",1321,26,46,368,159,1920
"Hillingdon","10:00:00","2020-07-03",923,8,70,202,82,1285
"Lambeth","10:00:00","2020-07-03",187,2,23,68,15,295
"Barnet","11:00:00","2020-07-03",1431,27,40,363,122,1983
"Hillingdon","11:00:00","2020-07-03",1027,32,72,190,63,1384
"Lambeth","11:00:00","2020-07-03",203,11,11,56,15,296
"Barnet","12:00:00","2020-07-03",1502,30,41,383,118,2074
"Hillingdon","12:00:00","2020-07-03",1220,38,77,222,61,1618
"Lambeth","12:00:00","2020-07-03",202,19,16,43,13,293
"Barnet","13:00:00","2020-07-03",1530,41,39,375,111,2096
"Hillingdon","13:00:00","2020-07-03",1255,31,68,186,45,1585
"Lambeth","13:00:00","2020-07-03",275,15,15,67,14,386
"Barnet","14:00:00","2020-07-03",1604,54,42,384,118,2202
"Hillingdon","14:00:00","2020-07-03",1239,30,73,239,38,1619
"Lambeth","14:00:00","2020-07-03",275,24,17,54,16,386
"Barnet","15:00:00","2020-07-03",1671,45,41,406,108,2271
"Hillingdon","15:00:00","2020-07-03",1262,31,72,239,32,1636
"Lambeth","15:00:00","2020-07-03",331,18,15,72,22,458
"Barnet","16:00:00","2020-07-03",1777,59,46,453,63,2398
"Hillingdon","16:00:00","2020-07-03",1264,25,69,260,40,1658
"Lambeth","16:00:00","2020-07-03",359,15,13,74,9,470
"Barnet","17:00:00","2020-07-03",1860,45,35,340,35,2315
"Hillingdon","17:00:00","2020-07-03",1357,28,65,175,20,1645
"Lambeth","17:00:00","2020-07-03",452,36,13,71,5,577
"Barnet","18:00:00","2020-07-03",1659,35,45,253,31,2023
"Hillingdon","18:00:00","2020-07-03",1117,28,69,117,14,1345
"Lambeth","18:00:00","2020-07-03",381,33,12,54,5,485
"Hackney","07:00:00","2020-07-06",438,31,37,195,27,728
"Hillingdon","07:00:00","2020-07-06",48,1,0,11,1,61
"Kingston upon Thames","07:00:00","2020-07-06",179,2,0,45,7,233
"Waltham Forest","07:00:00","2020-07-06",89,1,0,36,1,127
"Westminster","07:00:00","2020-07-06",92,12,7,57,26,194
"Hackney","08:00:00","2020-07-06",558,33,32,216,43,882
"Hillingdon","08:00:00","2020-07-06",95,0,0,9,1,105
"Kingston upon Thames","08:00:00","2020-07-06",332,5,0,37,7,381
"Waltham Forest","08:00:00","2020-07-06",109,1,0,26,5,141
"Westminster","08:00:00","2020-07-06",113,21,7,74,25,240
"Hackney","09:00:00","2020-07-06",550,19,34,159,41,803
"Hillingdon","09:00:00","2020-07-06",74,0,0,12,2,88
"Kingston upon Thames","09:00:00","2020-07-06",270,5,0,42,11,328
"Waltham Forest","09:00:00","2020-07-06",115,0,0,36,2,153
"Westminster","09:00:00","2020-07-06",153,20,8,82,26,289
"Hackney","10:00:00","2020-07-06",523,46,31,175,43,818
"Hillingdon","10:00:00","2020-07-06",80,0,0,6,1,87
"Kingston upon Thames","10:00:00","2020-07-06",270,6,0,50,12,338
"Waltham Forest","10:00:00","2020-07-06",121,2,0,26,6,155
"Westminster","10:00:00","2020-07-06",148,16,7,64,22,257
"Hackney","11:00:00","2020-07-06",502,37,31,192,35,797
"Hillingdon","11:00:00","2020-07-06",67,0,0,13,0,80
"Kingston upon Thames","11:00:00","2020-07-06",285,11,0,53,10,359
"Waltham Forest","11:00:00","2020-07-06",154,3,0,25,4,186
"Westminster","11:00:00","2020-07-06",205,26,7,96,25,359
"Hackney","12:00:00","2020-07-06",593,53,29,152,28,855
"Hillingdon","12:00:00","2020-07-06",80,0,0,12,0,92
"Kingston upon Thames","12:00:00","2020-07-06",355,8,0,52,9,424
"Waltham Forest","12:00:00","2020-07-06",150,0,0,12,2,164
"Westminster","12:00:00","2020-07-06",218,28,6,71,19,342
"Hackney","13:00:00","2020-07-06",604,55,30,154,25,868
"Hillingdon","13:00:00","2020-07-06",104,4,0,9,4,121
"Kingston upon Thames","13:00:00","2020-07-06",327,11,1,42,5,386
"Waltham Forest","13:00:00","2020-07-06",137,0,0,34,6,177
"Westminster","13:00:00","2020-07-06",213,29,7,62,15,326
"Hackney","14:00:00","2020-07-06",611,41,31,139,23,845
"Hillingdon","14:00:00","2020-07-06",109,0,0,11,1,121
"Kingston upon Thames","14:00:00","2020-07-06",381,13,1,46,6,447
"Waltham Forest","14:00:00","2020-07-06",147,2,0,21,2,172
"Westminster","14:00:00","2020-07-06",228,25,8,67,17,345
"Hackney","15:00:00","2020-07-06",667,49,31,156,25,928
"Hillingdon","15:00:00","2020-07-06",133,0,0,13,2,148
"Kingston upon Thames","15:00:00","2020-07-06",421,17,0,46,8,492
"Waltham Forest","15:00:00","2020-07-06",184,2,0,29,6,221
"Westminster","15:00:00","2020-07-06",264,20,6,55,14,359
"Hackney","16:00:00","2020-07-06",739,56,31,141,17,984
"Hillingdon","16:00:00","2020-07-06",90,2,0,10,0,102
"Kingston upon Thames","16:00:00","2020-07-06",395,11,0,43,2,451
"Waltham Forest","16:00:00","2020-07-06",150,11,0,36,5,202
"Westminster","16:00:00","2020-07-06",254,40,7,37,1,339
"Hackney","17:00:00","2020-07-06",751,75,32,138,12,1008
"Hillingdon","17:00:00","2020-07-06",87,1,0,8,0,96
"Kingston upon Thames","17:00:00","2020-07-06",362,7,0,41,3,413
"Waltham Forest","17:00:00","2020-07-06",153,4,0,20,4,181
"Westminster","17:00:00","2020-07-06",267,41,6,31,5,350
"Hackney","18:00:00","2020-07-06",715,56,30,80,13,894
"Hillingdon","18:00:00","2020-07-06",60,2,0,4,0,66
"Kingston upon Thames","18:00:00","2020-07-06",346,13,0,19,6,384
"Waltham Forest","18:00:00","2020-07-06",146,4,0,13,3,166
"Westminster","18:00:00","2020-07-06",291,24,7,22,5,349
"Bexley","08:00:00","2020-07-07",4132,86,15,1614,433,6280
"Bexley","09:00:00","2020-07-07",3841,70,10,1291,502,5714
"Bexley","10:00:00","2020-07-07",3786,50,8,1062,492,5398
"Bexley","11:00:00","2020-07-07",3870,42,8,1077,479,5476
"Bexley","12:00:00","2020-07-07",4210,63,2,1137,469,5881
"Bexley","13:00:00","2020-07-07",4109,65,10,1212,480,5876
"Bexley","14:00:00","2020-07-07",4437,69,7,1402,427,6342
"Bexley","18:00:00","2020-07-07",4746,106,3,873,127,5855
"Camden","07:00:00","2020-07-08",399,34,83,187,56,759
"Waltham Forest","07:00:00","2020-07-08",54,0,0,12,1,67
"Camden","08:00:00","2020-07-08",410,38,93,188,65,794
"Waltham Forest","08:00:00","2020-07-08",54,0,0,11,3,68
"Camden","09:00:00","2020-07-08",439,39,106,205,60,849
"Waltham Forest","09:00:00","2020-07-08",65,0,0,9,0,74
"Camden","10:00:00","2020-07-08",466,41,108,201,70,886
"Waltham Forest","10:00:00","2020-07-08",50,1,0,9,1,61
"Camden","11:00:00","2020-07-08",428,54,102,197,67,848
"Waltham Forest","11:00:00","2020-07-08",54,0,0,5,1,60
"Camden","12:00:00","2020-07-08",483,74,92,209,41,899
"Waltham Forest","12:00:00","2020-07-08",54,0,0,10,1,65
"Camden","13:00:00","2020-07-08",524,89,100,218,44,975
"Waltham Forest","13:00:00","2020-07-08",58,2,0,9,0,69
"Camden","14:00:00","2020-07-08",543,89,92,219,28,971
"Waltham Forest","14:00:00","2020-07-08",63,0,0,8,0,71
"Camden","15:00:00","2020-07-08",537,82,103,252,37,1011
"Waltham Forest","15:00:00","2020-07-08",56,1,0,9,0,66
"Camden","16:00:00","2020-07-08",601,88,103,209,28,1029
"Waltham Forest","16:00:00","2020-07-08",57,0,0,13,0,70
"Camden","17:00:00","2020-07-08",575,78,110,124,16,903
"Waltham Forest","17:00:00","2020-07-08",50,0,0,7,0,57
"Camden","18:00:00","2020-07-08",617,94,104,61,12,888
"Waltham Forest","18:00:00","2020-07-08",71,0,0,5,0,76
"Croydon","07:00:00","2020-07-09",153,1,4,35,3,196
"Hillingdon","07:00:00","2020-07-09",9,0,0,2,0,11
"Tower Hamlets","07:00:00","2020-07-09",3204,276,11,1498,387,5376
"Waltham Forest","07:00:00","2020-07-09",4004,155,9,1677,329,6174
"Croydon","08:00:00","2020-07-09",263,0,4,37,2,306
"Hillingdon","08:00:00","2020-07-09",16,0,0,1,2,19
"Tower Hamlets","08:00:00","2020-07-09",3339,149,16,1157,408,5069
"Waltham Forest","08:00:00","2020-07-09",3582,88,3,1195,358,5226
"Croydon","09:00:00","2020-07-09",169,0,4,27,5,205
"Hillingdon","09:00:00","2020-07-09",15,0,0,1,0,16
"Tower Hamlets","09:00:00","2020-07-09",2729,125,13,1021,438,4326
"Waltham Forest","09:00:00","2020-07-09",3493,71,7,1046,341,4958
"Croydon","10:00:00","2020-07-09",148,2,4,28,6,188
"Hillingdon","10:00:00","2020-07-09",11,0,0,6,0,17
"Tower Hamlets","10:00:00","2020-07-09",2612,140,10,938,476,4176
"Waltham Forest","10:00:00","2020-07-09",3288,48,10,1014,368,4728
"Croydon","11:00:00","2020-07-09",154,2,4,16,11,187
"Hillingdon","11:00:00","2020-07-09",10,0,0,3,0,13
"Tower Hamlets","11:00:00","2020-07-09",2608,146,10,1043,453,4260
"Waltham Forest","11:00:00","2020-07-09",3365,45,3,1002,337,4752
"Croydon","12:00:00","2020-07-09",202,4,4,29,6,245
"Hillingdon","12:00:00","2020-07-09",16,0,0,0,0,16
"Tower Hamlets","12:00:00","2020-07-09",3175,180,14,1056,411,4836
"Waltham Forest","12:00:00","2020-07-09",3514,59,5,1038,340,4956
"Croydon","13:00:00","2020-07-09",199,0,4,29,3,235
"Hillingdon","13:00:00","2020-07-09",11,1,0,3,0,15
"Tower Hamlets","13:00:00","2020-07-09",3250,250,9,1028,474,5011
"Waltham Forest","13:00:00","2020-07-09",3730,49,8,1077,320,5184
"Croydon","14:00:00","2020-07-09",241,1,4,39,1,286
"Hillingdon","14:00:00","2020-07-09",16,0,0,2,1,19
"Tower Hamlets","14:00:00","2020-07-09",3787,243,8,1198,402,5638
"Waltham Forest","14:00:00","2020-07-09",4066,66,6,1268,294,5700
"Croydon","15:00:00","2020-07-09",213,0,4,41,5,263
"Hillingdon","15:00:00","2020-07-09",11,0,0,1,1,13
"Tower Hamlets","15:00:00","2020-07-09",4162,217,13,1242,311,5945
"Waltham Forest","15:00:00","2020-07-09",4314,107,5,1375,226,6027
"Croydon","16:00:00","2020-07-09",259,5,4,43,4,315
"Hillingdon","16:00:00","2020-07-09",11,0,0,2,1,14
"Tower Hamlets","16:00:00","2020-07-09",4756,290,3,1294,257,6600
"Waltham Forest","16:00:00","2020-07-09",4303,108,5,1186,149,5751
"Croydon","17:00:00","2020-07-09",278,4,4,32,0,318
"Hillingdon","17:00:00","2020-07-09",10,0,0,0,0,10
"Tower Hamlets","17:00:00","2020-07-09",5221,367,2,1070,121,6781
"Waltham Forest","17:00:00","2020-07-09",4558,130,0,863,113,5664
"Croydon","18:00:00","2020-07-09",194,5,4,22,3,228
"Hillingdon","18:00:00","2020-07-09",21,0,0,2,2,25
"Tower Hamlets","18:00:00","2020-07-09",5167,336,2,710,87,6302
"Waltham Forest","18:00:00","2020-07-09",4638,114,4,575,91,5422
"Ealing","07:00:00","2020-07-10",35,0,0,7,2,44
"Hillingdon","07:00:00","2020-07-10",19,0,2,4,4,29
"Kensington and Chelsea","07:00:00","2020-07-10",139,9,56,50,16,270
"Southwark","07:00:00","2020-07-10",724,48,14,408,56,1250
"Ealing","08:00:00","2020-07-10",57,1,0,10,0,68
"Hillingdon","08:00:00","2020-07-10",18,0,1,6,0,25
"Kensington and Chelsea","08:00:00","2020-07-10",176,15,53,65,14,323
"Southwark","08:00:00","2020-07-10",669,42,13,274,61,1059
"Ealing","09:00:00","2020-07-10",43,2,0,12,3,60
"Hillingdon","09:00:00","2020-07-10",16,0,0,7,2,25
"Kensington and Chelsea","09:00:00","2020-07-10",200,15,52,67,26,360
"Southwark","09:00:00","2020-07-10",587,39,16,212,51,905
"Ealing","10:00:00","2020-07-10",69,8,0,5,8,90
"Hillingdon","10:00:00","2020-07-10",22,0,0,4,1,27
"Kensington and Chelsea","10:00:00","2020-07-10",184,25,55,71,17,352
"Southwark","10:00:00","2020-07-10",597,55,13,173,43,881
"Ealing","11:00:00","2020-07-10",66,0,0,17,2,85
"Hillingdon","11:00:00","2020-07-10",12,1,0,3,0,16
"Kensington and Chelsea","11:00:00","2020-07-10",208,20,50,97,18,393
"Southwark","11:00:00","2020-07-10",686,62,12,167,45,972
"Ealing","12:00:00","2020-07-10",65,10,0,18,1,94
"Hillingdon","12:00:00","2020-07-10",25,0,0,6,1,32
"Kensington and Chelsea","12:00:00","2020-07-10",209,37,50,75,29,400
"Southwark","12:00:00","2020-07-10",705,74,15,164,33,991
"Ealing","13:00:00","2020-07-10",68,1,0,16,0,85
"Hillingdon","13:00:00","2020-07-10",26,0,0,11,0,37
"Kensington and Chelsea","13:00:00","2020-07-10",242,46,46,52,13,399
"Southwark","13:00:00","2020-07-10",776,83,9,137,31,1036
"Ealing","14:00:00","2020-07-10",74,3,0,17,1,95
"Hillingdon","14:00:00","2020-07-10",26,0,0,10,5,41
"Kensington and Chelsea","14:00:00","2020-07-10",230,56,51,64,20,421
"Southwark","14:00:00","2020-07-10",823,85,14,118,31,1071
"Ealing","15:00:00","2020-07-10",98,0,0,7,0,105
"Hillingdon","15:00:00","2020-07-10",25,0,3,9,0,37
"Kensington and Chelsea","15:00:00","2020-07-10",249,27,49,50,12,387
"Southwark","15:00:00","2020-07-10",826,70,10,112,26,1044
"Ealing","16:00:00","2020-07-10",98,2,0,10,0,110
"Hillingdon","16:00:00","2020-07-10",39,0,0,8,0,47
"Kensington and Chelsea","16:00:00","2020-07-10",273,57,52,36,7,425
"Southwark","16:00:00","2020-07-10",841,71,13,91,12,1028
"Ealing","17:00:00","2020-07-10",105,6,0,13,3,127
"Hillingdon","17:00:00","2020-07-10",31,2,0,8,2,43
"Kensington and Chelsea","17:00:00","2020-07-10",271,57,48,38,9,423
"Southwark","17:00:00","2020-07-10",924,100,8,82,10,1124
"Ealing","18:00:00","2020-07-10",90,7,0,6,1,104
"Hillingdon","18:00:00","2020-07-10",33,0,0,1,0,34
"Kensington and Chelsea","18:00:00","2020-07-10",269,67,54,22,4,416
"Southwark","18:00:00","2020-07-10",1022,110,12,82,14,1240
"Barnet","07:00:00","2020-07-13",19,1,0,1,0,21
"Greenwich","07:00:00","2020-07-13",449,7,13,164,8,641
"Lewisham","07:00:00","2020-07-13",1269,118,59,618,172,2236
"Westminster","07:00:00","2020-07-13",918,61,39,451,118,1587
"Barnet","08:00:00","2020-07-13",25,0,0,7,1,33
"Greenwich","08:00:00","2020-07-13",528,5,14,110,18,675
"Lewisham","08:00:00","2020-07-13",1491,75,61,468,198,2293
"Westminster","08:00:00","2020-07-13",1132,66,47,367,126,1738
"Barnet","09:00:00","2020-07-13",35,0,0,5,1,41
"Greenwich","09:00:00","2020-07-13",488,11,12,103,12,626
"Lewisham","09:00:00","2020-07-13",1352,49,51,507,221,2180
"Westminster","09:00:00","2020-07-13",1193,60,52,337,130,1772
"Barnet","10:00:00","2020-07-13",38,1,0,1,0,40
"Greenwich","10:00:00","2020-07-13",548,7,15,95,20,685
"Lewisham","10:00:00","2020-07-13",1367,49,48,514,235,2213
"Westminster","10:00:00","2020-07-13",1156,57,43,336,105,1697
"Barnet","11:00:00","2020-07-13",30,3,0,7,2,42
"Greenwich","11:00:00","2020-07-13",535,12,12,102,14,675
"Lewisham","11:00:00","2020-07-13",1429,73,41,520,212,2275
"Westminster","11:00:00","2020-07-13",1166,89,46,345,89,1735
"Barnet","12:00:00","2020-07-13",40,3,0,8,1,52
"Greenwich","12:00:00","2020-07-13",552,13,13,107,17,702
"Lewisham","12:00:00","2020-07-13",1543,92,44,509,190,2378
"Westminster","12:00:00","2020-07-13",1168,90,47,325,85,1715
"Barnet","13:00:00","2020-07-13",40,0,0,5,1,46
"Greenwich","13:00:00","2020-07-13",581,17,11,117,15,741
"Lewisham","13:00:00","2020-07-13",1509,102,43,513,222,2389
"Westminster","13:00:00","2020-07-13",1189,99,44,293,86,1711
"Barnet","14:00:00","2020-07-13",41,3,0,6,0,50
"Greenwich","14:00:00","2020-07-13",566,7,13,103,10,699
"Lewisham","14:00:00","2020-07-13",1660,100,45,596,199,2600
"Westminster","14:00:00","2020-07-13",1373,86,47,289,74,1869
"Barnet","15:00:00","2020-07-13",59,2,0,11,0,72
"Greenwich","15:00:00","2020-07-13",623,16,13,122,13,787
"Lewisham","15:00:00","2020-07-13",1708,119,43,604,148,2622
"Westminster","15:00:00","2020-07-13",1218,89,47,310,71,1735
"Barnet","16:00:00","2020-07-13",48,2,0,4,0,54
"Greenwich","16:00:00","2020-07-13",648,23,13,137,4,825
"Westminster","16:00:00","2020-07-13",1273,111,52,280,73,1789
"Barnet","17:00:00","2020-07-13",59,5,0,4,1,69
"Greenwich","17:00:00","2020-07-13",639,11,13,106,8,777
"Lewisham","17:00:00","2020-07-13",1986,168,52,461,85,2752
"Westminster","17:00:00","2020-07-13",1376,137,53,198,37,1801
"Barnet","18:00:00","2020-07-13",53,3,0,4,0,60
"Greenwich","18:00:00","2020-07-13",573,26,11,62,5,677
"Lewisham","18:00:00","2020-07-13",1936,161,48,282,64,2491
"Westminster","18:00:00","2020-07-13",1429,137,45,104,28,1743
"Barking and Dagenham","07:00:00","2020-07-14",3158,143,33,1437,795,5566
"City of London","07:00:00","2020-07-14",400,101,30,290,67,888
"Croydon","07:00:00","2020-07-14",1198,26,3,460,84,1771
"Hackney","07:00:00","2020-07-14",271,22,9,127,19,448
"Barking and Dagenham","08:00:00","2020-07-14",3457,71,26,1241,886,5681
"City of London","08:00:00","2020-07-14",466,79,31,257,84,917
"Croydon","08:00:00","2020-07-14",1383,40,2,343,102,1870
"Hackney","08:00:00","2020-07-14",355,8,9,124,19,515
"Barking and Dagenham","09:00:00","2020-07-14",3235,36,31,1357,964,5623
"City of London","09:00:00","2020-07-14",479,67,29,248,99,922
"Croydon","09:00:00","2020-07-14",1173,30,3,364,99,1669
"Hackney","09:00:00","2020-07-14",326,17,9,101,28,481
"Barking and Dagenham","10:00:00","2020-07-14",3082,47,33,1260,1092,5514
"City of London","10:00:00","2020-07-14",368,44,31,234,81,758
"Croydon","10:00:00","2020-07-14",1133,39,2,288,95,1557
"Hackney","10:00:00","2020-07-14",251,14,13,96,18,392
"Barking and Dagenham","11:00:00","2020-07-14",3315,39,22,1295,1019,5690
"City of London","11:00:00","2020-07-14",453,65,29,250,71,868
"Croydon","11:00:00","2020-07-14",1197,29,4,277,101,1608
"Hackney","11:00:00","2020-07-14",302,11,9,99,15,436
"Barking and Dagenham","12:00:00","2020-07-14",4062,46,26,1505,1024,6663
"City of London","12:00:00","2020-07-14",380,73,27,200,64,744
"Croydon","12:00:00","2020-07-14",1292,65,3,273,106,1739
"Hackney","12:00:00","2020-07-14",288,26,8,91,20,433
"Barking and Dagenham","13:00:00","2020-07-14",4355,55,28,1438,1085,6961
"City of London","13:00:00","2020-07-14",392,77,26,190,71,756
"Croydon","13:00:00","2020-07-14",1350,52,3,311,111,1827
"Hackney","13:00:00","2020-07-14",319,21,10,94,20,464
"Barking and Dagenham","14:00:00","2020-07-14",4500,73,25,1527,1003,7128
"City of London","14:00:00","2020-07-14",436,64,27,220,55,802
"Croydon","14:00:00","2020-07-14",1407,58,4,311,83,1863
"Hackney","14:00:00","2020-07-14",357,15,12,111,7,502
"Barking and Dagenham","15:00:00","2020-07-14",4738,109,27,1573,826,7273
"City of London","15:00:00","2020-07-14",474,83,26,204,50,837
"Croydon","15:00:00","2020-07-14",1562,45,3,340,90,2040
"Hackney","15:00:00","2020-07-14",384,29,12,106,14,545
"Barking and Dagenham","16:00:00","2020-07-14",5137,152,29,1614,550,7482
"City of London","16:00:00","2020-07-14",533,89,32,203,42,899
"Croydon","16:00:00","2020-07-14",1673,55,2,376,58,2164
"Hackney","16:00:00","2020-07-14",492,25,9,119,12,657
"Barking and Dagenham","17:00:00","2020-07-14",5682,214,20,1342,349,7607
"City of London","17:00:00","2020-07-14",558,110,30,145,31,874
"Croydon","17:00:00","2020-07-14",1822,53,0,286,33,2194
"Hackney","17:00:00","2020-07-14",417,37,9,66,6,535
"Barking and Dagenham","18:00:00","2020-07-14",5770,139,34,966,258,7167
"City of London","18:00:00","2020-07-14",545,98,29,110,19,801
"Croydon","18:00:00","2020-07-14",1753,70,3,224,26,2076
"Hackney","18:00:00","2020-07-14",522,27,8,72,14,643
"Enfield","07:00:00","2020-07-15",1955,37,1,1096,359,3448
"Tower Hamlets","07:00:00","2020-07-15",3025,295,8,1405,393,5126
"Enfield","08:00:00","2020-07-15",2165,22,2,815,417,3421
"Tower Hamlets","08:00:00","2020-07-15",3008,151,9,1115,414,4697
"Enfield","09:00:00","2020-07-15",2062,14,0,729,379,3184
"Tower Hamlets","09:00:00","2020-07-15",2739,129,7,1125,465,4465
"Enfield","10:00:00","2020-07-15",2056,16,1,662,390,3125
"Tower Hamlets","10:00:00","2020-07-15",2541,131,5,1054,494,4225
"Enfield","11:00:00","2020-07-15",2229,22,4,691,407,3353
"Tower Hamlets","11:00:00","2020-07-15",2611,177,7,1171,491,4457
"Enfield","12:00:00","2020-07-15",2279,11,0,684,399,3373
"Tower Hamlets","12:00:00","2020-07-15",2920,174,2,1098,474,4668
"Enfield","13:00:00","2020-07-15",2377,28,5,630,383,3423
"Tower Hamlets","13:00:00","2020-07-15",3096,229,3,1164,464,4956
"Enfield","14:00:00","2020-07-15",2409,18,1,731,363,3522
"Tower Hamlets","14:00:00","2020-07-15",3348,215,4,1273,428,5268
"Enfield","15:00:00","2020-07-15",2428,24,0,776,328,3556
"Tower Hamlets","15:00:00","2020-07-15",3743,260,8,1352,309,5672
"Enfield","16:00:00","2020-07-15",2821,35,2,819,238,3915
"Tower Hamlets","16:00:00","2020-07-15",4110,323,8,1351,213,6005
"Enfield","17:00:00","2020-07-15",3115,49,0,683,193,4040
"Tower Hamlets","17:00:00","2020-07-15",4590,363,5,1000,150,6108
"Enfield","18:00:00","2020-07-15",2715,31,0,430,147,3323
"Tower Hamlets","18:00:00","2020-07-15",4840,367,3,786,90,6086
"Barnet","07:00:00","2020-07-16",478,23,21,209,33,764
"Westminster","07:00:00","2020-07-16",189,25,0,84,19,317
"Barnet","08:00:00","2020-07-16",623,20,23,142,26,834
"Westminster","08:00:00","2020-07-16",252,17,0,117,25,411
"Barnet","09:00:00","2020-07-16",523,13,23,118,36,713
"Westminster","09:00:00","2020-07-16",272,23,0,115,11,421
"Barnet","10:00:00","2020-07-16",534,20,25,116,30,725
"Westminster","10:00:00","2020-07-16",274,18,1,96,23,412
"Barnet","11:00:00","2020-07-16",617,31,26,119,31,824
"Westminster","11:00:00","2020-07-16",264,27,0,96,28,415
"Barnet","12:00:00","2020-07-16",617,30,22,92,23,784
"Westminster","12:00:00","2020-07-16",317,29,0,78,7,431
"Barnet","13:00:00","2020-07-16",661,36,22,79,21,819
"Westminster","13:00:00","2020-07-16",264,31,0,72,17,384
"Barnet","14:00:00","2020-07-16",709,29,21,92,12,863
"Westminster","14:00:00","2020-07-16",305,23,0,89,15,432
"Barnet","15:00:00","2020-07-16",659,38,20,73,16,806
"Westminster","15:00:00","2020-07-16",342,36,0,75,11,464
"Barnet","16:00:00","2020-07-16",608,34,23,69,11,745
"Westminster","16:00:00","2020-07-16",274,17,0,44,4,339
"Barnet","17:00:00","2020-07-16",712,33,21,63,8,837
"Westminster","17:00:00","2020-07-16",296,28,0,44,4,372
"Barnet","18:00:00","2020-07-16",663,40,19,50,13,785
"Westminster","18:00:00","2020-07-16",345,26,0,26,5,402
"Camden","07:00:00","2020-07-17",284,31,41,152,35,543
"Islington","07:00:00","2020-07-17",324,17,0,142,21,504
"Wandsworth","07:00:00","2020-07-17",591,40,50,295,69,1045
"Camden","08:00:00","2020-07-17",319,33,39,180,52,623
"Islington","08:00:00","2020-07-17",467,23,0,137,28,655
"Wandsworth","08:00:00","2020-07-17",740,36,47,262,83,1168
"Camden","09:00:00","2020-07-17",339,34,38,162,52,625
"Islington","09:00:00","2020-07-17",470,38,4,128,26,666
"Wandsworth","09:00:00","2020-07-17",677,41,49,249,72,1088
"Camden","10:00:00","2020-07-17",347,30,32,179,49,637
"Islington","10:00:00","2020-07-17",457,32,0,143,27,659
"Wandsworth","10:00:00","2020-07-17",762,42,53,251,62,1170
"Camden","11:00:00","2020-07-17",385,40,29,172,40,666
"Islington","11:00:00","2020-07-17",484,34,5,146,28,697
"Wandsworth","11:00:00","2020-07-17",761,62,43,213,60,1139
"Camden","12:00:00","2020-07-17",388,57,31,189,41,706
"Islington","12:00:00","2020-07-17",593,62,2,164,13,834
"Wandsworth","12:00:00","2020-07-17",770,67,45,223,57,1162
"Camden","13:00:00","2020-07-17",405,81,27,160,34,707
"Islington","13:00:00","2020-07-17",577,73,0,135,19,804
"Wandsworth","13:00:00","2020-07-17",876,65,51,222,49,1263
"Camden","14:00:00","2020-07-17",486,60,26,181,32,785
"Islington","14:00:00","2020-07-17",637,52,0,123,23,835
"Wandsworth","14:00:00","2020-07-17",883,68,47,178,47,1223
"Camden","15:00:00","2020-07-17",473,57,28,167,27,752
"Islington","15:00:00","2020-07-17",597,64,1,118,15,795
"Wandsworth","15:00:00","2020-07-17",952,47,43,169,35,1246
"Camden","16:00:00","2020-07-17",451,63,38,88,12,652
"Islington","16:00:00","2020-07-17",666,62,0,99,7,834
"Wandsworth","16:00:00","2020-07-17",984,74,55,167,21,1301
"Camden","17:00:00","2020-07-17",523,60,41,76,12,712
"Islington","17:00:00","2020-07-17",664,77,0,95,7,843
"Wandsworth","17:00:00","2020-07-17",1103,86,43,130,19,1381
"Camden","18:00:00","2020-07-17",501,41,37,43,5,627
"Islington","18:00:00","2020-07-17",690,109,0,61,5,865
"Wandsworth","18:00:00","2020-07-17",1143,129,46,90,6,1414
"Bromley","07:00:00","2020-07-20",946,24,20,393,46,1429
"Havering","07:00:00","2020-07-20",1421,12,85,413,85,2016
"Redbridge","07:00:00","2020-07-20",1152,12,17,454,54,1689
"Bromley","08:00:00","2020-07-20",1039,19,20,371,62,1511
"Havering","08:00:00","2020-07-20",1759,19,83,359,82,2302
"Redbridge","08:00:00","2020-07-20",1138,12,16,360,54,1580
"Bromley","09:00:00","2020-07-20",1019,12,15,315,49,1410
"Havering","09:00:00","2020-07-20",1530,24,85,328,104,2071
"Redbridge","09:00:00","2020-07-20",1033,6,16,284,44,1383
"Bromley","10:00:00","2020-07-20",1082,22,16,273,43,1436
"Havering","10:00:00","2020-07-20",1684,25,75,313,91,2188
"Redbridge","10:00:00","2020-07-20",985,5,17,257,41,1305
"Bromley","11:00:00","2020-07-20",1123,24,16,304,61,1528
"Havering","11:00:00","2020-07-20",1984,34,73,353,82,2526
"Redbridge","11:00:00","2020-07-20",1131,9,15,289,43,1487
"Bromley","12:00:00","2020-07-20",1282,27,16,274,58,1657
"Havering","12:00:00","2020-07-20",2006,44,75,345,72,2542
"Redbridge","12:00:00","2020-07-20",1311,15,16,286,45,1673
"Bromley","13:00:00","2020-07-20",1262,19,17,275,62,1635
"Havering","13:00:00","2020-07-20",2161,51,78,357,87,2734
"Redbridge","13:00:00","2020-07-20",1319,18,17,281,43,1678
"Bromley","14:00:00","2020-07-20",1339,18,18,301,53,1729
"Havering","14:00:00","2020-07-20",2035,38,84,374,64,2595
"Redbridge","14:00:00","2020-07-20",1331,22,17,277,42,1689
"Bromley","15:00:00","2020-07-20",1316,29,17,296,49,1707
"Havering","15:00:00","2020-07-20",2044,46,76,344,69,2579
"Redbridge","15:00:00","2020-07-20",1369,20,17,293,42,1741
"Bromley","16:00:00","2020-07-20",1543,36,16,348,28,1971
"Havering","16:00:00","2020-07-20",2087,40,79,336,44,2586
"Redbridge","16:00:00","2020-07-20",1474,28,16,308,23,1849
"Bromley","17:00:00","2020-07-20",1615,26,14,258,16,1929
"Havering","17:00:00","2020-07-20",2194,44,69,285,29,2621
"Redbridge","17:00:00","2020-07-20",1719,19,16,262,20,2036
"Bromley","18:00:00","2020-07-20",1483,30,20,185,22,1740
"Havering","18:00:00","2020-07-20",1941,60,78,229,26,2334
"Redbridge","18:00:00","2020-07-20",1505,27,18,189,13,1752
"Croydon","07:00:00","2020-07-21",491,16,5,200,44,756
"Hounslow","07:00:00","2020-07-21",1370,43,4,511,184,2112
"Kingston upon Thames","07:00:00","2020-07-21",4864,145,100,2193,333,7635
"Lambeth","07:00:00","2020-07-21",340,23,58,136,28,585
"Croydon","08:00:00","2020-07-21",606,13,2,177,61,859
"Hounslow","08:00:00","2020-07-21",1254,24,11,455,226,1970
"Kingston upon Thames","08:00:00","2020-07-21",4835,97,98,1474,374,6878
"Lambeth","08:00:00","2020-07-21",374,22,45,126,21,588
"Croydon","09:00:00","2020-07-21",571,14,4,161,60,810
"Hounslow","09:00:00","2020-07-21",1097,21,3,435,253,1809
"Kingston upon Thames","09:00:00","2020-07-21",4787,96,100,1222,379,6584
"Lambeth","09:00:00","2020-07-21",340,23,50,112,31,556
"Croydon","10:00:00","2020-07-21",562,25,1,140,48,776
"Hounslow","10:00:00","2020-07-21",1001,16,4,447,252,1720
"Kingston upon Thames","10:00:00","2020-07-21",4702,94,102,1104,400,6402
"Lambeth","10:00:00","2020-07-21",399,17,47,114,34,611
"Croydon","11:00:00","2020-07-21",581,24,1,159,59,824
"Hounslow","11:00:00","2020-07-21",1101,11,7,431,234,1784
"Kingston upon Thames","11:00:00","2020-07-21",4756,97,100,1182,385,6520
"Lambeth","11:00:00","2020-07-21",357,21,53,138,31,600
"Croydon","12:00:00","2020-07-21",602,31,0,132,53,818
"Hounslow","12:00:00","2020-07-21",1151,20,9,405,213,1798
"Kingston upon Thames","12:00:00","2020-07-21",4941,136,95,1182,380,6734
"Lambeth","12:00:00","2020-07-21",397,38,45,116,26,622
"Croydon","13:00:00","2020-07-21",647,28,0,134,31,840
"Hounslow","13:00:00","2020-07-21",1345,27,6,409,220,2007
"Kingston upon Thames","13:00:00","2020-07-21",4914,154,104,1155,365,6692
"Lambeth","13:00:00","2020-07-21",390,31,48,109,24,602
"Croydon","14:00:00","2020-07-21",622,28,2,132,42,826
"Hounslow","14:00:00","2020-07-21",1289,24,5,412,247,1977
"Kingston upon Thames","14:00:00","2020-07-21",5242,139,99,1249,376,7105
"Lambeth","14:00:00","2020-07-21",442,42,49,106,21,660
"Croydon","15:00:00","2020-07-21",631,44,4,146,31,856
"Hounslow","15:00:00","2020-07-21",1389,31,7,432,189,2048
"Kingston upon Thames","15:00:00","2020-07-21",5729,160,104,1466,323,7782
"Lambeth","15:00:00","2020-07-21",462,37,54,94,11,658
"Croydon","16:00:00","2020-07-21",641,33,0,129,26,829
"Hounslow","16:00:00","2020-07-21",1695,48,6,437,162,2348
"Kingston upon Thames","16:00:00","2020-07-21",6447,195,98,1583,218,8541
"Lambeth","16:00:00","2020-07-21",464,47,42,91,11,655
"Croydon","17:00:00","2020-07-21",666,53,0,104,24,847
"Hounslow","17:00:00","2020-07-21",1749,42,3,364,151,2309
"Kingston upon Thames","17:00:00","2020-07-21",7074,178,98,1214,131,8695
"Lambeth","17:00:00","2020-07-21",475,54,53,88,9,679
"Croydon","18:00:00","2020-07-21",725,58,0,73,15,871
"Hounslow","18:00:00","2020-07-21",1612,24,6,258,114,2014
"Kingston upon Thames","18:00:00","2020-07-21",6154,198,95,723,96,7266
"Lambeth","18:00:00","2020-07-21",486,61,51,75,8,681
"Bexley","07:00:00","2020-09-03",121,0,0,25,0,146
"Greenwich","07:00:00","2020-09-03",762,19,38,143,9,971
"Bexley","08:00:00","2020-09-03",211,0,0,32,1,244
"Greenwich","08:00:00","2020-09-03",897,13,35,105,16,1066
"Bexley","09:00:00","2020-09-03",161,2,0,19,5,187
"Greenwich","09:00:00","2020-09-03",621,10,38,91,21,781
"Bexley","10:00:00","2020-09-03",157,10,0,27,3,197
"Greenwich","10:00:00","2020-09-03",584,11,35,121,18,769
"Bexley","11:00:00","2020-09-03",206,2,0,26,4,238
"Greenwich","11:00:00","2020-09-03",699,7,36,102,29,873
"Bexley","12:00:00","2020-09-03",176,1,0,23,2,202
"Greenwich","12:00:00","2020-09-03",620,7,35,110,24,796
"Bexley","13:00:00","2020-09-03",161,1,0,28,2,192
"Greenwich","13:00:00","2020-09-03",806,17,37,126,20,1006
"Bexley","14:00:00","2020-09-03",188,7,0,30,0,225
"Greenwich","14:00:00","2020-09-03",900,16,41,117,21,1095
"Bexley","15:00:00","2020-09-03",203,0,0,36,2,241
"Greenwich","15:00:00","2020-09-03",889,17,35,107,13,1061
"Bexley","16:00:00","2020-09-03",213,3,0,23,1,240
"Greenwich","16:00:00","2020-09-03",943,23,37,105,11,1119
"Bexley","17:00:00","2020-09-03",203,0,0,20,0,223
"Greenwich","17:00:00","2020-09-03",959,21,36,101,20,1137
"Bexley","18:00:00","2020-09-03",196,3,0,17,0,216
"Greenwich","18:00:00","2020-09-03",835,21,37,88,10,991
"Bromley","07:00:00","2020-09-04",17,0,0,5,0,22
"Enfield","07:00:00","2020-09-04",5226,111,46,1962,550,7895
"Southwark","07:00:00","2020-09-04",433,27,21,128,13,622
"Bromley","08:00:00","2020-09-04",25,0,0,4,2,31
"Enfield","08:00:00","2020-09-04",4402,71,35,1544,568,6620
"Southwark","08:00:00","2020-09-04",432,23,22,57,17,551
"Bromley","09:00:00","2020-09-04",24,0,0,4,2,30
"Enfield","09:00:00","2020-09-04",4226,56,38,1425,577,6322
"Southwark","09:00:00","2020-09-04",421,21,21,83,21,567
"Bromley","10:00:00","2020-09-04",20,1,0,4,2,27
"Enfield","10:00:00","2020-09-04",4136,48,41,1322,600,6147
"Southwark","10:00:00","2020-09-04",408,16,22,126,20,592
"Bromley","11:00:00","2020-09-04",25,0,0,3,0,28
"Enfield","11:00:00","2020-09-04",4432,39,33,1388,597,6489
"Southwark","11:00:00","2020-09-04",405,25,20,116,22,588
"Bromley","12:00:00","2020-09-04",31,0,0,2,2,35
"Enfield","12:00:00","2020-09-04",4734,54,30,1430,515,6763
"Southwark","12:00:00","2020-09-04",491,24,20,127,25,687
"Bromley","13:00:00","2020-09-04",40,0,0,6,0,46
"Enfield","13:00:00","2020-09-04",4964,65,31,1369,557,6986
"Southwark","13:00:00","2020-09-04",491,20,18,127,20,676
"Bromley","14:00:00","2020-09-04",25,0,0,6,0,31
"Enfield","14:00:00","2020-09-04",5031,81,31,1449,497,7089
"Southwark","14:00:00","2020-09-04",576,22,23,144,21,786
"Bromley","15:00:00","2020-09-04",40,0,0,4,0,44
"Enfield","15:00:00","2020-09-04",5412,74,36,1547,376,7445
"Southwark","15:00:00","2020-09-04",578,35,18,92,9,732
"Bromley","16:00:00","2020-09-04",29,0,0,6,0,35
"Enfield","16:00:00","2020-09-04",5815,113,33,1364,266,7591
"Southwark","16:00:00","2020-09-04",553,40,25,95,9,722
"Bromley","17:00:00","2020-09-04",43,2,0,5,0,50
"Enfield","17:00:00","2020-09-04",5974,119,32,1150,217,7492
"Southwark","17:00:00","2020-09-04",626,45,21,93,5,790
"Bromley","18:00:00","2020-09-04",30,0,0,1,0,31
"Enfield","18:00:00","2020-09-04",6290,98,30,917,144,7479
"Southwark","18:00:00","2020-09-04",716,50,18,79,9,872
"Croydon","07:00:00","2020-09-07",305,3,0,37,4,349
"Havering","07:00:00","2020-09-07",671,10,1,114,13,809
"Hillingdon","07:00:00","2020-09-07",812,16,18,275,45,1166
"Lambeth","07:00:00","2020-09-07",177,8,0,40,8,233
"Richmond upon Thames","07:00:00","2020-09-07",595,21,14,129,7,766
"Croydon","08:00:00","2020-09-07",353,6,0,41,5,405
"Havering","08:00:00","2020-09-07",772,1,6,124,11,914
"Hillingdon","08:00:00","2020-09-07",1094,7,16,231,78,1426
"Lambeth","08:00:00","2020-09-07",215,8,0,43,5,271
"Richmond upon Thames","08:00:00","2020-09-07",615,17,20,92,16,760
"Croydon","09:00:00","2020-09-07",269,3,1,40,5,318
"Havering","09:00:00","2020-09-07",553,4,2,76,10,645
"Hillingdon","09:00:00","2020-09-07",879,13,18,237,106,1253
"Lambeth","09:00:00","2020-09-07",213,6,0,41,6,266
"Richmond upon Thames","09:00:00","2020-09-07",534,12,15,95,23,679
"Croydon","10:00:00","2020-09-07",193,1,0,16,2,212
"Havering","10:00:00","2020-09-07",500,1,1,64,6,572
"Hillingdon","10:00:00","2020-09-07",869,9,15,262,93,1248
"Lambeth","10:00:00","2020-09-07",142,5,0,60,13,220
"Richmond upon Thames","10:00:00","2020-09-07",443,8,14,82,24,571
"Croydon","11:00:00","2020-09-07",181,5,0,22,10,218
"Havering","11:00:00","2020-09-07",525,1,1,82,6,615
"Hillingdon","11:00:00","2020-09-07",981,10,14,222,98,1325
"Lambeth","11:00:00","2020-09-07",125,5,0,61,16,207
"Richmond upon Thames","11:00:00","2020-09-07",452,10,11,69,9,551
"Croydon","12:00:00","2020-09-07",168,1,0,29,4,202
"Havering","12:00:00","2020-09-07",537,1,1,88,7,634
"Hillingdon","12:00:00","2020-09-07",1052,8,10,246,93,1409
"Lambeth","12:00:00","2020-09-07",136,28,0,37,12,213
"Richmond upon Thames","12:00:00","2020-09-07",470,12,14,87,13,596
"Croydon","13:00:00","2020-09-07",189,1,0,26,8,224
"Havering","13:00:00","2020-09-07",502,4,1,66,2,575
"Hillingdon","13:00:00","2020-09-07",1042,16,10,220,76,1364
"Lambeth","13:00:00","2020-09-07",164,32,0,52,7,255
"Richmond upon Thames","13:00:00","2020-09-07",485,19,15,51,9,579
"Croydon","14:00:00","2020-09-07",235,1,0,26,1,263
"Havering","14:00:00","2020-09-07",615,3,1,94,4,717
"Hillingdon","14:00:00","2020-09-07",1204,16,18,220,82,1540
"Lambeth","14:00:00","2020-09-07",185,29,0,55,11,280
"Richmond upon Thames","14:00:00","2020-09-07",495,7,21,67,14,604
"Croydon","15:00:00","2020-09-07",301,2,0,28,3,334
"Havering","15:00:00","2020-09-07",685,4,2,119,7,817
"Hillingdon","15:00:00","2020-09-07",1194,16,9,220,93,1532
"Lambeth","15:00:00","2020-09-07",256,28,0,63,7,354
"Richmond upon Thames","15:00:00","2020-09-07",555,9,17,55,6,642
"Croydon","16:00:00","2020-09-07",284,2,0,28,5,319
"Havering","16:00:00","2020-09-07",786,6,5,146,6,949
"Hillingdon","16:00:00","2020-09-07",1278,14,16,274,60,1642
"Lambeth","16:00:00","2020-09-07",201,21,0,59,6,287
"Richmond upon Thames","16:00:00","2020-09-07",627,30,12,87,9,765
"Croydon","17:00:00","2020-09-07",321,2,0,29,7,359
"Havering","17:00:00","2020-09-07",833,12,0,95,6,946
"Hillingdon","17:00:00","2020-09-07",1508,25,13,255,44,1845
"Lambeth","17:00:00","2020-09-07",260,40,0,35,4,339
"Richmond upon Thames","17:00:00","2020-09-07",635,29,8,64,9,745
"Croydon","18:00:00","2020-09-07",201,8,0,16,2,227
"Havering","18:00:00","2020-09-07",597,7,0,58,1,663
"Hillingdon","18:00:00","2020-09-07",1558,21,20,208,31,1838
"Lambeth","18:00:00","2020-09-07",233,49,0,38,2,322
"Richmond upon Thames","18:00:00","2020-09-07",490,24,10,49,6,579
"Bromley","07:00:00","2020-09-08",604,5,8,123,12,752
"Haringey","07:00:00","2020-09-08",357,13,35,84,7,496
"Hillingdon","07:00:00","2020-09-08",104,1,0,10,3,118
"Lewisham","07:00:00","2020-09-08",1419,66,115,506,110,2216
"Southwark","07:00:00","2020-09-08",879,203,153,469,103,1807
"Sutton","07:00:00","2020-09-08",95,0,0,27,0,122
"Bromley","08:00:00","2020-09-08",785,7,6,93,10,901
"Haringey","08:00:00","2020-09-08",501,5,23,105,19,653
"Hillingdon","08:00:00","2020-09-08",248,0,0,20,1,269
"Lewisham","08:00:00","2020-09-08",1534,46,104,386,138,2208
"Southwark","08:00:00","2020-09-08",826,164,151,404,139,1684
"Sutton","08:00:00","2020-09-08",149,2,0,14,3,168
"Bromley","09:00:00","2020-09-08",536,3,8,99,13,659
"Haringey","09:00:00","2020-09-08",438,10,30,77,17,572
"Hillingdon","09:00:00","2020-09-08",130,0,0,13,7,150
"Lewisham","09:00:00","2020-09-08",1303,46,115,416,125,2005
"Southwark","09:00:00","2020-09-08",880,122,142,443,136,1723
"Sutton","09:00:00","2020-09-08",82,0,2,13,5,102
"Bromley","10:00:00","2020-09-08",382,4,9,69,13,477
"Haringey","10:00:00","2020-09-08",290,12,27,53,20,402
"Hillingdon","10:00:00","2020-09-08",96,0,0,16,4,116
"Lewisham","10:00:00","2020-09-08",1264,52,119,377,163,1975
"Southwark","10:00:00","2020-09-08",873,75,144,454,151,1697
"Sutton","10:00:00","2020-09-08",65,2,0,17,2,86
"Bromley","11:00:00","2020-09-08",397,9,6,69,13,494
"Haringey","11:00:00","2020-09-08",354,9,25,60,13,461
"Hillingdon","11:00:00","2020-09-08",116,0,0,11,0,127
"Lewisham","11:00:00","2020-09-08",1239,46,107,421,172,1985
"Southwark","11:00:00","2020-09-08",922,82,128,509,189,1830
"Sutton","11:00:00","2020-09-08",79,2,0,17,0,98
"Bromley","12:00:00","2020-09-08",442,14,6,79,18,559
"Haringey","12:00:00","2020-09-08",387,18,23,61,14,503
"Hillingdon","12:00:00","2020-09-08",140,2,0,16,3,161
"Lewisham","12:00:00","2020-09-08",1310,81,111,379,146,2027
"Southwark","12:00:00","2020-09-08",869,92,129,446,186,1722
"Sutton","12:00:00","2020-09-08",76,3,0,19,5,103
"Bromley","13:00:00","2020-09-08",460,3,7,60,12,542
"Haringey","13:00:00","2020-09-08",372,6,25,72,10,485
"Hillingdon","13:00:00","2020-09-08",130,1,0,15,0,146
"Lewisham","13:00:00","2020-09-08",1294,75,111,338,130,1948
"Southwark","13:00:00","2020-09-08",936,121,130,426,148,1761
"Sutton","13:00:00","2020-09-08",92,4,0,15,2,113
"Bromley","14:00:00","2020-09-08",513,9,6,98,5,631
"Haringey","14:00:00","2020-09-08",418,14,26,66,10,534
"Hillingdon","14:00:00","2020-09-08",127,0,0,15,0,142
"Lewisham","14:00:00","2020-09-08",1536,52,112,355,134,2189
"Southwark","14:00:00","2020-09-08",978,109,137,477,149,1850
"Sutton","14:00:00","2020-09-08",98,1,0,21,2,122
"Bromley","15:00:00","2020-09-08",625,7,6,106,4,748
"Haringey","15:00:00","2020-09-08",466,22,25,59,8,580
"Hillingdon","15:00:00","2020-09-08",218,2,0,12,1,233
"Lewisham","15:00:00","2020-09-08",1585,87,106,350,78,2206
"Southwark","15:00:00","2020-09-08",999,121,131,453,98,1802
"Sutton","15:00:00","2020-09-08",117,3,0,19,2,141
"Bromley","16:00:00","2020-09-08",639,14,6,125,4,788
"Haringey","16:00:00","2020-09-08",473,20,32,62,14,601
"Hillingdon","16:00:00","2020-09-08",137,5,0,9,0,151
"Lewisham","16:00:00","2020-09-08",1540,117,115,360,77,2209
"Southwark","16:00:00","2020-09-08",1104,177,137,447,70,1935
"Sutton","16:00:00","2020-09-08",136,4,3,38,0,181
"Bromley","17:00:00","2020-09-08",841,23,6,94,5,969
"Haringey","17:00:00","2020-09-08",488,28,26,48,5,595
"Hillingdon","17:00:00","2020-09-08",141,5,0,14,0,160
"Lewisham","17:00:00","2020-09-08",1651,121,114,289,40,2215
"Southwark","17:00:00","2020-09-08",1207,239,130,348,38,1962
"Sutton","17:00:00","2020-09-08",133,5,0,16,0,154
"Bromley","18:00:00","2020-09-08",605,17,6,70,3,701
"Haringey","18:00:00","2020-09-08",514,24,28,45,8,619
"Hillingdon","18:00:00","2020-09-08",120,1,0,14,0,135
"Lewisham","18:00:00","2020-09-08",1712,150,103,216,48,2229
"Southwark","18:00:00","2020-09-08",1260,195,139,232,55,1881
"Sutton","18:00:00","2020-09-08",117,4,0,14,1,136
"Barnet","07:00:00","2020-09-09",54,3,0,12,2,71
"Croydon","07:00:00","2020-09-09",508,6,10,153,10,687
"Enfield","07:00:00","2020-09-09",2922,124,10,1042,268,4366
"Havering","07:00:00","2020-09-09",587,4,40,123,13,767
"Newham","07:00:00","2020-09-09",4608,322,11,1773,461,7175
"Waltham Forest","07:00:00","2020-09-09",625,4,21,132,26,808
"Barnet","08:00:00","2020-09-09",129,1,0,10,3,143
"Croydon","08:00:00","2020-09-09",603,5,7,121,21,757
"Enfield","08:00:00","2020-09-09",2385,75,5,778,275,3518
"Havering","08:00:00","2020-09-09",936,3,34,103,20,1096
"Newham","08:00:00","2020-09-09",4622,148,4,1512,525,6811
"Waltham Forest","08:00:00","2020-09-09",987,14,26,143,26,1196
"Barnet","09:00:00","2020-09-09",95,6,0,16,1,118
"Croydon","09:00:00","2020-09-09",390,4,7,91,22,514
"Enfield","09:00:00","2020-09-09",2377,42,8,768,235,3430
"Havering","09:00:00","2020-09-09",788,7,39,107,23,964
"Newham","09:00:00","2020-09-09",4032,117,11,1382,573,6115
"Waltham Forest","09:00:00","2020-09-09",822,6,25,159,33,1045
"Barnet","10:00:00","2020-09-09",63,3,1,16,2,85
"Croydon","10:00:00","2020-09-09",355,3,6,86,16,466
"Enfield","10:00:00","2020-09-09",2700,48,5,894,317,3964
"Havering","10:00:00","2020-09-09",659,2,28,101,15,805
"Newham","10:00:00","2020-09-09",3665,107,9,1299,623,5703
"Waltham Forest","10:00:00","2020-09-09",727,8,22,113,30,900
"Barnet","11:00:00","2020-09-09",90,7,0,12,1,110
"Croydon","11:00:00","2020-09-09",355,1,6,80,23,465
"Enfield","11:00:00","2020-09-09",2909,46,3,949,315,4222
"Havering","11:00:00","2020-09-09",698,6,33,108,22,867
"Newham","11:00:00","2020-09-09",3646,88,6,1219,593,5552
"Waltham Forest","11:00:00","2020-09-09",749,10,27,157,20,963
"Barnet","12:00:00","2020-09-09",96,2,0,15,2,115
"Croydon","12:00:00","2020-09-09",434,6,6,87,21,554
"Enfield","12:00:00","2020-09-09",3079,45,4,994,400,4522
"Havering","12:00:00","2020-09-09",794,8,32,131,18,983
"Newham","12:00:00","2020-09-09",3800,121,4,1213,586,5724
"Waltham Forest","12:00:00","2020-09-09",745,9,25,113,26,918
"Barnet","13:00:00","2020-09-09",89,3,0,20,1,113
"Croydon","13:00:00","2020-09-09",392,6,8,100,17,523
"Enfield","13:00:00","2020-09-09",3481,54,4,1002,386,4927
"Havering","13:00:00","2020-09-09",727,7,31,122,11,898
"Newham","13:00:00","2020-09-09",4253,122,12,1280,596,6263
"Waltham Forest","13:00:00","2020-09-09",718,14,24,97,25,878
"Barnet","14:00:00","2020-09-09",100,4,0,15,1,120
"Croydon","14:00:00","2020-09-09",449,9,6,77,19,560
"Enfield","14:00:00","2020-09-09",4151,73,10,1309,382,5925
"Havering","14:00:00","2020-09-09",834,6,34,105,13,992
"Newham","14:00:00","2020-09-09",4387,153,12,1411,563,6526
"Waltham Forest","14:00:00","2020-09-09",758,9,25,96,17,905
"Barnet","15:00:00","2020-09-09",156,2,1,19,1,179
"Croydon","15:00:00","2020-09-09",576,7,6,85,18,692
"Enfield","15:00:00","2020-09-09",4342,93,7,1326,406,6174
"Havering","15:00:00","2020-09-09",898,10,33,123,11,1075
"Newham","15:00:00","2020-09-09",4539,176,12,1357,402,6486
"Waltham Forest","15:00:00","2020-09-09",924,15,24,125,24,1112
"Barnet","16:00:00","2020-09-09",169,8,1,23,2,203
"Croydon","16:00:00","2020-09-09",572,16,8,144,18,758
"Enfield","16:00:00","2020-09-09",4585,116,15,1343,235,6294
"Havering","16:00:00","2020-09-09",844,17,42,141,6,1050
"Newham","16:00:00","2020-09-09",4857,273,8,1260,273,6671
"Waltham Forest","16:00:00","2020-09-09",916,12,27,147,16,1118
"Barnet","17:00:00","2020-09-09",183,6,0,18,1,208
"Croydon","17:00:00","2020-09-09",629,9,6,103,9,756
"Enfield","17:00:00","2020-09-09",4228,138,4,991,148,5509
"Havering","17:00:00","2020-09-09",936,7,30,97,7,1077
"Newham","17:00:00","2020-09-09",4932,327,4,1026,157,6446
"Waltham Forest","17:00:00","2020-09-09",928,13,23,98,16,1078
"Barnet","18:00:00","2020-09-09",178,6,0,16,3,203
"Croydon","18:00:00","2020-09-09",516,12,6,69,7,610
"Enfield","18:00:00","2020-09-09",4520,115,6,759,118,5518
"Havering","18:00:00","2020-09-09",860,7,33,67,5,972
"Newham","18:00:00","2020-09-09",5283,285,4,792,155,6519
"Waltham Forest","18:00:00","2020-09-09",785,23,25,69,9,911
"Croydon","07:00:00","2020-09-10",4,0,1,5,0,10
"Ealing","07:00:00","2020-09-10",4084,149,17,1643,488,6381
"Richmond upon Thames","07:00:00","2020-09-10",146,7,12,31,7,203
"Westminster","07:00:00","2020-09-10",749,115,213,470,146,1693
"Croydon","08:00:00","2020-09-10",8,0,0,8,0,16
"Ealing","08:00:00","2020-09-10",3658,110,9,1179,536,5492
"Richmond upon Thames","08:00:00","2020-09-10",252,6,16,39,7,320
"Westminster","08:00:00","2020-09-10",990,107,207,472,118,1894
"Croydon","09:00:00","2020-09-10",4,0,0,1,0,5
"Ealing","09:00:00","2020-09-10",3705,84,15,1240,565,5609
"Richmond upon Thames","09:00:00","2020-09-10",254,2,12,35,11,314
"Westminster","09:00:00","2020-09-10",962,80,206,453,141,1842
"Croydon","10:00:00","2020-09-10",5,0,0,4,0,9
"Ealing","10:00:00","2020-09-10",3751,64,10,1168,637,5630
"Richmond upon Thames","10:00:00","2020-09-10",226,2,13,45,9,295
"Westminster","10:00:00","2020-09-10",984,68,184,443,171,1850
"Croydon","11:00:00","2020-09-10",6,0,0,2,0,8
"Ealing","11:00:00","2020-09-10",3584,86,10,1136,606,5422
"Richmond upon Thames","11:00:00","2020-09-10",270,4,11,38,6,329
"Westminster","11:00:00","2020-09-10",949,87,202,410,195,1843
"Croydon","12:00:00","2020-09-10",14,0,0,5,0,19
"Ealing","12:00:00","2020-09-10",3377,70,9,1013,568,5037
"Richmond upon Thames","12:00:00","2020-09-10",228,5,15,34,5,287
"Westminster","12:00:00","2020-09-10",933,112,216,452,126,1839
"Croydon","13:00:00","2020-09-10",11,0,0,8,1,20
"Ealing","13:00:00","2020-09-10",3516,93,12,1021,532,5174
"Richmond upon Thames","13:00:00","2020-09-10",256,10,18,30,6,320
"Westminster","13:00:00","2020-09-10",932,83,191,417,121,1744
"Croydon","14:00:00","2020-09-10",3,0,0,0,2,5
"Ealing","14:00:00","2020-09-10",3394,82,9,1021,483,4989
"Richmond upon Thames","14:00:00","2020-09-10",229,9,18,35,6,297
"Westminster","14:00:00","2020-09-10",1048,109,203,406,98,1864
"Croydon","15:00:00","2020-09-10",12,0,0,3,0,15
"Ealing","15:00:00","2020-09-10",3623,118,11,1079,431,5262
"Richmond upon Thames","15:00:00","2020-09-10",277,9,20,41,5,352
"Westminster","15:00:00","2020-09-10",1205,114,194,414,81,2008
"Croydon","16:00:00","2020-09-10",2,0,1,2,0,5
"Ealing","16:00:00","2020-09-10",3465,140,12,908,279,4804
"Richmond upon Thames","16:00:00","2020-09-10",299,7,12,24,2,344
"Westminster","16:00:00","2020-09-10",1267,153,210,441,75,2146
"Croydon","17:00:00","2020-09-10",6,0,0,0,0,6
"Ealing","17:00:00","2020-09-10",4168,181,12,836,225,5422
"Richmond upon Thames","17:00:00","2020-09-10",302,9,8,20,2,341
"Westminster","17:00:00","2020-09-10",1239,173,208,286,32,1938
"Croydon","18:00:00","2020-09-10",12,0,0,1,0,13
"Ealing","18:00:00","2020-09-10",4404,145,10,738,176,5473
"Richmond upon Thames","18:00:00","2020-09-10",258,4,13,9,3,287
"Westminster","18:00:00","2020-09-10",1299,137,210,201,40,1887
"Brent","07:00:00","2020-09-11",2152,74,88,686,108,3108
"Lambeth","07:00:00","2020-09-11",458,26,38,166,18,706
"Redbridge","07:00:00","2020-09-11",465,7,15,74,8,569
"Waltham Forest","07:00:00","2020-09-11",62,0,0,12,0,74
"Wandsworth","07:00:00","2020-09-11",266,35,0,118,10,429
"Brent","08:00:00","2020-09-11",2590,59,81,455,106,3291
"Lambeth","08:00:00","2020-09-11",536,22,43,103,21,725
"Redbridge","08:00:00","2020-09-11",579,4,15,79,8,685
"Waltham Forest","08:00:00","2020-09-11",154,0,0,4,0,158
"Wandsworth","08:00:00","2020-09-11",294,33,0,63,8,398
"Brent","09:00:00","2020-09-11",2233,72,99,579,141,3124
"Lambeth","09:00:00","2020-09-11",467,24,40,115,15,661
"Redbridge","09:00:00","2020-09-11",414,5,13,58,20,510
"Waltham Forest","09:00:00","2020-09-11",91,0,0,10,1,102
"Wandsworth","09:00:00","2020-09-11",275,35,1,84,5,400
"Brent","10:00:00","2020-09-11",2166,88,74,597,150,3075
"Lambeth","10:00:00","2020-09-11",412,37,40,114,27,630
"Redbridge","10:00:00","2020-09-11",347,3,12,69,15,446
"Waltham Forest","10:00:00","2020-09-11",58,4,0,6,7,75
"Wandsworth","10:00:00","2020-09-11",299,21,0,96,6,422
"Brent","11:00:00","2020-09-11",2173,91,73,524,140,3001
"Lambeth","11:00:00","2020-09-11",377,40,37,106,19,579
"Redbridge","11:00:00","2020-09-11",347,3,10,63,14,437
"Waltham Forest","11:00:00","2020-09-11",43,1,0,15,0,59
"Wandsworth","11:00:00","2020-09-11",340,31,0,95,12,478
"Brent","12:00:00","2020-09-11",2538,88,69,552,135,3382
"Lambeth","12:00:00","2020-09-11",463,57,36,113,19,688
"Redbridge","12:00:00","2020-09-11",551,4,14,97,5,671
"Waltham Forest","12:00:00","2020-09-11",44,2,0,10,0,56
"Wandsworth","12:00:00","2020-09-11",318,26,0,77,13,434
"Brent","13:00:00","2020-09-11",2484,125,73,481,123,3286
"Lambeth","13:00:00","2020-09-11",438,46,39,109,13,645
"Redbridge","13:00:00","2020-09-11",437,5,12,85,17,556
"Waltham Forest","13:00:00","2020-09-11",66,6,0,7,4,83
"Wandsworth","13:00:00","2020-09-11",290,25,0,100,8,423
"Brent","14:00:00","2020-09-11",2693,135,94,430,100,3452
"Lambeth","14:00:00","2020-09-11",495,44,32,105,17,693
"Redbridge","14:00:00","2020-09-11",501,4,12,70,12,599
"Waltham Forest","14:00:00","2020-09-11",61,2,0,10,0,73
"Wandsworth","14:00:00","2020-09-11",352,24,4,81,8,469
"Brent","15:00:00","2020-09-11",2510,133,66,399,76,3184
"Lambeth","15:00:00","2020-09-11",571,35,44,72,19,741
"Redbridge","15:00:00","2020-09-11",525,4,13,60,4,606
"Waltham Forest","15:00:00","2020-09-11",124,0,0,4,3,131
"Wandsworth","15:00:00","2020-09-11",401,51,0,106,11,569
"Brent","16:00:00","2020-09-11",2476,138,75,385,59,3133
"Lambeth","16:00:00","2020-09-11",581,42,35,90,12,760
"Redbridge","16:00:00","2020-09-11",486,10,11,53,11,571
"Waltham Forest","16:00:00","2020-09-11",66,1,0,7,0,74
"Wandsworth","16:00:00","2020-09-11",380,45,0,75,7,507
"Brent","17:00:00","2020-09-11",2468,198,74,391,36,3167
"Lambeth","17:00:00","2020-09-11",605,56,35,75,13,784
"Redbridge","17:00:00","2020-09-11",421,4,6,54,3,488
"Waltham Forest","17:00:00","2020-09-11",50,1,0,3,2,56
"Wandsworth","17:00:00","2020-09-11",345,48,0,40,4,437
"Brent","18:00:00","2020-09-11",2347,174,68,298,35,2922
"Lambeth","18:00:00","2020-09-11",651,87,40,49,6,833
"Redbridge","18:00:00","2020-09-11",443,7,13,45,4,512
"Waltham Forest","18:00:00","2020-09-11",60,3,0,0,0,63
"Wandsworth","18:00:00","2020-09-11",367,53,0,32,1,453
"Bexley","07:00:00","2020-09-14",576,10,1,126,9,722
"Haringey","07:00:00","2020-09-14",31,1,0,11,0,43
"Harrow","07:00:00","2020-09-14",33,0,1,2,0,36
"Hillingdon","07:00:00","2020-09-14",100,1,0,15,1,117
"Lewisham","07:00:00","2020-09-14",598,36,47,161,54,896
"Bexley","08:00:00","2020-09-14",1095,5,0,108,11,1219
"Haringey","08:00:00","2020-09-14",40,0,0,10,0,50
"Harrow","08:00:00","2020-09-14",130,1,1,6,1,139
"Hillingdon","08:00:00","2020-09-14",232,4,1,17,3,257
"Lewisham","08:00:00","2020-09-14",607,22,36,116,45,826
"Bexley","09:00:00","2020-09-14",667,17,0,107,11,802
"Haringey","09:00:00","2020-09-14",32,2,0,8,1,43
"Harrow","09:00:00","2020-09-14",38,0,1,5,2,46
"Hillingdon","09:00:00","2020-09-14",80,0,0,10,2,92
"Lewisham","09:00:00","2020-09-14",752,31,36,180,86,1085
"Bexley","10:00:00","2020-09-14",534,10,0,78,20,642
"Haringey","10:00:00","2020-09-14",19,2,0,9,4,34
"Harrow","10:00:00","2020-09-14",31,1,0,4,1,37
"Hillingdon","10:00:00","2020-09-14",69,0,0,17,0,86
"Lewisham","10:00:00","2020-09-14",698,39,44,172,95,1048
"Bexley","11:00:00","2020-09-14",542,15,0,83,12,652
"Haringey","11:00:00","2020-09-14",27,5,0,8,2,42
"Harrow","11:00:00","2020-09-14",55,3,0,8,1,67
"Hillingdon","11:00:00","2020-09-14",72,1,0,16,3,92
"Lewisham","11:00:00","2020-09-14",766,31,40,192,98,1127
"Bexley","12:00:00","2020-09-14",585,15,0,99,12,711
"Haringey","12:00:00","2020-09-14",28,6,0,6,2,42
"Harrow","12:00:00","2020-09-14",43,1,0,9,0,53
"Hillingdon","12:00:00","2020-09-14",80,2,0,11,3,96
"Lewisham","12:00:00","2020-09-14",748,53,40,175,80,1096
"Bexley","13:00:00","2020-09-14",564,16,0,95,7,682
"Haringey","13:00:00","2020-09-14",43,5,0,2,1,51
"Harrow","13:00:00","2020-09-14",49,3,1,5,1,59
"Hillingdon","13:00:00","2020-09-14",77,3,0,7,1,88
"Lewisham","13:00:00","2020-09-14",773,58,42,173,78,1124
"Bexley","14:00:00","2020-09-14",750,14,0,88,13,865
"Haringey","14:00:00","2020-09-14",32,5,0,5,0,42
"Harrow","14:00:00","2020-09-14",114,1,0,6,1,122
"Hillingdon","14:00:00","2020-09-14",127,9,0,15,0,151
"Lewisham","14:00:00","2020-09-14",767,60,37,158,80,1102
"Bexley","15:00:00","2020-09-14",917,8,0,117,10,1052
"Haringey","15:00:00","2020-09-14",40,5,1,3,0,49
"Harrow","15:00:00","2020-09-14",93,1,1,9,2,106
"Hillingdon","15:00:00","2020-09-14",150,3,0,10,1,164
"Lewisham","15:00:00","2020-09-14",773,66,36,167,49,1091
"Bexley","16:00:00","2020-09-14",701,13,0,128,6,848
"Haringey","16:00:00","2020-09-14",41,5,1,6,1,54
"Harrow","16:00:00","2020-09-14",75,4,0,13,0,92
"Hillingdon","16:00:00","2020-09-14",93,1,1,20,0,115
"Lewisham","16:00:00","2020-09-14",775,115,36,141,41,1108
"Bexley","17:00:00","2020-09-14",811,12,0,91,7,921
"Haringey","17:00:00","2020-09-14",52,3,0,6,0,61
"Harrow","17:00:00","2020-09-14",70,5,0,8,0,83
"Hillingdon","17:00:00","2020-09-14",114,1,0,13,1,129
"Lewisham","17:00:00","2020-09-14",835,108,41,112,28,1124
"Bexley","18:00:00","2020-09-14",623,17,0,62,7,709
"Haringey","18:00:00","2020-09-14",43,9,0,5,0,57
"Harrow","18:00:00","2020-09-14",71,2,0,9,0,82
"Hillingdon","18:00:00","2020-09-14",102,1,0,11,0,114
"Lewisham","18:00:00","2020-09-14",850,96,40,116,29,1131
"Bromley","07:00:00","2020-09-15",47,0,2,18,4,71
"Haringey","07:00:00","2020-09-15",358,13,13,66,8,458
"Hillingdon","07:00:00","2020-09-15",396,14,24,87,18,539
"Bromley","08:00:00","2020-09-15",44,0,2,11,4,61
"Haringey","08:00:00","2020-09-15",395,15,13,59,18,500
"Hillingdon","08:00:00","2020-09-15",599,11,23,71,26,730
"Bromley","09:00:00","2020-09-15",43,1,1,15,1,61
"Haringey","09:00:00","2020-09-15",303,10,8,72,13,406
"Hillingdon","09:00:00","2020-09-15",391,9,21,67,14,502
"Bromley","10:00:00","2020-09-15",38,0,2,8,2,50
"Haringey","10:00:00","2020-09-15",220,8,11,70,16,325
"Hillingdon","10:00:00","2020-09-15",315,8,16,61,13,413
"Bromley","11:00:00","2020-09-15",46,0,2,15,0,63
"Haringey","11:00:00","2020-09-15",236,18,10,56,16,336
"Hillingdon","11:00:00","2020-09-15",387,6,16,77,19,505
"Bromley","12:00:00","2020-09-15",36,0,2,7,2,47
"Haringey","12:00:00","2020-09-15",212,22,11,50,13,308
"Hillingdon","12:00:00","2020-09-15",370,4,18,77,20,489
"Bromley","13:00:00","2020-09-15",45,0,2,9,0,56
"Haringey","13:00:00","2020-09-15",224,21,9,55,8,317
"Hillingdon","13:00:00","2020-09-15",401,4,18,64,24,511
"Bromley","14:00:00","2020-09-15",52,0,2,11,0,65
"Haringey","14:00:00","2020-09-15",247,15,11,47,8,328
"Hillingdon","14:00:00","2020-09-15",470,5,22,62,21,580
"Bromley","15:00:00","2020-09-15",59,0,2,20,3,84
"Haringey","15:00:00","2020-09-15",322,13,11,52,6,404
"Hillingdon","15:00:00","2020-09-15",572,23,20,77,21,713
"Bromley","16:00:00","2020-09-15",59,0,2,14,2,77
"Haringey","16:00:00","2020-09-15",312,19,11,63,7,412
"Hillingdon","16:00:00","2020-09-15",542,6,20,107,8,683
"Bromley","17:00:00","2020-09-15",62,0,2,15,1,80
"Haringey","17:00:00","2020-09-15",355,24,12,42,7,440
"Hillingdon","17:00:00","2020-09-15",590,20,18,79,8,715
"Bromley","18:00:00","2020-09-15",62,1,2,10,0,75
"Haringey","18:00:00","2020-09-15",305,24,10,26,1,366
"Hillingdon","18:00:00","2020-09-15",504,8,17,67,5,601
"Ealing","07:00:00","2020-09-16",1590,54,66,430,120,2260
"Hillingdon","07:00:00","2020-09-16",207,0,1,16,6,230
"Hounslow","07:00:00","2020-09-16",3196,165,34,1055,283,4733
"Kensington and Chelsea","07:00:00","2020-09-16",829,75,13,232,54,1203
"Kingston upon Thames","07:00:00","2020-09-16",36,1,0,6,2,45
"Lambeth","07:00:00","2020-09-16",95,4,0,22,3,124
"Southwark","07:00:00","2020-09-16",117,27,0,81,23,248
"Ealing","08:00:00","2020-09-16",1560,59,63,365,139,2186
"Hillingdon","08:00:00","2020-09-16",518,1,4,21,5,549
"Hounslow","08:00:00","2020-09-16",3251,117,31,906,248,4553
"Kensington and Chelsea","08:00:00","2020-09-16",881,66,11,273,48,1279
"Kingston upon Thames","08:00:00","2020-09-16",113,2,1,7,2,125
"Lambeth","08:00:00","2020-09-16",147,4,1,27,2,181
"Southwark","08:00:00","2020-09-16",144,33,0,87,20,284
"Ealing","09:00:00","2020-09-16",1438,37,67,394,167,2103
"Hillingdon","09:00:00","2020-09-16",129,0,0,23,6,158
"Hounslow","09:00:00","2020-09-16",2994,67,26,889,332,4308
"Kensington and Chelsea","09:00:00","2020-09-16",899,38,19,247,90,1293
"Kingston upon Thames","09:00:00","2020-09-16",28,0,0,3,2,33
"Lambeth","09:00:00","2020-09-16",113,7,0,33,2,155
"Southwark","09:00:00","2020-09-16",103,18,0,90,20,231
"Ealing","10:00:00","2020-09-16",1708,49,98,540,253,2648
"Hillingdon","10:00:00","2020-09-16",107,8,1,17,2,135
"Hounslow","10:00:00","2020-09-16",3169,63,20,860,364,4476
"Kensington and Chelsea","10:00:00","2020-09-16",877,52,16,342,109,1396
"Kingston upon Thames","10:00:00","2020-09-16",33,0,0,8,0,41
"Lambeth","10:00:00","2020-09-16",80,6,0,27,8,121
"Southwark","10:00:00","2020-09-16",126,33,0,79,28,266
"Ealing","11:00:00","2020-09-16",1932,34,89,531,222,2808
"Hillingdon","11:00:00","2020-09-16",97,0,0,20,7,124
"Hounslow","11:00:00","2020-09-16",3225,63,25,879,337,4529
"Kensington and Chelsea","11:00:00","2020-09-16",966,58,11,385,86,1506
"Kingston upon Thames","11:00:00","2020-09-16",38,0,0,1,1,40
"Lambeth","11:00:00","2020-09-16",94,6,0,51,5,156
"Southwark","11:00:00","2020-09-16",118,20,0,74,22,234
"Ealing","12:00:00","2020-09-16",2088,42,92,526,220,2968
"Hillingdon","12:00:00","2020-09-16",122,0,0,16,4,142
"Hounslow","12:00:00","2020-09-16",3194,83,20,916,340,4553
"Kensington and Chelsea","12:00:00","2020-09-16",993,60,16,335,94,1498
"Kingston upon Thames","12:00:00","2020-09-16",38,1,0,6,1,46
"Lambeth","12:00:00","2020-09-16",88,13,0,46,6,153
"Southwark","12:00:00","2020-09-16",132,47,0,55,26,260
"Ealing","13:00:00","2020-09-16",2167,55,92,481,204,2999
"Hillingdon","13:00:00","2020-09-16",137,0,0,7,4,148
"Hounslow","13:00:00","2020-09-16",3284,89,18,955,308,4654
"Kensington and Chelsea","13:00:00","2020-09-16",924,74,16,351,97,1462
"Kingston upon Thames","13:00:00","2020-09-16",35,0,0,0,0,35
"Lambeth","13:00:00","2020-09-16",108,14,0,40,3,165
"Southwark","13:00:00","2020-09-16",125,40,0,78,22,265
"Ealing","14:00:00","2020-09-16",2496,53,109,519,212,3389
"Hillingdon","14:00:00","2020-09-16",193,2,0,15,5,215
"Hounslow","14:00:00","2020-09-16",3556,89,29,1036,285,4995
"Kensington and Chelsea","14:00:00","2020-09-16",988,66,16,371,71,1512
"Kingston upon Thames","14:00:00","2020-09-16",57,3,0,4,2,66
"Lambeth","14:00:00","2020-09-16",134,18,2,42,0,196
"Southwark","14:00:00","2020-09-16",137,33,0,83,15,268
"Ealing","15:00:00","2020-09-16",2203,89,93,507,174,3066
"Hillingdon","15:00:00","2020-09-16",371,0,0,27,7,405
"Hounslow","15:00:00","2020-09-16",3688,91,26,1126,231,5162
"Kensington and Chelsea","15:00:00","2020-09-16",1032,82,17,364,79,1574
"Kingston upon Thames","15:00:00","2020-09-16",95,0,1,7,2,105
"Lambeth","15:00:00","2020-09-16",125,13,0,28,5,171
"Southwark","15:00:00","2020-09-16",171,38,1,77,17,304
"Ealing","16:00:00","2020-09-16",1706,76,64,347,96,2289
"Hillingdon","16:00:00","2020-09-16",219,3,0,28,4,254
"Hounslow","16:00:00","2020-09-16",3839,140,35,1130,153,5297
"Kensington and Chelsea","16:00:00","2020-09-16",894,106,16,331,36,1383
"Kingston upon Thames","16:00:00","2020-09-16",47,4,0,9,2,62
"Lambeth","16:00:00","2020-09-16",181,18,0,37,8,244
"Southwark","16:00:00","2020-09-16",175,47,0,80,8,310
"Ealing","17:00:00","2020-09-16",1659,90,63,302,75,2189
"Hillingdon","17:00:00","2020-09-16",206,3,0,23,5,237
"Hounslow","17:00:00","2020-09-16",4216,170,34,824,121,5365
"Kensington and Chelsea","17:00:00","2020-09-16",1022,130,16,288,37,1493
"Kingston upon Thames","17:00:00","2020-09-16",65,2,0,7,0,74
"Lambeth","17:00:00","2020-09-16",150,7,0,34,3,194
"Southwark","17:00:00","2020-09-16",205,44,0,62,7,318
"Ealing","18:00:00","2020-09-16",1701,68,64,246,53,2132
"Hillingdon","18:00:00","2020-09-16",183,0,0,14,3,200
"Hounslow","18:00:00","2020-09-16",4440,142,24,590,96,5292
"Kensington and Chelsea","18:00:00","2020-09-16",1191,108,18,192,21,1530
"Kingston upon Thames","18:00:00","2020-09-16",64,1,0,9,0,74
"Lambeth","18:00:00","2020-09-16",156,16,0,23,0,195
"Southwark","18:00:00","2020-09-16",189,59,0,37,7,292
"Croydon","07:00:00","2020-09-17",453,4,26,150,14,647
"Hackney","07:00:00","2020-09-17",447,25,14,140,28,654
"Havering","07:00:00","2020-09-17",531,3,19,152,22,727
"Sutton","07:00:00","2020-09-17",398,3,8,81,12,502
"Croydon","08:00:00","2020-09-17",648,6,24,129,13,820
"Hackney","08:00:00","2020-09-17",779,32,14,158,27,1010
"Havering","08:00:00","2020-09-17",847,6,20,131,26,1030
"Sutton","08:00:00","2020-09-17",440,3,8,55,11,517
"Croydon","09:00:00","2020-09-17",384,8,32,110,21,555
"Hackney","09:00:00","2020-09-17",579,34,15,200,41,869
"Havering","09:00:00","2020-09-17",521,8,26,119,23,697
"Sutton","09:00:00","2020-09-17",269,3,10,52,14,348
"Croydon","10:00:00","2020-09-17",276,1,24,79,23,403
"Hackney","10:00:00","2020-09-17",458,40,15,186,46,745
"Havering","10:00:00","2020-09-17",454,5,20,87,24,590
"Sutton","10:00:00","2020-09-17",220,5,9,35,14,283
"Croydon","11:00:00","2020-09-17",321,6,31,102,20,480
"Hackney","11:00:00","2020-09-17",469,39,15,179,39,741
"Havering","11:00:00","2020-09-17",479,2,18,103,27,629
"Sutton","11:00:00","2020-09-17",223,3,8,42,7,283
"Croydon","12:00:00","2020-09-17",323,11,24,102,27,487
"Hackney","12:00:00","2020-09-17",526,82,12,186,38,844
"Havering","12:00:00","2020-09-17",525,6,20,84,22,657
"Sutton","12:00:00","2020-09-17",190,4,8,40,5,247
"Croydon","13:00:00","2020-09-17",385,4,28,100,21,538
"Hackney","13:00:00","2020-09-17",531,73,13,175,16,808
"Havering","13:00:00","2020-09-17",552,11,18,85,29,695
"Sutton","13:00:00","2020-09-17",229,9,8,42,7,295
"Croydon","14:00:00","2020-09-17",509,8,31,106,23,677
"Hackney","14:00:00","2020-09-17",605,47,15,165,25,857
"Havering","14:00:00","2020-09-17",709,3,23,115,19,869
"Sutton","14:00:00","2020-09-17",307,5,9,55,6,382
"Croydon","15:00:00","2020-09-17",562,5,24,131,19,741
"Hackney","15:00:00","2020-09-17",671,55,13,138,29,906
"Havering","15:00:00","2020-09-17",781,6,19,115,23,944
"Sutton","15:00:00","2020-09-17",387,7,7,67,7,475
"Croydon","16:00:00","2020-09-17",541,9,22,160,20,752
"Hackney","16:00:00","2020-09-17",679,67,15,137,19,917
"Havering","16:00:00","2020-09-17",709,15,18,159,9,910
"Sutton","16:00:00","2020-09-17",365,7,9,82,3,466
"Croydon","17:00:00","2020-09-17",566,9,26,120,8,729
"Hackney","17:00:00","2020-09-17",725,73,12,120,11,941
"Havering","17:00:00","2020-09-17",773,12,21,107,16,929
"Sutton","17:00:00","2020-09-17",401,7,9,57,7,481
"Croydon","18:00:00","2020-09-17",475,7,22,78,5,587
"Hackney","18:00:00","2020-09-17",687,103,13,74,15,892
"Havering","18:00:00","2020-09-17",649,5,19,83,4,760
"Sutton","18:00:00","2020-09-17",336,3,6,38,4,387
"Hounslow","07:00:00","2020-09-18",120,0,11,19,2,152
"Sutton","07:00:00","2020-09-18",8,0,0,2,0,10
"Hounslow","08:00:00","2020-09-18",141,2,13,9,2,167
"Sutton","08:00:00","2020-09-18",4,0,0,0,0,4
"Hounslow","09:00:00","2020-09-18",150,5,12,17,2,186
"Sutton","09:00:00","2020-09-18",4,0,0,0,0,4
"Hounslow","10:00:00","2020-09-18",117,2,9,15,1,144
"Sutton","10:00:00","2020-09-18",1,0,0,2,0,3
"Hounslow","11:00:00","2020-09-18",146,3,9,18,3,179
"Sutton","11:00:00","2020-09-18",4,0,0,1,0,5
"Hounslow","12:00:00","2020-09-18",182,7,5,32,0,226
"Sutton","12:00:00","2020-09-18",4,0,0,0,0,4
"Hounslow","13:00:00","2020-09-18",193,6,9,9,1,218
"Sutton","13:00:00","2020-09-18",5,0,0,0,1,6
"Hounslow","14:00:00","2020-09-18",173,9,9,16,4,211
"Sutton","14:00:00","2020-09-18",5,0,0,0,1,6
"Hounslow","15:00:00","2020-09-18",198,7,11,30,4,250
"Sutton","15:00:00","2020-09-18",3,0,0,0,0,3
"Hounslow","16:00:00","2020-09-18",191,13,12,11,1,228
"Sutton","16:00:00","2020-09-18",9,0,0,1,0,10
"Hounslow","17:00:00","2020-09-18",186,13,10,19,0,228
"Sutton","17:00:00","2020-09-18",9,0,0,1,0,10
"Hounslow","18:00:00","2020-09-18",177,9,9,16,4,215
"Sutton","18:00:00","2020-09-18",5,0,0,0,0,5
"Ealing","07:00:00","2020-09-21",615,26,24,170,36,871
"Lewisham","07:00:00","2020-09-21",418,11,4,89,11,533
"Ealing","08:00:00","2020-09-21",748,15,25,159,49,996
"Lewisham","08:00:00","2020-09-21",449,7,10,105,7,578
"Ealing","09:00:00","2020-09-21",585,13,26,166,42,832
"Lewisham","09:00:00","2020-09-21",394,12,6,97,12,521
"Ealing","10:00:00","2020-09-21",478,7,25,164,53,727
"Lewisham","10:00:00","2020-09-21",378,7,2,88,12,487
"Ealing","11:00:00","2020-09-21",522,10,27,172,60,791
"Lewisham","11:00:00","2020-09-21",331,8,1,84,14,438
"Ealing","12:00:00","2020-09-21",569,17,27,155,58,826
"Lewisham","12:00:00","2020-09-21",367,9,0,87,12,475
"Ealing","13:00:00","2020-09-21",607,16,27,134,55,839
"Lewisham","13:00:00","2020-09-21",384,14,2,82,11,493
"Ealing","14:00:00","2020-09-21",671,23,26,145,59,924
"Lewisham","14:00:00","2020-09-21",477,12,14,106,8,617
"Ealing","15:00:00","2020-09-21",703,24,27,126,30,910
"Lewisham","15:00:00","2020-09-21",477,14,10,89,6,596
"Ealing","16:00:00","2020-09-21",734,24,21,141,29,949
"Lewisham","16:00:00","2020-09-21",458,12,3,103,8,584
"Ealing","17:00:00","2020-09-21",756,35,25,127,23,966
"Lewisham","17:00:00","2020-09-21",534,23,1,94,2,654
"Ealing","18:00:00","2020-09-21",718,37,28,98,12,893
"Lewisham","18:00:00","2020-09-21",504,23,2,67,5,601
"Greenwich","07:00:00","2020-09-22",1168,105,7,478,102,1860
"Hackney","07:00:00","2020-09-22",34,0,0,6,1,41
"Kingston upon Thames","07:00:00","2020-09-22",703,10,6,211,17,947
"Southwark","07:00:00","2020-09-22",15,1,0,2,0,18
"Greenwich","08:00:00","2020-09-22",1178,56,2,317,100,1653
"Hackney","08:00:00","2020-09-22",65,0,0,11,4,80
"Kingston upon Thames","08:00:00","2020-09-22",747,18,7,152,17,941
"Southwark","08:00:00","2020-09-22",21,0,0,3,1,25
"Greenwich","09:00:00","2020-09-22",1069,44,2,317,96,1528
"Hackney","09:00:00","2020-09-22",50,2,0,14,4,70
"Kingston upon Thames","09:00:00","2020-09-22",597,8,1,138,25,769
"Southwark","09:00:00","2020-09-22",25,0,1,3,1,30
"Greenwich","10:00:00","2020-09-22",1220,33,3,337,126,1719
"Hackney","10:00:00","2020-09-22",40,4,0,28,5,77
"Kingston upon Thames","10:00:00","2020-09-22",597,4,0,105,21,727
"Southwark","10:00:00","2020-09-22",14,0,0,2,4,20
"Greenwich","11:00:00","2020-09-22",1151,22,0,352,111,1636
"Hackney","11:00:00","2020-09-22",28,10,0,20,4,62
"Kingston upon Thames","11:00:00","2020-09-22",542,12,0,117,23,694
"Southwark","11:00:00","2020-09-22",17,2,2,2,0,23
"Greenwich","12:00:00","2020-09-22",1123,39,1,312,84,1559
"Hackney","12:00:00","2020-09-22",46,4,0,11,0,61
"Kingston upon Thames","12:00:00","2020-09-22",614,7,1,104,18,744
"Southwark","12:00:00","2020-09-22",16,2,0,2,2,22
"Greenwich","13:00:00","2020-09-22",1240,45,0,342,99,1726
"Hackney","13:00:00","2020-09-22",59,13,0,32,5,109
"Kingston upon Thames","13:00:00","2020-09-22",593,5,3,116,23,740
"Southwark","13:00:00","2020-09-22",17,4,0,3,2,26
"Greenwich","14:00:00","2020-09-22",1182,46,4,343,74,1649
"Hackney","14:00:00","2020-09-22",68,5,0,21,3,97
"Kingston upon Thames","14:00:00","2020-09-22",608,13,6,114,23,764
"Southwark","14:00:00","2020-09-22",33,3,0,4,0,40
"Greenwich","15:00:00","2020-09-22",1285,37,4,392,59,1777
"Hackney","15:00:00","2020-09-22",74,4,0,11,2,91
"Kingston upon Thames","15:00:00","2020-09-22",693,9,3,166,13,884
"Southwark","15:00:00","2020-09-22",23,2,0,4,2,31
"Greenwich","16:00:00","2020-09-22",1367,80,6,392,51,1896
"Hackney","16:00:00","2020-09-22",81,3,0,5,0,89
"Kingston upon Thames","16:00:00","2020-09-22",856,10,7,145,15,1033
"Southwark","16:00:00","2020-09-22",23,4,0,1,0,28
"Greenwich","17:00:00","2020-09-22",1437,104,2,304,36,1883
"Hackney","17:00:00","2020-09-22",69,4,0,15,2,90
"Kingston upon Thames","17:00:00","2020-09-22",891,16,3,123,13,1046
"Southwark","17:00:00","2020-09-22",23,0,0,2,0,25
"Greenwich","18:00:00","2020-09-22",1386,91,4,207,31,1719
"Hackney","18:00:00","2020-09-22",73,15,0,4,0,92
"Kingston upon Thames","18:00:00","2020-09-22",683,12,4,90,7,796
"Southwark","18:00:00","2020-09-22",21,6,0,5,0,32
"Barking and Dagenham","07:00:00","2020-09-23",50,0,0,5,2,57
"Bexley","07:00:00","2020-09-23",342,8,29,78,30,487
"Hounslow","07:00:00","2020-09-23",777,13,9,222,95,1116
"Barking and Dagenham","08:00:00","2020-09-23",73,0,0,10,0,83
"Bexley","08:00:00","2020-09-23",754,0,22,83,23,882
"Hounslow","08:00:00","2020-09-23",801,6,9,223,84,1123
"Barking and Dagenham","09:00:00","2020-09-23",43,0,0,9,2,54
"Bexley","09:00:00","2020-09-23",372,1,23,78,28,502
"Hounslow","09:00:00","2020-09-23",492,3,12,182,102,791
"Barking and Dagenham","10:00:00","2020-09-23",36,0,0,6,1,43
"Bexley","10:00:00","2020-09-23",284,7,19,75,39,424
"Hounslow","10:00:00","2020-09-23",352,8,6,162,111,639
"Barking and Dagenham","11:00:00","2020-09-23",40,0,0,4,0,44
"Bexley","11:00:00","2020-09-23",316,3,19,77,25,440
"Hounslow","11:00:00","2020-09-23",375,5,7,162,79,628
"Barking and Dagenham","12:00:00","2020-09-23",38,2,0,9,3,52
"Bexley","12:00:00","2020-09-23",354,6,19,68,44,491
"Hounslow","12:00:00","2020-09-23",508,6,9,178,112,813
"Barking and Dagenham","13:00:00","2020-09-23",49,2,0,1,0,52
"Bexley","13:00:00","2020-09-23",374,1,24,77,34,510
"Hounslow","13:00:00","2020-09-23",547,10,7,184,94,842
"Barking and Dagenham","14:00:00","2020-09-23",45,1,0,5,0,51
"Bexley","14:00:00","2020-09-23",497,4,22,97,51,671
"Hounslow","14:00:00","2020-09-23",581,9,9,183,101,883
"Barking and Dagenham","15:00:00","2020-09-23",52,1,0,5,1,59
"Bexley","15:00:00","2020-09-23",624,2,28,82,22,758
"Hounslow","15:00:00","2020-09-23",670,6,7,192,81,956
"Barking and Dagenham","16:00:00","2020-09-23",44,0,0,4,0,48
"Bexley","16:00:00","2020-09-23",487,1,23,98,14,623
"Hounslow","16:00:00","2020-09-23",692,7,11,214,93,1017
"Barking and Dagenham","17:00:00","2020-09-23",53,0,0,6,0,59
"Bexley","17:00:00","2020-09-23",503,5,20,55,17,600
"Hounslow","17:00:00","2020-09-23",904,9,9,156,65,1143
"Barking and Dagenham","18:00:00","2020-09-23",51,1,0,7,0,59
"Bexley","18:00:00","2020-09-23",403,2,19,65,10,499
"Hounslow","18:00:00","2020-09-23",665,7,8,149,52,881
"Barnet","07:00:00","2020-09-24",4629,165,38,1912,520,7264
"Brent","07:00:00","2020-09-24",1058,57,97,435,89,1736
"Havering","07:00:00","2020-09-24",114,2,8,34,6,164
"Hillingdon","07:00:00","2020-09-24",17,0,0,4,0,21
"Lewisham","07:00:00","2020-09-24",18,0,0,3,0,21
"Barnet","08:00:00","2020-09-24",4161,116,34,1526,526,6363
"Brent","08:00:00","2020-09-24",1197,45,59,356,65,1722
"Havering","08:00:00","2020-09-24",115,1,8,22,1,147
"Hillingdon","08:00:00","2020-09-24",57,0,0,3,0,60
"Lewisham","08:00:00","2020-09-24",28,0,0,9,0,37
"Barnet","09:00:00","2020-09-24",4272,81,37,1493,641,6524
"Brent","09:00:00","2020-09-24",1031,58,72,351,119,1631
"Havering","09:00:00","2020-09-24",57,0,6,18,4,85
"Hillingdon","09:00:00","2020-09-24",14,0,0,3,0,17
"Lewisham","09:00:00","2020-09-24",15,0,0,7,2,24
"Barnet","10:00:00","2020-09-24",4233,85,24,1648,697,6687
"Brent","10:00:00","2020-09-24",1066,57,73,310,94,1600
"Havering","10:00:00","2020-09-24",76,0,6,17,2,101
"Hillingdon","10:00:00","2020-09-24",10,2,0,5,0,17
"Lewisham","10:00:00","2020-09-24",18,3,0,13,0,34
"Barnet","11:00:00","2020-09-24",4294,75,25,1583,693,6670
"Brent","11:00:00","2020-09-24",1105,64,64,327,108,1668
"Havering","11:00:00","2020-09-24",65,0,6,18,0,89
"Hillingdon","11:00:00","2020-09-24",24,2,0,1,0,27
"Lewisham","11:00:00","2020-09-24",16,2,0,4,1,23
"Barnet","12:00:00","2020-09-24",4464,80,17,1453,686,6700
"Brent","12:00:00","2020-09-24",1221,54,67,333,80,1755
"Havering","12:00:00","2020-09-24",77,0,6,20,6,109
"Hillingdon","12:00:00","2020-09-24",13,2,0,5,0,20
"Lewisham","12:00:00","2020-09-24",13,0,0,8,2,23
"Barnet","13:00:00","2020-09-24",4472,96,31,1464,641,6704
"Brent","13:00:00","2020-09-24",1179,85,75,288,86,1713
"Havering","13:00:00","2020-09-24",63,1,6,17,3,90
"Hillingdon","13:00:00","2020-09-24",17,0,0,2,0,19
"Lewisham","13:00:00","2020-09-24",13,5,0,4,2,24
"Barnet","14:00:00","2020-09-24",4495,96,31,1493,576,6691
"Brent","14:00:00","2020-09-24",1197,55,70,272,91,1685
"Havering","14:00:00","2020-09-24",86,2,5,14,4,111
"Hillingdon","14:00:00","2020-09-24",60,0,0,2,1,63
"Lewisham","14:00:00","2020-09-24",18,3,0,5,0,26
"Barnet","15:00:00","2020-09-24",4782,105,27,1559,475,6948
"Brent","15:00:00","2020-09-24",1246,81,68,240,63,1698
"Havering","15:00:00","2020-09-24",104,0,6,20,2,132
"Hillingdon","15:00:00","2020-09-24",31,0,0,1,0,32
"Lewisham","15:00:00","2020-09-24",23,1,0,5,0,29
"Barnet","16:00:00","2020-09-24",5593,140,35,1589,345,7702
"Brent","16:00:00","2020-09-24",1295,90,81,284,47,1797
"Havering","16:00:00","2020-09-24",127,1,8,34,2,172
"Hillingdon","16:00:00","2020-09-24",15,0,0,6,0,21
"Lewisham","16:00:00","2020-09-24",13,0,0,4,0,17
"Barnet","17:00:00","2020-09-24",5967,183,44,1402,262,7858
"Brent","17:00:00","2020-09-24",1370,109,56,294,32,1861
"Havering","17:00:00","2020-09-24",127,0,7,21,1,156
"Hillingdon","17:00:00","2020-09-24",32,0,0,5,0,37
"Lewisham","17:00:00","2020-09-24",22,1,0,4,0,27
"Barnet","18:00:00","2020-09-24",6136,180,29,1038,166,7549
"Brent","18:00:00","2020-09-24",1448,95,69,193,23,1828
"Havering","18:00:00","2020-09-24",119,1,6,20,3,149
"Hillingdon","18:00:00","2020-09-24",20,2,0,4,0,26
"Lewisham","18:00:00","2020-09-24",24,7,0,8,0,39
"Barnet","07:00:00","2020-09-25",3233,115,26,1252,377,5003
"Haringey","07:00:00","2020-09-25",137,2,1,29,4,173
"Lewisham","07:00:00","2020-09-25",114,3,0,37,3,157
"Redbridge","07:00:00","2020-09-25",386,0,18,67,9,480
"Sutton","07:00:00","2020-09-25",231,1,7,34,2,275
"Barnet","08:00:00","2020-09-25",3318,73,22,1125,401,4939
"Haringey","08:00:00","2020-09-25",136,1,0,23,3,163
"Lewisham","08:00:00","2020-09-25",200,3,0,25,4,232
"Redbridge","08:00:00","2020-09-25",611,1,14,48,9,683
"Sutton","08:00:00","2020-09-25",431,1,4,31,1,468
"Barnet","09:00:00","2020-09-25",3294,45,29,1080,453,4901
"Haringey","09:00:00","2020-09-25",107,0,1,24,5,137
"Lewisham","09:00:00","2020-09-25",114,1,0,33,2,150
"Redbridge","09:00:00","2020-09-25",459,1,16,56,11,543
"Sutton","09:00:00","2020-09-25",205,0,5,29,4,243
"Barnet","10:00:00","2020-09-25",3206,55,20,1002,465,4748
"Haringey","10:00:00","2020-09-25",83,6,0,26,5,120
"Lewisham","10:00:00","2020-09-25",98,5,0,20,3,126
"Redbridge","10:00:00","2020-09-25",379,5,11,50,17,462
"Sutton","10:00:00","2020-09-25",195,1,4,26,4,230
"Barnet","11:00:00","2020-09-25",3361,35,19,1043,498,4956
"Haringey","11:00:00","2020-09-25",76,3,0,16,1,96
"Lewisham","11:00:00","2020-09-25",105,6,0,22,4,137
"Redbridge","11:00:00","2020-09-25",385,1,12,53,7,458
"Sutton","11:00:00","2020-09-25",173,1,4,23,2,203
"Barnet","12:00:00","2020-09-25",3610,49,16,1051,404,5130
"Haringey","12:00:00","2020-09-25",109,6,1,23,4,143
"Lewisham","12:00:00","2020-09-25",123,9,0,26,0,158
"Redbridge","12:00:00","2020-09-25",429,7,10,59,17,522
"Sutton","12:00:00","2020-09-25",226,6,4,35,3,274
"Barnet","13:00:00","2020-09-25",3648,68,21,957,403,5097
"Haringey","13:00:00","2020-09-25",86,10,2,26,2,126
"Lewisham","13:00:00","2020-09-25",135,7,0,31,3,176
"Redbridge","13:00:00","2020-09-25",465,3,13,55,14,550
"Sutton","13:00:00","2020-09-25",239,3,4,43,1,290
"Barnet","14:00:00","2020-09-25",3273,55,27,747,319,4421
"Haringey","14:00:00","2020-09-25",118,7,1,25,3,154
"Lewisham","14:00:00","2020-09-25",160,11,0,28,2,201
"Redbridge","14:00:00","2020-09-25",492,11,11,59,8,581
"Sutton","14:00:00","2020-09-25",246,8,4,30,2,290
"Barnet","15:00:00","2020-09-25",2932,54,15,650,245,3896
"Haringey","15:00:00","2020-09-25",136,8,1,16,3,164
"Lewisham","15:00:00","2020-09-25",209,9,0,21,0,239
"Redbridge","15:00:00","2020-09-25",543,12,11,42,9,617
"Sutton","15:00:00","2020-09-25",328,12,4,28,4,376
"Barnet","16:00:00","2020-09-25",3436,106,18,780,199,4539
"Haringey","16:00:00","2020-09-25",111,2,1,8,4,126
"Lewisham","16:00:00","2020-09-25",170,10,0,40,2,222
"Redbridge","16:00:00","2020-09-25",559,7,13,57,13,649
"Sutton","16:00:00","2020-09-25",316,7,5,49,2,379
"Barnet","17:00:00","2020-09-25",3754,93,16,723,154,4740
"Haringey","17:00:00","2020-09-25",100,8,0,22,2,132
"Lewisham","17:00:00","2020-09-25",194,16,0,30,1,241
"Redbridge","17:00:00","2020-09-25",518,8,12,55,1,594
"Sutton","17:00:00","2020-09-25",345,8,5,35,4,397
"Barnet","18:00:00","2020-09-25",4150,111,22,630,112,5025
"Haringey","18:00:00","2020-09-25",127,14,0,13,1,155
"Lewisham","18:00:00","2020-09-25",180,8,0,20,0,208
"Redbridge","18:00:00","2020-09-25",585,15,11,56,3,670
"Sutton","18:00:00","2020-09-25",271,16,4,20,1,312
"Barnet","07:00:00","2020-09-28",256,3,9,50,6,324
"Camden","07:00:00","2020-09-28",14,1,0,17,2,34
"Kingston upon Thames","07:00:00","2020-09-28",136,2,3,36,5,182
"Barnet","08:00:00","2020-09-28",373,3,8,30,7,421
"Camden","08:00:00","2020-09-28",30,6,0,18,4,58
"Kingston upon Thames","08:00:00","2020-09-28",378,5,1,44,6,434
"Barnet","09:00:00","2020-09-28",212,5,7,44,11,279
"Camden","09:00:00","2020-09-28",27,3,0,14,5,49
"Kingston upon Thames","09:00:00","2020-09-28",163,1,0,25,5,194
"Barnet","10:00:00","2020-09-28",185,4,8,43,10,250
"Camden","10:00:00","2020-09-28",24,1,0,16,4,45
"Kingston upon Thames","10:00:00","2020-09-28",123,3,0,23,7,156
"Barnet","11:00:00","2020-09-28",217,7,5,23,9,261
"Camden","11:00:00","2020-09-28",45,8,0,27,7,87
"Kingston upon Thames","11:00:00","2020-09-28",135,2,0,27,5,169
"Barnet","12:00:00","2020-09-28",223,7,6,38,6,280
"Camden","12:00:00","2020-09-28",38,8,0,20,3,69
"Kingston upon Thames","12:00:00","2020-09-28",182,6,1,33,11,233
"Barnet","13:00:00","2020-09-28",248,11,7,46,9,321
"Camden","13:00:00","2020-09-28",45,14,0,22,3,84
"Kingston upon Thames","13:00:00","2020-09-28",145,8,0,23,3,179
"Barnet","14:00:00","2020-09-28",260,7,6,37,12,322
"Camden","14:00:00","2020-09-28",48,14,0,14,5,81
"Kingston upon Thames","14:00:00","2020-09-28",266,2,1,33,1,303
"Barnet","15:00:00","2020-09-28",346,7,8,34,8,403
"Camden","15:00:00","2020-09-28",62,11,0,21,3,97
"Kingston upon Thames","15:00:00","2020-09-28",307,4,0,38,5,354
"Barnet","16:00:00","2020-09-28",317,6,9,60,2,394
"Camden","16:00:00","2020-09-28",43,6,1,13,2,65
"Kingston upon Thames","16:00:00","2020-09-28",232,5,1,29,4,271
"Barnet","17:00:00","2020-09-28",345,17,6,42,3,413
"Camden","17:00:00","2020-09-28",60,13,0,18,3,94
"Kingston upon Thames","17:00:00","2020-09-28",226,5,1,24,6,262
"Barnet","18:00:00","2020-09-28",251,11,5,20,1,288
"Camden","18:00:00","2020-09-28",66,21,0,9,2,98
"Kingston upon Thames","18:00:00","2020-09-28",215,7,0,19,4,245
"Harrow","07:00:00","2020-09-29",591,8,0,87,5,691
"Hounslow","07:00:00","2020-09-29",10,0,0,0,1,11
"Newham","07:00:00","2020-09-29",24,0,15,10,1,50
"Harrow","08:00:00","2020-09-29",751,4,1,54,6,816
"Hounslow","08:00:00","2020-09-29",22,0,0,1,1,24
"Newham","08:00:00","2020-09-29",130,0,13,15,2,160
"Harrow","09:00:00","2020-09-29",561,11,1,62,17,652
"Hounslow","09:00:00","2020-09-29",13,0,0,3,1,17
"Newham","09:00:00","2020-09-29",46,1,13,9,2,71
"Harrow","10:00:00","2020-09-29",446,8,0,62,8,524
"Hounslow","10:00:00","2020-09-29",9,3,0,3,0,15
"Newham","10:00:00","2020-09-29",36,1,13,8,3,61
"Harrow","11:00:00","2020-09-29",461,9,1,76,11,558
"Hounslow","11:00:00","2020-09-29",10,0,0,5,1,16
"Newham","11:00:00","2020-09-29",50,1,12,21,1,85
"Harrow","12:00:00","2020-09-29",474,9,0,62,10,555
"Hounslow","12:00:00","2020-09-29",15,0,0,8,0,23
"Newham","12:00:00","2020-09-29",33,1,13,7,2,56
"Harrow","13:00:00","2020-09-29",536,12,1,57,7,613
"Hounslow","13:00:00","2020-09-29",5,2,0,7,1,15
"Newham","13:00:00","2020-09-29",54,0,13,19,2,88
"Harrow","14:00:00","2020-09-29",582,17,0,50,8,657
"Hounslow","14:00:00","2020-09-29",13,1,0,1,2,17
"Newham","14:00:00","2020-09-29",63,1,13,15,2,94
"Harrow","15:00:00","2020-09-29",725,9,2,64,5,805
"Hounslow","15:00:00","2020-09-29",16,1,0,3,1,21
"Newham","15:00:00","2020-09-29",121,2,14,11,3,151
"Harrow","16:00:00","2020-09-29",705,12,0,55,8,780
"Hounslow","16:00:00","2020-09-29",10,0,0,3,1,14
"Newham","16:00:00","2020-09-29",70,4,15,11,0,100
"Harrow","17:00:00","2020-09-29",702,18,0,54,5,779
"Hounslow","17:00:00","2020-09-29",14,1,0,2,1,18
"Newham","17:00:00","2020-09-29",62,0,13,6,0,81
"Harrow","18:00:00","2020-09-29",638,11,0,54,2,705
"Hounslow","18:00:00","2020-09-29",14,2,0,0,1,17
"Newham","18:00:00","2020-09-29",64,6,15,2,0,87
"Ealing","07:00:00","2020-09-30",984,24,22,260,163,1453
"Harrow","07:00:00","2020-09-30",264,4,22,68,5,363
"Hounslow","07:00:00","2020-09-30",800,13,14,157,19,1003
"Redbridge","07:00:00","2020-09-30",2337,47,22,664,72,3142
"Tower Hamlets","07:00:00","2020-09-30",2307,323,20,1133,332,4115
"Ealing","08:00:00","2020-09-30",891,14,15,189,183,1292
"Harrow","08:00:00","2020-09-30",380,1,18,40,9,448
"Hounslow","08:00:00","2020-09-30",888,9,16,128,20,1061
"Redbridge","08:00:00","2020-09-30",2498,33,28,524,60,3143
"Tower Hamlets","08:00:00","2020-09-30",2495,167,13,1055,384,4114
"Ealing","09:00:00","2020-09-30",827,25,31,159,246,1288
"Harrow","09:00:00","2020-09-30",200,3,19,42,8,272
"Hounslow","09:00:00","2020-09-30",686,19,14,131,36,886
"Redbridge","09:00:00","2020-09-30",1988,24,20,470,81,2583
"Tower Hamlets","09:00:00","2020-09-30",2146,116,6,987,446,3701
"Ealing","10:00:00","2020-09-30",797,30,25,172,224,1248
"Harrow","10:00:00","2020-09-30",160,4,17,38,6,225
"Hounslow","10:00:00","2020-09-30",584,11,7,149,27,778
"Redbridge","10:00:00","2020-09-30",1704,15,17,396,82,2214
"Tower Hamlets","10:00:00","2020-09-30",1955,98,6,974,428,3461
"Ealing","11:00:00","2020-09-30",934,21,17,184,215,1371
"Harrow","11:00:00","2020-09-30",193,0,15,29,3,240
"Hounslow","11:00:00","2020-09-30",634,7,8,113,31,793
"Redbridge","11:00:00","2020-09-30",1726,18,19,396,84,2243
"Tower Hamlets","11:00:00","2020-09-30",2146,94,1,975,433,3649
"Ealing","12:00:00","2020-09-30",987,20,20,170,220,1417
"Harrow","12:00:00","2020-09-30",237,2,16,34,8,297
"Hounslow","12:00:00","2020-09-30",713,26,8,152,27,926
"Redbridge","12:00:00","2020-09-30",1797,10,20,356,83,2266
"Tower Hamlets","12:00:00","2020-09-30",2337,134,4,1005,419,3899
"Ealing","13:00:00","2020-09-30",1052,16,21,204,203,1496
"Harrow","13:00:00","2020-09-30",218,1,17,38,12,286
"Hounslow","13:00:00","2020-09-30",734,17,6,120,44,921
"Redbridge","13:00:00","2020-09-30",1800,21,17,390,83,2311
"Tower Hamlets","13:00:00","2020-09-30",2433,143,9,1046,391,4022
"Ealing","14:00:00","2020-09-30",1137,36,26,195,175,1569
"Harrow","14:00:00","2020-09-30",295,2,20,31,1,349
"Hounslow","14:00:00","2020-09-30",800,12,13,128,30,983
"Redbridge","14:00:00","2020-09-30",1895,24,26,361,76,2382
"Tower Hamlets","14:00:00","2020-09-30",2703,140,2,1086,380,4311
"Ealing","15:00:00","2020-09-30",1075,29,21,201,174,1500
"Harrow","15:00:00","2020-09-30",281,4,18,53,14,370
"Hounslow","15:00:00","2020-09-30",842,18,15,109,17,1001
"Redbridge","15:00:00","2020-09-30",2113,16,17,335,39,2520
"Tower Hamlets","15:00:00","2020-09-30",2782,181,10,1065,264,4302
"Ealing","16:00:00","2020-09-30",1123,30,17,201,151,1522
"Harrow","16:00:00","2020-09-30",303,3,19,53,7,385
"Hounslow","16:00:00","2020-09-30",885,22,18,113,12,1050
"Redbridge","16:00:00","2020-09-30",2202,24,23,393,48,2690
"Tower Hamlets","16:00:00","2020-09-30",2723,275,7,1095,229,4329
"Ealing","17:00:00","2020-09-30",1234,33,16,207,144,1634
"Harrow","17:00:00","2020-09-30",386,4,15,77,3,485
"Hounslow","17:00:00","2020-09-30",906,21,10,132,16,1085
"Redbridge","17:00:00","2020-09-30",2269,33,17,307,22,2648
"Tower Hamlets","17:00:00","2020-09-30",2987,317,11,959,161,4435
"Ealing","18:00:00","2020-09-30",1219,39,18,164,103,1543
"Harrow","18:00:00","2020-09-30",387,2,17,53,6,465
"Hounslow","18:00:00","2020-09-30",864,16,6,92,13,991
"Redbridge","18:00:00","2020-09-30",2186,32,19,275,19,2531
"Tower Hamlets","18:00:00","2020-09-30",3290,313,11,697,103,4414
"Barnet","07:00:00","2020-10-01",1034,13,57,321,41,1466
"Bromley","07:00:00","2020-10-01",420,7,7,165,9,608
"Croydon","07:00:00","2020-10-01",80,1,0,13,0,94
"Lambeth","07:00:00","2020-10-01",138,5,34,41,15,233
"Barnet","08:00:00","2020-10-01",1759,14,50,239,50,2112
"Bromley","08:00:00","2020-10-01",499,11,7,102,9,628
"Croydon","08:00:00","2020-10-01",148,1,2,14,2,167
"Lambeth","08:00:00","2020-10-01",229,7,42,53,17,348
"Barnet","09:00:00","2020-10-01",1279,23,58,264,47,1671
"Bromley","09:00:00","2020-10-01",520,4,6,98,13,641
"Croydon","09:00:00","2020-10-01",84,4,0,14,4,106
"Lambeth","09:00:00","2020-10-01",202,12,36,74,17,341
"Barnet","10:00:00","2020-10-01",1088,38,52,244,55,1477
"Bromley","10:00:00","2020-10-01",423,5,6,72,13,519
"Croydon","10:00:00","2020-10-01",79,3,0,17,3,102
"Lambeth","10:00:00","2020-10-01",172,11,35,58,24,300
"Barnet","11:00:00","2020-10-01",1229,55,51,239,61,1635
"Bromley","11:00:00","2020-10-01",415,4,6,89,16,530
"Croydon","11:00:00","2020-10-01",88,5,0,23,1,117
"Lambeth","11:00:00","2020-10-01",187,22,37,84,18,348
"Barnet","12:00:00","2020-10-01",1280,57,47,240,45,1669
"Bromley","12:00:00","2020-10-01",469,8,6,88,15,586
"Croydon","12:00:00","2020-10-01",75,2,0,21,1,99
"Lambeth","12:00:00","2020-10-01",209,30,34,77,29,379
"Barnet","13:00:00","2020-10-01",1259,74,48,204,38,1623
"Bromley","13:00:00","2020-10-01",483,6,6,93,13,601
"Croydon","13:00:00","2020-10-01",101,7,0,17,1,126
"Lambeth","13:00:00","2020-10-01",224,43,36,81,26,410
"Barnet","14:00:00","2020-10-01",1422,58,48,224,39,1791
"Bromley","14:00:00","2020-10-01",559,6,6,90,9,670
"Croydon","14:00:00","2020-10-01",114,3,2,21,5,145
"Lambeth","14:00:00","2020-10-01",287,36,35,78,18,454
"Barnet","15:00:00","2020-10-01",1612,50,42,222,40,1966
"Bromley","15:00:00","2020-10-01",617,7,6,127,13,770
"Croydon","15:00:00","2020-10-01",166,4,0,25,1,196
"Lambeth","15:00:00","2020-10-01",285,29,36,74,9,433
"Barnet","16:00:00","2020-10-01",1637,70,52,218,23,2000
"Bromley","16:00:00","2020-10-01",641,1,6,124,6,778
"Croydon","16:00:00","2020-10-01",152,5,1,28,2,188
"Lambeth","16:00:00","2020-10-01",287,54,32,83,7,463
"Barnet","17:00:00","2020-10-01",1651,91,47,211,25,2025
"Bromley","17:00:00","2020-10-01",666,7,7,103,9,792
"Croydon","17:00:00","2020-10-01",193,5,1,26,3,228
"Lambeth","17:00:00","2020-10-01",278,48,35,78,8,447
"Barnet","18:00:00","2020-10-01",1658,78,56,171,16,1979
"Bromley","18:00:00","2020-10-01",580,10,6,79,3,678
"Croydon","18:00:00","2020-10-01",151,7,0,15,1,174
"Lambeth","18:00:00","2020-10-01",252,53,39,43,3,390
"Bromley","07:00:00","2020-10-02",4,0,0,4,4,12
"Enfield","07:00:00","2020-10-02",282,2,4,64,5,357
"Kensington and Chelsea","07:00:00","2020-10-02",525,52,64,137,33,811
"Lambeth","07:00:00","2020-10-02",492,17,68,147,26,750
"Southwark","07:00:00","2020-10-02",825,28,27,215,33,1128
"Bromley","08:00:00","2020-10-02",38,0,0,3,0,41
"Enfield","08:00:00","2020-10-02",654,1,5,40,5,705
"Kensington and Chelsea","08:00:00","2020-10-02",699,44,53,149,40,985
"Lambeth","08:00:00","2020-10-02",591,25,61,133,23,833
"Southwark","08:00:00","2020-10-02",876,18,22,219,50,1185
"Bromley","09:00:00","2020-10-02",7,1,0,5,0,13
"Enfield","09:00:00","2020-10-02",453,1,5,46,8,513
"Kensington and Chelsea","09:00:00","2020-10-02",724,68,69,172,54,1087
"Lambeth","09:00:00","2020-10-02",551,38,72,159,30,850
"Southwark","09:00:00","2020-10-02",793,26,31,208,37,1095
"Bromley","10:00:00","2020-10-02",13,0,0,0,0,13
"Enfield","10:00:00","2020-10-02",311,0,4,38,7,360
"Kensington and Chelsea","10:00:00","2020-10-02",726,52,59,160,51,1048
"Lambeth","10:00:00","2020-10-02",477,32,64,172,44,789
"Southwark","10:00:00","2020-10-02",820,22,23,265,70,1200
"Bromley","11:00:00","2020-10-02",7,0,0,0,0,7
"Enfield","11:00:00","2020-10-02",339,1,7,50,7,404
"Kensington and Chelsea","11:00:00","2020-10-02",784,57,54,207,43,1145
"Lambeth","11:00:00","2020-10-02",504,51,57,179,45,836
"Southwark","11:00:00","2020-10-02",865,37,23,267,61,1253
"Bromley","12:00:00","2020-10-02",6,0,0,2,0,8
"Enfield","12:00:00","2020-10-02",387,3,4,40,6,440
"Kensington and Chelsea","12:00:00","2020-10-02",853,83,60,155,49,1200
"Lambeth","12:00:00","2020-10-02",573,57,58,151,40,879
"Southwark","12:00:00","2020-10-02",960,40,27,248,47,1322
"Bromley","13:00:00","2020-10-02",11,0,0,1,0,12
"Enfield","13:00:00","2020-10-02",363,4,4,44,11,426
"Kensington and Chelsea","13:00:00","2020-10-02",844,79,67,194,31,1215
"Lambeth","13:00:00","2020-10-02",602,80,61,159,33,935
"Southwark","13:00:00","2020-10-02",880,41,26,224,49,1220
"Bromley","14:00:00","2020-10-02",20,0,0,5,0,25
"Enfield","14:00:00","2020-10-02",489,4,4,30,6,533
"Kensington and Chelsea","14:00:00","2020-10-02",834,100,62,162,33,1191
"Lambeth","14:00:00","2020-10-02",600,49,64,148,34,895
"Southwark","14:00:00","2020-10-02",983,32,26,207,41,1289
"Bromley","15:00:00","2020-10-02",23,0,0,6,0,29
"Enfield","15:00:00","2020-10-02",599,2,5,48,10,664
"Kensington and Chelsea","15:00:00","2020-10-02",800,87,55,107,27,1076
"Lambeth","15:00:00","2020-10-02",697,57,65,137,18,974
"Southwark","15:00:00","2020-10-02",883,48,26,163,41,1161
"Bromley","16:00:00","2020-10-02",14,0,0,1,0,15
"Enfield","16:00:00","2020-10-02",521,4,4,67,5,601
"Kensington and Chelsea","16:00:00","2020-10-02",802,80,48,100,14,1044
"Lambeth","16:00:00","2020-10-02",676,61,68,151,15,971
"Southwark","16:00:00","2020-10-02",882,58,28,144,16,1128
"Bromley","17:00:00","2020-10-02",10,0,0,2,0,12
"Enfield","17:00:00","2020-10-02",462,3,5,28,1,499
"Kensington and Chelsea","17:00:00","2020-10-02",954,96,51,81,8,1190
"Lambeth","17:00:00","2020-10-02",743,87,62,86,11,989
"Southwark","17:00:00","2020-10-02",937,66,28,135,18,1184
"Bromley","18:00:00","2020-10-02",10,0,0,1,0,11
"Enfield","18:00:00","2020-10-02",399,8,4,36,2,449
"Kensington and Chelsea","18:00:00","2020-10-02",1059,115,51,44,12,1281
"Lambeth","18:00:00","2020-10-02",725,92,63,87,10,977
"Southwark","18:00:00","2020-10-02",935,50,29,78,12,1104
"Bexley","07:00:00","2020-10-05",173,2,0,42,2,219
"Greenwich","07:00:00","2020-10-05",3682,221,23,1380,334,5640
"Islington","07:00:00","2020-10-05",761,131,84,288,91,1355
"Waltham Forest","07:00:00","2020-10-05",1208,19,10,326,71,1634
"Bexley","08:00:00","2020-10-05",327,0,0,43,6,376
"Greenwich","08:00:00","2020-10-05",3539,121,16,1173,404,5253
"Islington","08:00:00","2020-10-05",703,98,83,312,134,1330
"Waltham Forest","08:00:00","2020-10-05",1159,8,14,237,68,1486
"Bexley","09:00:00","2020-10-05",167,2,0,31,5,205
"Greenwich","09:00:00","2020-10-05",3419,75,14,1092,463,5063
"Islington","09:00:00","2020-10-05",703,83,91,271,119,1267
"Waltham Forest","09:00:00","2020-10-05",1191,16,20,321,77,1625
"Bexley","10:00:00","2020-10-05",112,0,0,24,4,140
"Greenwich","10:00:00","2020-10-05",3255,39,10,989,473,4766
"Islington","10:00:00","2020-10-05",632,82,90,292,117,1213
"Waltham Forest","10:00:00","2020-10-05",994,9,11,296,80,1390
"Bexley","11:00:00","2020-10-05",136,2,0,23,3,164
"Greenwich","11:00:00","2020-10-05",3305,53,5,1008,465,4836
"Islington","11:00:00","2020-10-05",675,127,83,334,126,1345
"Waltham Forest","11:00:00","2020-10-05",996,17,13,294,82,1402
"Bexley","12:00:00","2020-10-05",159,0,0,25,2,186
"Greenwich","12:00:00","2020-10-05",3688,58,7,1151,471,5375
"Islington","12:00:00","2020-10-05",697,147,81,304,127,1356
"Waltham Forest","12:00:00","2020-10-05",1098,12,12,286,92,1500
"Bexley","13:00:00","2020-10-05",153,2,0,10,6,171
"Greenwich","13:00:00","2020-10-05",3739,76,13,1201,496,5525
"Islington","13:00:00","2020-10-05",745,170,80,341,98,1434
"Waltham Forest","13:00:00","2020-10-05",1203,24,14,249,69,1559
"Bexley","14:00:00","2020-10-05",195,1,0,17,2,215
"Greenwich","14:00:00","2020-10-05",4068,75,14,1250,479,5886
"Islington","14:00:00","2020-10-05",746,164,89,335,91,1425
"Waltham Forest","14:00:00","2020-10-05",1282,24,13,241,75,1635
"Bexley","15:00:00","2020-10-05",259,2,0,40,1,302
"Islington","15:00:00","2020-10-05",826,163,82,335,67,1473
"Waltham Forest","15:00:00","2020-10-05",1248,13,14,262,50,1587
"Bexley","16:00:00","2020-10-05",187,2,0,41,1,231
"Islington","16:00:00","2020-10-05",849,200,83,294,53,1479
"Waltham Forest","16:00:00","2020-10-05",1367,23,21,255,25,1691
"Bexley","17:00:00","2020-10-05",250,2,0,30,1,283
"Islington","17:00:00","2020-10-05",938,189,88,245,35,1495
"Waltham Forest","17:00:00","2020-10-05",1447,19,12,225,27,1730
"Bexley","18:00:00","2020-10-05",172,2,0,18,1,193
"Islington","18:00:00","2020-10-05",996,187,85,142,40,1450
"Waltham Forest","18:00:00","2020-10-05",1500,12,12,189,19,1732
"Hackney","07:00:00","2020-10-06",492,16,98,209,39,854
"Lewisham","07:00:00","2020-10-06",9,0,0,1,0,10
"Newham","07:00:00","2020-10-06",422,3,15,67,12,519
"Hackney","08:00:00","2020-10-06",553,25,91,168,21,858
"Lewisham","08:00:00","2020-10-06",7,0,0,3,0,10
"Newham","08:00:00","2020-10-06",642,1,12,68,7,730
"Hackney","09:00:00","2020-10-06",576,19,104,162,40,901
"Lewisham","09:00:00","2020-10-06",9,1,0,5,1,16
"Newham","09:00:00","2020-10-06",420,2,16,64,18,520
"Hackney","10:00:00","2020-10-06",469,18,99,195,31,812
"Lewisham","10:00:00","2020-10-06",10,1,0,6,2,19
"Newham","10:00:00","2020-10-06",317,3,13,73,8,414
"Hackney","11:00:00","2020-10-06",428,24,97,152,37,738
"Lewisham","11:00:00","2020-10-06",15,0,0,6,0,21
"Newham","11:00:00","2020-10-06",323,5,11,80,8,427
"Hackney","12:00:00","2020-10-06",504,36,97,189,38,864
"Lewisham","12:00:00","2020-10-06",7,0,0,5,1,13
"Newham","12:00:00","2020-10-06",403,4,14,67,17,505
"Hackney","13:00:00","2020-10-06",468,41,90,165,30,794
"Lewisham","13:00:00","2020-10-06",8,2,0,6,0,16
"Newham","13:00:00","2020-10-06",462,6,10,61,6,545
"Hackney","14:00:00","2020-10-06",540,37,95,151,22,845
"Lewisham","14:00:00","2020-10-06",10,0,0,2,0,12
"Newham","14:00:00","2020-10-06",528,7,14,65,11,625
"Hackney","15:00:00","2020-10-06",400,39,80,113,16,648
"Lewisham","15:00:00","2020-10-06",10,0,0,0,1,11
"Newham","15:00:00","2020-10-06",598,8,14,70,14,704
"Hackney","16:00:00","2020-10-06",328,27,68,90,11,524
"Lewisham","16:00:00","2020-10-06",7,1,0,4,0,12
"Newham","16:00:00","2020-10-06",630,8,14,120,15,787
"Hackney","17:00:00","2020-10-06",570,56,79,124,16,845
"Lewisham","17:00:00","2020-10-06",16,0,0,4,0,20
"Newham","17:00:00","2020-10-06",752,13,13,139,14,931
"Hackney","18:00:00","2020-10-06",623,43,87,94,17,864
"Lewisham","18:00:00","2020-10-06",12,1,0,1,0,14
"Newham","18:00:00","2020-10-06",707,18,14,79,12,830
"Bromley","07:00:00","2020-10-07",219,0,11,53,5,288
"Haringey","07:00:00","2020-10-07",1169,42,62,440,115,1828
"Southwark","07:00:00","2020-10-07",7,0,0,2,2,11
"Bromley","08:00:00","2020-10-07",348,2,10,62,9,431
"Haringey","08:00:00","2020-10-07",1254,44,42,436,127,1903
"Southwark","08:00:00","2020-10-07",34,2,1,6,2,45
"Bromley","09:00:00","2020-10-07",177,2,10,35,13,237
"Haringey","09:00:00","2020-10-07",1173,49,43,375,136,1776
"Southwark","09:00:00","2020-10-07",21,0,1,10,3,35
"Bromley","10:00:00","2020-10-07",140,1,13,45,12,211
"Haringey","10:00:00","2020-10-07",1079,41,44,355,140,1659
"Southwark","10:00:00","2020-10-07",16,0,0,7,4,27
"Bromley","11:00:00","2020-10-07",147,0,10,41,2,200
"Haringey","11:00:00","2020-10-07",1141,46,39,402,132,1760
"Southwark","11:00:00","2020-10-07",21,2,0,11,3,37
"Bromley","12:00:00","2020-10-07",196,3,10,38,4,251
"Haringey","12:00:00","2020-10-07",1243,80,40,362,143,1868
"Southwark","12:00:00","2020-10-07",18,2,0,15,6,41
"Bromley","13:00:00","2020-10-07",177,3,11,41,2,234
"Haringey","13:00:00","2020-10-07",1367,70,44,389,126,1996
"Southwark","13:00:00","2020-10-07",31,5,0,12,7,55
"Bromley","14:00:00","2020-10-07",249,1,9,30,3,292
"Haringey","14:00:00","2020-10-07",1480,68,48,392,133,2121
"Southwark","14:00:00","2020-10-07",31,5,0,10,2,48
"Bromley","15:00:00","2020-10-07",258,5,10,64,4,341
"Southwark","15:00:00","2020-10-07",36,4,1,2,2,45
"Bromley","16:00:00","2020-10-07",238,1,12,63,9,323
"Southwark","16:00:00","2020-10-07",34,3,1,5,1,44
"Bromley","17:00:00","2020-10-07",235,3,10,30,0,278
"Southwark","17:00:00","2020-10-07",35,2,0,2,0,39
"Bromley","18:00:00","2020-10-07",213,1,12,21,3,250
"Southwark","18:00:00","2020-10-07",29,5,0,8,0,42
"Barnet","07:00:00","2020-10-08",480,7,2,106,4,599
"Croydon","07:00:00","2020-10-08",114,4,0,11,2,131
"Ealing","07:00:00","2020-10-08",432,7,1,114,27,581
"Enfield","07:00:00","2020-10-08",177,2,13,35,4,231
"Kingston upon Thames","07:00:00","2020-10-08",163,2,0,48,3,216
"Richmond upon Thames","07:00:00","2020-10-08",194,8,13,39,5,259
"Wandsworth","07:00:00","2020-10-08",161,3,0,37,4,205
"Barnet","08:00:00","2020-10-08",828,7,6,59,7,907
"Croydon","08:00:00","2020-10-08",231,4,0,17,1,253
"Ealing","08:00:00","2020-10-08",447,9,0,73,13,542
"Enfield","08:00:00","2020-10-08",419,5,11,62,4,501
"Kingston upon Thames","08:00:00","2020-10-08",230,0,0,31,4,265
"Richmond upon Thames","08:00:00","2020-10-08",310,2,13,32,3,360
"Wandsworth","08:00:00","2020-10-08",213,3,0,24,4,244
"Barnet","09:00:00","2020-10-08",507,5,2,74,11,599
"Croydon","09:00:00","2020-10-08",65,0,0,15,0,80
"Ealing","09:00:00","2020-10-08",336,5,0,90,20,451
"Enfield","09:00:00","2020-10-08",233,0,16,35,4,288
"Kingston upon Thames","09:00:00","2020-10-08",114,1,0,14,1,130
"Richmond upon Thames","09:00:00","2020-10-08",179,4,11,38,11,243
"Wandsworth","09:00:00","2020-10-08",118,0,0,34,4,156
"Barnet","10:00:00","2020-10-08",434,2,1,83,17,537
"Croydon","10:00:00","2020-10-08",39,1,0,16,2,58
"Ealing","10:00:00","2020-10-08",283,14,1,75,16,389
"Enfield","10:00:00","2020-10-08",195,6,12,22,6,241
"Kingston upon Thames","10:00:00","2020-10-08",82,3,0,18,2,105
"Richmond upon Thames","10:00:00","2020-10-08",153,4,15,37,9,218
"Wandsworth","10:00:00","2020-10-08",76,2,0,27,1,106
"Barnet","11:00:00","2020-10-08",502,4,0,82,11,599
"Croydon","11:00:00","2020-10-08",41,0,0,6,1,48
"Ealing","11:00:00","2020-10-08",323,6,1,66,18,414
"Enfield","11:00:00","2020-10-08",178,9,11,22,8,228
"Kingston upon Thames","11:00:00","2020-10-08",70,3,0,21,1,95
"Richmond upon Thames","11:00:00","2020-10-08",153,7,12,36,3,211
"Wandsworth","11:00:00","2020-10-08",60,1,0,19,2,82
"Barnet","12:00:00","2020-10-08",496,8,0,71,16,591
"Croydon","12:00:00","2020-10-08",40,1,0,13,0,54
"Ealing","12:00:00","2020-10-08",335,9,0,62,13,419
"Enfield","12:00:00","2020-10-08",178,12,12,36,5,243
"Kingston upon Thames","12:00:00","2020-10-08",90,3,0,22,1,116
"Richmond upon Thames","12:00:00","2020-10-08",186,5,12,42,4,249
"Wandsworth","12:00:00","2020-10-08",55,5,0,15,1,76
"Barnet","13:00:00","2020-10-08",516,11,4,92,13,636
"Croydon","13:00:00","2020-10-08",37,1,0,9,1,48
"Ealing","13:00:00","2020-10-08",370,7,1,98,22,498
"Enfield","13:00:00","2020-10-08",204,11,12,42,4,273
"Kingston upon Thames","13:00:00","2020-10-08",95,3,0,13,0,111
"Richmond upon Thames","13:00:00","2020-10-08",195,9,13,30,11,258
"Wandsworth","13:00:00","2020-10-08",53,7,0,11,1,72
"Barnet","14:00:00","2020-10-08",606,4,2,83,11,706
"Croydon","14:00:00","2020-10-08",83,2,0,8,1,94
"Ealing","14:00:00","2020-10-08",425,6,2,78,17,528
"Enfield","14:00:00","2020-10-08",249,13,11,28,3,304
"Kingston upon Thames","14:00:00","2020-10-08",141,2,0,20,2,165
"Richmond upon Thames","14:00:00","2020-10-08",240,4,11,32,7,294
"Wandsworth","14:00:00","2020-10-08",57,10,0,15,2,84
"Barnet","15:00:00","2020-10-08",859,9,8,79,5,960
"Croydon","15:00:00","2020-10-08",115,0,0,11,0,126
"Ealing","15:00:00","2020-10-08",465,4,0,65,17,551
"Enfield","15:00:00","2020-10-08",370,13,15,48,8,454
"Kingston upon Thames","15:00:00","2020-10-08",143,3,0,23,1,170
"Richmond upon Thames","15:00:00","2020-10-08",323,7,16,36,8,390
"Wandsworth","15:00:00","2020-10-08",104,3,0,13,5,125
"Barnet","16:00:00","2020-10-08",752,3,2,107,5,869
"Croydon","16:00:00","2020-10-08",115,3,0,23,2,143
"Ealing","16:00:00","2020-10-08",537,11,0,77,11,636
"Enfield","16:00:00","2020-10-08",307,11,15,56,4,393
"Kingston upon Thames","16:00:00","2020-10-08",124,3,0,24,0,151
"Richmond upon Thames","16:00:00","2020-10-08",244,5,12,30,5,296
"Wandsworth","16:00:00","2020-10-08",85,3,0,8,0,96
"Barnet","17:00:00","2020-10-08",761,12,1,64,4,842
"Croydon","17:00:00","2020-10-08",103,0,0,15,2,120
"Ealing","17:00:00","2020-10-08",555,10,1,77,5,648
"Enfield","17:00:00","2020-10-08",304,15,11,44,4,378
"Kingston upon Thames","17:00:00","2020-10-08",140,7,0,23,0,170
"Richmond upon Thames","17:00:00","2020-10-08",231,15,13,21,2,282
"Wandsworth","17:00:00","2020-10-08",88,5,0,6,6,105
"Barnet","18:00:00","2020-10-08",792,16,0,58,2,868
"Croydon","18:00:00","2020-10-08",73,4,0,7,0,84
"Ealing","18:00:00","2020-10-08",493,8,0,37,3,541
"Enfield","18:00:00","2020-10-08",270,7,12,27,0,316
"Kingston upon Thames","18:00:00","2020-10-08",136,8,0,22,0,166
"Richmond upon Thames","18:00:00","2020-10-08",196,13,11,11,1,232
"Wandsworth","18:00:00","2020-10-08",82,8,0,3,0,93
"Barking and Dagenham","07:00:00","2020-10-09",28,1,0,9,0,38
"Croydon","07:00:00","2020-10-09",585,12,12,135,14,758
"Hillingdon","07:00:00","2020-10-09",155,4,2,26,0,187
"Barking and Dagenham","08:00:00","2020-10-09",55,0,0,3,1,59
"Croydon","08:00:00","2020-10-09",792,14,10,107,12,935
"Hillingdon","08:00:00","2020-10-09",433,2,3,36,1,475
"Barking and Dagenham","09:00:00","2020-10-09",31,3,0,1,1,36
"Croydon","09:00:00","2020-10-09",548,9,10,138,25,730
"Hillingdon","09:00:00","2020-10-09",164,1,2,21,4,192
"Barking and Dagenham","10:00:00","2020-10-09",20,0,0,2,1,23
"Croydon","10:00:00","2020-10-09",501,12,10,120,13,656
"Hillingdon","10:00:00","2020-10-09",174,0,2,19,1,196
"Barking and Dagenham","11:00:00","2020-10-09",30,0,0,1,1,32
"Croydon","11:00:00","2020-10-09",519,18,12,115,19,683
"Hillingdon","11:00:00","2020-10-09",162,1,2,27,4,196
"Barking and Dagenham","12:00:00","2020-10-09",41,0,0,5,0,46
"Croydon","12:00:00","2020-10-09",594,36,12,107,13,762
"Hillingdon","12:00:00","2020-10-09",174,4,2,13,2,195
"Barking and Dagenham","13:00:00","2020-10-09",21,1,0,5,1,28
"Croydon","13:00:00","2020-10-09",633,35,9,129,20,826
"Hillingdon","13:00:00","2020-10-09",165,2,2,24,1,194
"Barking and Dagenham","14:00:00","2020-10-09",44,2,0,2,0,48
"Croydon","14:00:00","2020-10-09",694,18,7,119,15,853
"Hillingdon","14:00:00","2020-10-09",230,4,2,28,5,269
"Barking and Dagenham","15:00:00","2020-10-09",41,0,0,7,1,49
"Croydon","15:00:00","2020-10-09",719,25,11,131,16,902
"Hillingdon","15:00:00","2020-10-09",442,0,2,47,9,500
"Barking and Dagenham","16:00:00","2020-10-09",43,2,0,4,0,49
"Croydon","16:00:00","2020-10-09",728,27,11,115,7,888
"Hillingdon","16:00:00","2020-10-09",380,1,2,65,7,455
"Barking and Dagenham","17:00:00","2020-10-09",60,0,0,8,1,69
"Croydon","17:00:00","2020-10-09",792,21,11,119,4,947
"Hillingdon","17:00:00","2020-10-09",356,2,2,58,5,423
"Barking and Dagenham","18:00:00","2020-10-09",42,1,0,4,0,47
"Croydon","18:00:00","2020-10-09",796,42,10,94,11,953
"Hillingdon","18:00:00","2020-10-09",366,0,2,39,3,410
"Sutton","09:00:00","2020-10-12",1639,36,21,412,92,2200
"Sutton","10:00:00","2020-10-12",1370,35,20,379,84,1888
"Sutton","11:00:00","2020-10-12",1429,30,18,374,92,1943
"Sutton","12:00:00","2020-10-12",1310,36,20,344,94,1804
"Sutton","13:00:00","2020-10-12",1556,40,20,363,62,2041
"Sutton","14:00:00","2020-10-12",1728,38,17,380,89,2252
"Sutton","18:00:00","2020-10-12",1758,40,20,347,30,2195
"Enfield","07:00:00","2020-10-15",305,2,17,71,14,409
"Enfield","08:00:00","2020-10-15",531,5,10,66,17,629
"Enfield","09:00:00","2020-10-15",310,10,10,71,21,422
"Enfield","10:00:00","2020-10-15",209,21,15,93,24,362
"Enfield","11:00:00","2020-10-15",255,13,13,61,17,359
"Enfield","12:00:00","2020-10-15",258,18,13,57,23,369
"Enfield","13:00:00","2020-10-15",253,20,10,75,18,376
"Enfield","14:00:00","2020-10-15",365,7,16,88,10,486
"Enfield","15:00:00","2020-10-15",470,5,11,59,8,553
"Enfield","16:00:00","2020-10-15",406,9,11,65,12,503
"Enfield","17:00:00","2020-10-15",389,12,11,50,17,479
"Enfield","18:00:00","2020-10-15",340,11,14,33,12,410
"City of London","07:00:00","2020-10-16",233,21,26,136,39,455
"Ealing","07:00:00","2020-10-16",391,7,1,136,14,549
"City of London","08:00:00","2020-10-16",219,27,30,104,50,430
"Ealing","08:00:00","2020-10-16",510,4,1,97,30,642
"City of London","09:00:00","2020-10-16",203,35,31,128,66,463
"Ealing","09:00:00","2020-10-16",432,10,1,111,24,578
"City of London","10:00:00","2020-10-16",241,38,27,159,58,523
"Ealing","10:00:00","2020-10-16",376,11,3,118,39,547
"City of London","11:00:00","2020-10-16",254,30,28,144,38,494
"Ealing","11:00:00","2020-10-16",417,9,5,115,29,575
"City of London","12:00:00","2020-10-16",268,34,28,124,34,488
"Ealing","12:00:00","2020-10-16",478,17,1,113,20,629
"City of London","13:00:00","2020-10-16",256,52,29,122,26,485
"Ealing","13:00:00","2020-10-16",539,20,9,101,18,687
"City of London","14:00:00","2020-10-16",247,38,24,133,24,466
"Ealing","14:00:00","2020-10-16",547,16,1,90,19,673
"City of London","15:00:00","2020-10-16",339,49,25,84,7,504
"Ealing","15:00:00","2020-10-16",502,15,0,110,17,644
"City of London","16:00:00","2020-10-16",286,40,25,76,16,443
"Ealing","16:00:00","2020-10-16",513,17,5,106,10,651
"City of London","17:00:00","2020-10-16",357,56,31,29,6,479
"Ealing","17:00:00","2020-10-16",573,27,3,89,15,707
"City of London","18:00:00","2020-10-16",410,45,24,30,9,518
"Ealing","18:00:00","2020-10-16",522,24,1,53,7,607
"Havering","07:00:00","2020-11-02",699,4,27,139,10,879
"Havering","08:00:00","2020-11-02",932,6,30,116,14,1098
"Havering","09:00:00","2020-11-02",795,3,31,116,21,966
"Havering","10:00:00","2020-11-02",753,5,25,107,19,909
"Havering","11:00:00","2020-11-02",752,9,24,101,17,903
"Havering","12:00:00","2020-11-02",787,4,25,104,8,928
"Havering","13:00:00","2020-11-02",900,9,25,114,12,1060
"Havering","14:00:00","2020-11-02",840,8,25,112,5,990
"Havering","15:00:00","2020-11-02",921,8,34,82,10,1055
"Havering","16:00:00","2020-11-02",754,11,31,109,9,914
"Havering","17:00:00","2020-11-02",783,6,24,84,6,903
"Havering","18:00:00","2020-11-02",714,3,21,62,2,802
"Barking and Dagenham","07:00:00","2021-03-19",1177,11,22,282,74,1566
"Bromley","07:00:00","2021-03-19",272,3,37,128,14,454
"Croydon","07:00:00","2021-03-19",995,10,11,294,45,1355
"Barking and Dagenham","08:00:00","2021-03-19",1317,8,18,231,75,1649
"Bromley","08:00:00","2021-03-19",443,4,43,122,12,624
"Croydon","08:00:00","2021-03-19",1168,15,4,223,46,1456
"Barking and Dagenham","09:00:00","2021-03-19",1102,18,16,289,82,1507
"Bromley","09:00:00","2021-03-19",366,7,38,83,16,510
"Croydon","09:00:00","2021-03-19",914,13,7,257,68,1259
"Barking and Dagenham","10:00:00","2021-03-19",1064,17,16,223,79,1399
"Bromley","10:00:00","2021-03-19",349,8,41,76,16,490
"Croydon","10:00:00","2021-03-19",657,15,3,196,61,932
"Barking and Dagenham","11:00:00","2021-03-19",1087,13,13,254,64,1431
"Bromley","11:00:00","2021-03-19",361,13,40,75,12,501
"Croydon","11:00:00","2021-03-19",824,27,1,205,49,1106
"Barking and Dagenham","12:00:00","2021-03-19",1127,16,10,230,58,1441
"Bromley","12:00:00","2021-03-19",398,18,37,85,8,546
"Croydon","12:00:00","2021-03-19",829,32,0,202,62,1125
"Barking and Dagenham","13:00:00","2021-03-19",1244,26,11,266,65,1612
"Bromley","13:00:00","2021-03-19",408,18,35,79,5,545
"Croydon","13:00:00","2021-03-19",943,39,1,221,53,1257
"Barking and Dagenham","14:00:00","2021-03-19",1393,29,18,221,68,1729
"Bromley","14:00:00","2021-03-19",403,11,39,86,13,552
"Croydon","14:00:00","2021-03-19",1049,39,9,232,51,1380
"Barking and Dagenham","15:00:00","2021-03-19",1337,15,21,172,41,1586
"Bromley","15:00:00","2021-03-19",366,10,33,70,4,483
"Croydon","15:00:00","2021-03-19",1193,22,4,184,35,1438
"Barking and Dagenham","16:00:00","2021-03-19",1412,24,15,200,37,1688
"Bromley","16:00:00","2021-03-19",416,10,45,66,5,542
"Croydon","16:00:00","2021-03-19",1186,25,7,204,24,1446
"Barking and Dagenham","17:00:00","2021-03-19",1356,33,13,168,32,1602
"Bromley","17:00:00","2021-03-19",444,14,42,58,4,562
"Croydon","17:00:00","2021-03-19",1220,50,1,161,21,1453
"Barking and Dagenham","18:00:00","2021-03-19",1274,35,12,142,13,1476
"Bromley","18:00:00","2021-03-19",430,19,37,39,6,531
"Croydon","18:00:00","2021-03-19",1058,50,0,136,16,1260
"Lambeth","07:00:00","2021-03-24",709,51,55,243,61,1119
"Lambeth","08:00:00","2021-03-24",744,43,57,157,52,1053
"Lambeth","09:00:00","2021-03-24",560,49,56,216,61,942
"Lambeth","10:00:00","2021-03-24",561,60,57,226,75,979
"Lambeth","11:00:00","2021-03-24",536,65,54,227,74,956
"Lambeth","12:00:00","2021-03-24",529,109,51,223,58,970
"Lambeth","13:00:00","2021-03-24",624,80,54,206,48,1012
"Lambeth","14:00:00","2021-03-24",666,66,58,210,54,1054
"Lambeth","15:00:00","2021-03-24",674,82,48,200,49,1053
"Lambeth","16:00:00","2021-03-24",699,79,60,199,20,1057
"Lambeth","17:00:00","2021-03-24",690,113,56,158,24,1041
"Lambeth","18:00:00","2021-03-24",783,149,51,101,7,1091
"Hillingdon","07:00:00","2021-03-25",1153,6,22,230,45,1456
"Hillingdon","08:00:00","2021-03-25",1641,2,23,172,34,1872
"Hillingdon","09:00:00","2021-03-25",982,6,20,173,40,1221
"Hillingdon","10:00:00","2021-03-25",915,4,14,184,47,1164
"Hillingdon","11:00:00","2021-03-25",992,8,17,186,43,1246
"Hillingdon","12:00:00","2021-03-25",1056,7,18,147,44,1272
"Hillingdon","13:00:00","2021-03-25",999,17,20,155,38,1229
"Hillingdon","14:00:00","2021-03-25",1150,7,19,166,31,1373
"Hillingdon","15:00:00","2021-03-25",1469,10,17,190,22,1708
"Hillingdon","16:00:00","2021-03-25",1371,9,22,159,20,1581
"Hillingdon","17:00:00","2021-03-25",1268,8,20,121,16,1433
"Hillingdon","18:00:00","2021-03-25",1036,15,20,129,7,1207
"Bromley","07:00:00","2021-03-26",655,16,45,178,28,922
"Bromley","08:00:00","2021-03-26",815,17,38,134,25,1029
"Bromley","09:00:00","2021-03-26",735,16,41,161,39,992
"Bromley","10:00:00","2021-03-26",625,31,45,168,38,907
"Bromley","11:00:00","2021-03-26",696,27,43,155,34,955
"Bromley","12:00:00","2021-03-26",763,53,40,186,36,1078
"Bromley","13:00:00","2021-03-26",841,52,38,181,39,1151
"Bromley","14:00:00","2021-03-26",853,67,40,144,22,1126
"Bromley","15:00:00","2021-03-26",843,32,44,161,16,1096
"Bromley","16:00:00","2021-03-26",958,57,48,169,24,1256
"Bromley","17:00:00","2021-03-26",986,72,40,116,9,1223
"Bromley","18:00:00","2021-03-26",857,73,44,83,9,1066
"Barnet","07:00:00","2021-03-29",2962,58,23,1140,293,4476
"Harrow","07:00:00","2021-03-29",1102,14,15,273,36,1440
"Barnet","08:00:00","2021-03-29",2830,29,24,834,263,3980
"Harrow","08:00:00","2021-03-29",1229,13,16,212,45,1515
"Barnet","09:00:00","2021-03-29",2263,30,20,776,264,3353
"Harrow","09:00:00","2021-03-29",921,11,10,197,60,1199
"Barnet","10:00:00","2021-03-29",2193,33,18,732,282,3258
"Harrow","10:00:00","2021-03-29",818,16,11,257,62,1164
"Barnet","11:00:00","2021-03-29",2315,30,15,659,292,3311
"Harrow","11:00:00","2021-03-29",955,11,11,236,67,1280
"Barnet","12:00:00","2021-03-29",2543,32,14,717,291,3597
"Harrow","12:00:00","2021-03-29",1027,23,9,208,56,1323
"Barnet","13:00:00","2021-03-29",2516,41,14,787,268,3626
"Harrow","13:00:00","2021-03-29",1071,22,10,248,50,1401
"Barnet","14:00:00","2021-03-29",2788,45,20,888,278,4019
"Harrow","14:00:00","2021-03-29",1288,29,14,189,49,1569
"Barnet","15:00:00","2021-03-29",2773,40,22,1022,276,4133
"Harrow","15:00:00","2021-03-29",1330,29,10,176,40,1585
"Barnet","16:00:00","2021-03-29",3286,58,26,1128,185,4683
"Harrow","16:00:00","2021-03-29",1221,28,8,237,31,1525
"Barnet","17:00:00","2021-03-29",3712,74,17,989,134,4926
"Harrow","17:00:00","2021-03-29",1378,20,9,257,20,1684
"Barnet","18:00:00","2021-03-29",3452,51,16,625,89,4233
"Harrow","18:00:00","2021-03-29",1244,28,11,209,15,1507
"Ealing","07:00:00","2021-04-20",3049,205,49,1083,341,4727
"Hammersmith and Fulham","07:00:00","2021-04-20",2188,166,9,868,199,3430
"Harrow","07:00:00","2021-04-20",515,3,11,67,24,620
"Kingston upon Thames","07:00:00","2021-04-20",945,21,30,225,36,1257
"Lewisham","07:00:00","2021-04-20",662,106,77,335,53,1233
"Merton","07:00:00","2021-04-20",346,15,16,107,22,506
"Redbridge","07:00:00","2021-04-20",917,22,4,243,34,1220
"Wandsworth","07:00:00","2021-04-20",1315,160,157,485,67,2184
"Ealing","08:00:00","2021-04-20",2904,137,33,967,401,4442
"Hammersmith and Fulham","08:00:00","2021-04-20",2178,144,9,741,204,3276
"Harrow","08:00:00","2021-04-20",825,5,6,63,19,918
"Kingston upon Thames","08:00:00","2021-04-20",1119,17,32,220,37,1425
"Lewisham","08:00:00","2021-04-20",718,60,57,215,60,1110
"Merton","08:00:00","2021-04-20",344,7,18,69,34,472
"Redbridge","08:00:00","2021-04-20",880,13,5,159,24,1081
"Wandsworth","08:00:00","2021-04-20",1413,176,178,358,62,2187
"Ealing","09:00:00","2021-04-20",2773,118,44,944,470,4349
"Hammersmith and Fulham","09:00:00","2021-04-20",2060,108,13,743,227,3151
"Harrow","09:00:00","2021-04-20",558,4,4,71,30,667
"Kingston upon Thames","09:00:00","2021-04-20",963,16,19,227,39,1264
"Lewisham","09:00:00","2021-04-20",758,51,60,229,64,1162
"Merton","09:00:00","2021-04-20",281,7,25,93,31,437
"Redbridge","09:00:00","2021-04-20",874,9,2,186,30,1101
"Wandsworth","09:00:00","2021-04-20",1332,146,171,384,79,2112
"Ealing","10:00:00","2021-04-20",2852,94,32,1017,508,4503
"Hammersmith and Fulham","10:00:00","2021-04-20",2096,81,11,856,242,3286
"Harrow","10:00:00","2021-04-20",426,7,1,71,33,538
"Kingston upon Thames","10:00:00","2021-04-20",808,22,22,216,48,1116
"Lewisham","10:00:00","2021-04-20",795,43,69,255,94,1256
"Merton","10:00:00","2021-04-20",257,5,20,96,38,416
"Redbridge","10:00:00","2021-04-20",993,19,4,210,49,1275
"Wandsworth","10:00:00","2021-04-20",1305,144,168,456,76,2149
"Ealing","11:00:00","2021-04-20",2881,83,35,1056,507,4562
"Hammersmith and Fulham","11:00:00","2021-04-20",1990,85,10,763,262,3110
"Harrow","11:00:00","2021-04-20",476,10,1,74,45,606
"Kingston upon Thames","11:00:00","2021-04-20",841,32,21,213,47,1154
"Lewisham","11:00:00","2021-04-20",709,48,67,227,72,1123
"Merton","11:00:00","2021-04-20",262,2,22,83,42,411
"Redbridge","11:00:00","2021-04-20",978,20,4,206,46,1254
"Wandsworth","11:00:00","2021-04-20",1284,120,158,358,82,2002
"Ealing","12:00:00","2021-04-20",2649,120,37,1062,486,4354
"Hammersmith and Fulham","12:00:00","2021-04-20",2116,119,10,752,249,3246
"Harrow","12:00:00","2021-04-20",531,12,0,74,27,644
"Kingston upon Thames","12:00:00","2021-04-20",878,44,21,198,35,1176
"Lewisham","12:00:00","2021-04-20",789,56,59,221,82,1207
"Merton","12:00:00","2021-04-20",287,13,17,102,29,448
"Redbridge","12:00:00","2021-04-20",1061,22,4,224,33,1344
"Wandsworth","12:00:00","2021-04-20",1263,159,162,355,70,2009
"Ealing","13:00:00","2021-04-20",3128,117,32,1024,491,4792
"Hammersmith and Fulham","13:00:00","2021-04-20",2239,135,9,739,197,3319
"Harrow","13:00:00","2021-04-20",503,13,0,82,25,623
"Kingston upon Thames","13:00:00","2021-04-20",910,53,19,168,28,1178
"Lewisham","13:00:00","2021-04-20",751,68,62,244,71,1196
"Merton","13:00:00","2021-04-20",255,11,22,73,23,384
"Redbridge","13:00:00","2021-04-20",1170,26,6,221,35,1458
"Wandsworth","13:00:00","2021-04-20",1294,156,166,363,59,2038
"Ealing","14:00:00","2021-04-20",3251,102,45,1040,512,4950
"Hammersmith and Fulham","14:00:00","2021-04-20",2406,120,12,773,204,3515
"Harrow","14:00:00","2021-04-20",567,2,6,70,25,670
"Kingston upon Thames","14:00:00","2021-04-20",949,28,22,177,43,1219
"Lewisham","14:00:00","2021-04-20",764,59,63,239,47,1172
"Merton","14:00:00","2021-04-20",294,13,21,79,42,449
"Redbridge","14:00:00","2021-04-20",1190,30,9,213,30,1472
"Wandsworth","14:00:00","2021-04-20",1210,163,165,387,55,1980
"Ealing","15:00:00","2021-04-20",3581,119,30,1099,363,5192
"Hammersmith and Fulham","15:00:00","2021-04-20",2667,125,9,751,172,3724
"Harrow","15:00:00","2021-04-20",764,4,8,60,21,857
"Kingston upon Thames","15:00:00","2021-04-20",969,37,26,167,31,1230
"Lewisham","15:00:00","2021-04-20",727,70,60,218,44,1119
"Merton","15:00:00","2021-04-20",321,10,21,65,39,456
"Redbridge","15:00:00","2021-04-20",1334,29,2,199,24,1588
"Wandsworth","15:00:00","2021-04-20",1456,149,157,331,38,2131
"Ealing","16:00:00","2021-04-20",3756,201,45,1072,269,5343
"Hammersmith and Fulham","16:00:00","2021-04-20",2802,168,19,725,108,3822
"Harrow","16:00:00","2021-04-20",642,9,8,66,18,743
"Kingston upon Thames","16:00:00","2021-04-20",1079,52,26,192,11,1360
"Lewisham","16:00:00","2021-04-20",689,109,77,191,24,1090
"Merton","16:00:00","2021-04-20",351,17,18,80,26,492
"Redbridge","16:00:00","2021-04-20",1155,28,8,216,23,1430
"Wandsworth","16:00:00","2021-04-20",1501,194,167,335,21,2218
"Ealing","17:00:00","2021-04-20",4041,258,40,925,141,5405
"Hammersmith and Fulham","17:00:00","2021-04-20",3058,218,13,627,67,3983
"Harrow","17:00:00","2021-04-20",618,10,3,62,7,700
"Kingston upon Thames","17:00:00","2021-04-20",1156,36,23,137,14,1366
"Lewisham","17:00:00","2021-04-20",591,128,58,114,22,913
"Merton","17:00:00","2021-04-20",397,17,20,70,14,518
"Redbridge","17:00:00","2021-04-20",1216,43,3,187,14,1463
"Wandsworth","17:00:00","2021-04-20",1527,266,159,275,18,2245
"Ealing","18:00:00","2021-04-20",4306,175,31,637,112,5261
"Hammersmith and Fulham","18:00:00","2021-04-20",3117,173,12,444,57,3803
"Harrow","18:00:00","2021-04-20",533,20,1,49,4,607
"Kingston upon Thames","18:00:00","2021-04-20",1103,48,23,82,12,1268
"Lewisham","18:00:00","2021-04-20",690,131,65,96,29,1011
"Merton","18:00:00","2021-04-20",427,15,21,74,14,551
"Redbridge","18:00:00","2021-04-20",1310,32,2,151,13,1508
"Wandsworth","18:00:00","2021-04-20",1575,303,143,208,22,2251
"Tower Hamlets","07:00:00","2021-04-21",3430,319,16,1528,382,5675
"Tower Hamlets","08:00:00","2021-04-21",3398,197,6,1220,402,5223
"Tower Hamlets","09:00:00","2021-04-21",3430,163,10,1234,475,5312
"Waltham Forest","09:00:00","2021-04-21",5025,59,24,1657,650,7415
"Tower Hamlets","10:00:00","2021-04-21",2827,193,19,1105,483,4627
"Waltham Forest","10:00:00","2021-04-21",4751,53,24,1672,744,7244
"Tower Hamlets","11:00:00","2021-04-21",2790,234,14,1079,442,4559
"Tower Hamlets","12:00:00","2021-04-21",3054,336,19,1069,444,4922
"Tower Hamlets","13:00:00","2021-04-21",3240,343,9,1141,410,5143
"Tower Hamlets","14:00:00","2021-04-21",3530,295,9,1257,408,5499
"Tower Hamlets","15:00:00","2021-04-21",3875,252,6,1312,355,5800
"Tower Hamlets","16:00:00","2021-04-21",4601,380,6,1445,266,6698
"Tower Hamlets","17:00:00","2021-04-21",5137,502,3,1175,195,7012
"Tower Hamlets","18:00:00","2021-04-21",5454,493,8,766,119,6840
"Hammersmith and Fulham","07:00:00","2021-04-22",827,85,68,280,60,1320
"Merton","07:00:00","2021-04-22",2329,115,203,741,145,3533
"Waltham Forest","07:00:00","2021-04-22",797,22,8,279,44,1150
"Hammersmith and Fulham","08:00:00","2021-04-22",761,67,66,190,58,1142
"Merton","08:00:00","2021-04-22",2354,82,171,532,126,3265
"Waltham Forest","08:00:00","2021-04-22",787,13,2,207,63,1072
"Hammersmith and Fulham","09:00:00","2021-04-22",710,53,71,207,73,1114
"Merton","09:00:00","2021-04-22",2449,75,192,543,174,3433
"Waltham Forest","09:00:00","2021-04-22",862,18,7,249,56,1192
"Hammersmith and Fulham","10:00:00","2021-04-22",728,50,63,229,87,1157
"Merton","10:00:00","2021-04-22",2261,75,190,621,178,3325
"Waltham Forest","10:00:00","2021-04-22",772,8,2,268,68,1118
"Hammersmith and Fulham","11:00:00","2021-04-22",771,48,56,230,65,1170
"Merton","11:00:00","2021-04-22",2308,87,175,575,159,3304
"Waltham Forest","11:00:00","2021-04-22",843,14,4,245,57,1163
"Hammersmith and Fulham","12:00:00","2021-04-22",763,62,60,214,70,1169
"Merton","12:00:00","2021-04-22",2336,113,185,563,174,3371
"Waltham Forest","12:00:00","2021-04-22",908,16,2,207,56,1189
"Hammersmith and Fulham","13:00:00","2021-04-22",758,95,58,198,68,1177
"Merton","13:00:00","2021-04-22",2534,143,173,572,173,3595
"Waltham Forest","13:00:00","2021-04-22",951,25,2,214,53,1245
"Hammersmith and Fulham","14:00:00","2021-04-22",783,93,58,199,42,1175
"Merton","14:00:00","2021-04-22",2627,134,185,582,145,3673
"Waltham Forest","14:00:00","2021-04-22",971,26,2,239,59,1297
"Hammersmith and Fulham","15:00:00","2021-04-22",833,73,61,188,35,1190
"Merton","15:00:00","2021-04-22",2546,115,171,501,125,3458
"Waltham Forest","15:00:00","2021-04-22",1115,20,3,265,65,1468
"Hammersmith and Fulham","16:00:00","2021-04-22",835,93,66,173,22,1189
"Merton","16:00:00","2021-04-22",2666,125,175,591,117,3674
"Waltham Forest","16:00:00","2021-04-22",1120,31,4,257,32,1444
"Hammersmith and Fulham","17:00:00","2021-04-22",902,94,66,152,23,1237
"Merton","17:00:00","2021-04-22",2864,159,171,472,77,3743
"Waltham Forest","17:00:00","2021-04-22",1133,31,1,212,21,1398
"Hammersmith and Fulham","18:00:00","2021-04-22",943,108,64,104,17,1236
"Merton","18:00:00","2021-04-22",2927,168,180,371,68,3714
"Waltham Forest","18:00:00","2021-04-22",1126,25,0,167,20,1338
"Barking and Dagenham","07:00:00","2021-04-23",848,12,29,230,57,1176
"Barnet","07:00:00","2021-04-23",2530,93,55,816,231,3725
"Enfield","07:00:00","2021-04-23",5043,118,48,2005,500,7714
"Greenwich","07:00:00","2021-04-23",351,9,32,137,98,627
"Harrow","07:00:00","2021-04-23",855,14,8,153,23,1053
"Havering","07:00:00","2021-04-23",2415,46,42,786,145,3434
"Hounslow","07:00:00","2021-04-23",443,17,50,101,19,630
"Kingston upon Thames","07:00:00","2021-04-23",3553,134,28,1232,183,5130
"Southwark","07:00:00","2021-04-23",675,185,230,361,121,1572
"Barking and Dagenham","08:00:00","2021-04-23",729,5,30,143,48,955
"Barnet","08:00:00","2021-04-23",2817,53,51,610,188,3719
"Enfield","08:00:00","2021-04-23",4607,78,32,1430,535,6682
"Greenwich","08:00:00","2021-04-23",347,8,38,105,118,616
"Harrow","08:00:00","2021-04-23",982,19,7,110,19,1137
"Havering","08:00:00","2021-04-23",2217,29,17,521,112,2896
"Hounslow","08:00:00","2021-04-23",790,10,47,73,23,943
"Kingston upon Thames","08:00:00","2021-04-23",3824,143,15,836,165,4983
"Southwark","08:00:00","2021-04-23",714,114,218,353,123,1522
"Barking and Dagenham","09:00:00","2021-04-23",671,8,33,170,71,953
"Barnet","09:00:00","2021-04-23",2679,38,43,688,286,3734
"Enfield","09:00:00","2021-04-23",4343,48,34,1319,590,6334
"Greenwich","09:00:00","2021-04-23",688,19,37,93,90,927
"Harrow","09:00:00","2021-04-23",823,13,10,117,23,986
"Havering","09:00:00","2021-04-23",2108,29,24,492,146,2799
"Hounslow","09:00:00","2021-04-23",551,15,50,62,18,696
"Kingston upon Thames","09:00:00","2021-04-23",3722,90,13,846,193,4864
"Southwark","09:00:00","2021-04-23",735,124,234,366,136,1595
"Barking and Dagenham","10:00:00","2021-04-23",574,7,27,138,50,796
"Barnet","10:00:00","2021-04-23",2654,30,31,689,269,3673
"Enfield","10:00:00","2021-04-23",3987,46,32,1363,589,6017
"Greenwich","10:00:00","2021-04-23",813,17,38,119,106,1093
"Harrow","10:00:00","2021-04-23",732,15,9,144,23,923
"Havering","10:00:00","2021-04-23",1944,19,13,548,141,2665
"Hounslow","10:00:00","2021-04-23",393,5,47,76,27,548
"Kingston upon Thames","10:00:00","2021-04-23",3701,106,10,844,201,4862
"Southwark","10:00:00","2021-04-23",801,100,225,378,159,1663
"Barking and Dagenham","11:00:00","2021-04-23",644,6,25,121,55,851
"Barnet","11:00:00","2021-04-23",2798,40,28,662,258,3786
"Enfield","11:00:00","2021-04-23",4264,66,27,1516,586,6459
"Greenwich","11:00:00","2021-04-23",964,13,36,111,113,1237
"Harrow","11:00:00","2021-04-23",697,19,8,126,31,881
"Havering","11:00:00","2021-04-23",2083,30,14,581,159,2867
"Hounslow","11:00:00","2021-04-23",406,18,45,82,17,568
"Kingston upon Thames","11:00:00","2021-04-23",3564,105,8,910,177,4764
"Southwark","11:00:00","2021-04-23",814,136,208,382,152,1692
"Barking and Dagenham","12:00:00","2021-04-23",702,11,24,151,64,952
"Barnet","12:00:00","2021-04-23",2963,44,28,693,286,4014
"Enfield","12:00:00","2021-04-23",4531,65,29,1458,541,6624
"Greenwich","12:00:00","2021-04-23",996,29,30,115,101,1271
"Harrow","12:00:00","2021-04-23",830,22,8,100,20,980
"Havering","12:00:00","2021-04-23",2009,29,12,507,146,2703
"Hounslow","12:00:00","2021-04-23",454,21,43,87,15,620
"Kingston upon Thames","12:00:00","2021-04-23",3837,117,10,813,161,4938
"Southwark","12:00:00","2021-04-23",893,163,217,403,154,1830
"Barking and Dagenham","13:00:00","2021-04-23",800,23,25,132,70,1050
"Barnet","13:00:00","2021-04-23",2859,66,27,765,253,3970
"Enfield","13:00:00","2021-04-23",4517,92,31,1441,576,6657
"Greenwich","13:00:00","2021-04-23",1046,21,29,100,95,1291
"Harrow","13:00:00","2021-04-23",907,17,6,131,13,1074
"Havering","13:00:00","2021-04-23",2200,43,13,591,125,2972
"Hounslow","13:00:00","2021-04-23",485,27,44,82,17,655
"Kingston upon Thames","13:00:00","2021-04-23",3823,130,8,912,172,5045
"Southwark","13:00:00","2021-04-23",964,192,205,393,130,1884
"Barking and Dagenham","14:00:00","2021-04-23",816,30,26,154,55,1081
"Barnet","14:00:00","2021-04-23",2848,55,36,695,217,3851
"Enfield","14:00:00","2021-04-23",4826,83,38,1405,444,6796
"Greenwich","14:00:00","2021-04-23",935,21,35,72,117,1180
"Harrow","14:00:00","2021-04-23",833,19,11,114,26,1003
"Havering","14:00:00","2021-04-23",2251,33,18,525,119,2946
"Hounslow","14:00:00","2021-04-23",573,17,47,67,15,719
"Kingston upon Thames","14:00:00","2021-04-23",4207,114,17,962,128,5428
"Southwark","14:00:00","2021-04-23",1084,187,217,407,100,1995
"Barking and Dagenham","15:00:00","2021-04-23",924,11,25,157,42,1159
"Barnet","15:00:00","2021-04-23",2867,57,44,666,214,3848
"Enfield","15:00:00","2021-04-23",5041,89,25,1494,378,7027
"Greenwich","15:00:00","2021-04-23",892,21,32,74,72,1091
"Harrow","15:00:00","2021-04-23",941,14,6,119,12,1092
"Havering","15:00:00","2021-04-23",2344,42,21,512,76,2995
"Hounslow","15:00:00","2021-04-23",696,23,43,66,13,841
"Kingston upon Thames","15:00:00","2021-04-23",4304,151,18,866,109,5448
"Southwark","15:00:00","2021-04-23",1130,231,210,405,85,2061
"Barking and Dagenham","16:00:00","2021-04-23",972,27,19,163,26,1207
"Barnet","16:00:00","2021-04-23",3252,95,52,774,142,4315
"Enfield","16:00:00","2021-04-23",5321,116,32,1375,288,7132
"Greenwich","16:00:00","2021-04-23",911,27,30,98,49,1115
"Harrow","16:00:00","2021-04-23",1038,35,11,114,6,1204
"Havering","16:00:00","2021-04-23",2614,62,28,484,64,3252
"Hounslow","16:00:00","2021-04-23",584,32,50,61,15,742
"Kingston upon Thames","16:00:00","2021-04-23",4626,180,14,917,82,5819
"Southwark","16:00:00","2021-04-23",1145,240,214,351,78,2028
"Barking and Dagenham","17:00:00","2021-04-23",1073,25,25,146,28,1297
"Barnet","17:00:00","2021-04-23",3253,122,28,639,88,4130
"Enfield","17:00:00","2021-04-23",5578,128,30,1184,205,7125
"Greenwich","17:00:00","2021-04-23",967,32,28,82,41,1150
"Harrow","17:00:00","2021-04-23",1043,49,5,118,10,1225
"Havering","17:00:00","2021-04-23",2630,60,16,425,56,3187
"Hounslow","17:00:00","2021-04-23",562,48,48,47,9,714
"Kingston upon Thames","17:00:00","2021-04-23",4902,239,24,811,71,6047
"Southwark","17:00:00","2021-04-23",1307,272,204,267,40,2090
"Barking and Dagenham","18:00:00","2021-04-23",943,22,38,95,9,1107
"Barnet","18:00:00","2021-04-23",3611,84,36,524,79,4334
"Enfield","18:00:00","2021-04-23",5858,123,29,1036,159,7205
"Greenwich","18:00:00","2021-04-23",1033,38,35,61,24,1191
"Harrow","18:00:00","2021-04-23",1042,38,9,85,9,1183
"Havering","18:00:00","2021-04-23",2805,48,14,357,41,3265
"Hounslow","18:00:00","2021-04-23",533,48,51,34,2,668
"Kingston upon Thames","18:00:00","2021-04-23",5219,248,9,527,78,6081
"Southwark","18:00:00","2021-04-23",1354,296,221,209,37,2117
"Hillingdon","07:00:00","2021-04-26",852,11,23,140,19,1045
"Islington","07:00:00","2021-04-26",395,27,23,176,37,658
"Kensington and Chelsea","07:00:00","2021-04-26",1386,132,31,527,129,2205
"Kingston upon Thames","07:00:00","2021-04-26",619,18,46,102,18,803
"Redbridge","07:00:00","2021-04-26",3814,153,41,1421,306,5735
"Hillingdon","08:00:00","2021-04-26",964,7,34,97,34,1136
"Islington","08:00:00","2021-04-26",484,20,16,142,65,727
"Kensington and Chelsea","08:00:00","2021-04-26",1584,98,28,500,137,2347
"Kingston upon Thames","08:00:00","2021-04-26",876,23,47,106,22,1074
"Redbridge","08:00:00","2021-04-26",4039,75,30,1183,308,5635
"Hillingdon","09:00:00","2021-04-26",857,4,30,116,33,1040
"Islington","09:00:00","2021-04-26",469,19,21,175,52,736
"Kensington and Chelsea","09:00:00","2021-04-26",1528,56,28,540,142,2294
"Kingston upon Thames","09:00:00","2021-04-26",747,17,49,109,24,946
"Redbridge","09:00:00","2021-04-26",3766,49,36,1143,376,5370
"Hillingdon","10:00:00","2021-04-26",858,3,27,119,37,1044
"Islington","10:00:00","2021-04-26",375,13,17,154,35,594
"Kensington and Chelsea","10:00:00","2021-04-26",1310,94,25,560,180,2169
"Kingston upon Thames","10:00:00","2021-04-26",635,14,44,97,21,811
"Redbridge","10:00:00","2021-04-26",3466,41,35,1162,372,5076
"Hillingdon","11:00:00","2021-04-26",826,5,26,104,40,1001
"Islington","11:00:00","2021-04-26",326,25,17,147,25,540
"Kensington and Chelsea","11:00:00","2021-04-26",1416,85,30,596,187,2314
"Kingston upon Thames","11:00:00","2021-04-26",606,28,45,84,10,773
"Redbridge","11:00:00","2021-04-26",3650,44,30,1099,404,5227
"Hillingdon","12:00:00","2021-04-26",807,6,26,126,35,1000
"Islington","12:00:00","2021-04-26",322,43,16,118,33,532
"Kensington and Chelsea","12:00:00","2021-04-26",1340,78,28,551,134,2131
"Kingston upon Thames","12:00:00","2021-04-26",648,33,46,98,10,835
"Redbridge","12:00:00","2021-04-26",3621,51,30,1109,357,5168
"Hillingdon","13:00:00","2021-04-26",835,10,24,116,25,1010
"Islington","13:00:00","2021-04-26",336,47,19,122,22,546
"Kensington and Chelsea","13:00:00","2021-04-26",1446,107,29,517,153,2252
"Kingston upon Thames","13:00:00","2021-04-26",641,40,49,86,16,832
"Redbridge","13:00:00","2021-04-26",3685,51,28,1214,359,5337
"Hillingdon","14:00:00","2021-04-26",827,8,33,102,21,991
"Islington","14:00:00","2021-04-26",406,36,14,115,10,581
"Kensington and Chelsea","14:00:00","2021-04-26",1480,114,30,494,131,2249
"Kingston upon Thames","14:00:00","2021-04-26",667,29,47,91,19,853
"Redbridge","14:00:00","2021-04-26",4208,65,32,1304,354,5963
"Hillingdon","15:00:00","2021-04-26",956,19,23,134,26,1158
"Islington","15:00:00","2021-04-26",433,39,23,96,17,608
"Kensington and Chelsea","15:00:00","2021-04-26",1570,120,28,490,111,2319
"Kingston upon Thames","15:00:00","2021-04-26",753,38,52,83,7,933
"Redbridge","15:00:00","2021-04-26",4231,70,27,1284,283,5895
"Hillingdon","16:00:00","2021-04-26",877,8,30,130,16,1061
"Islington","16:00:00","2021-04-26",450,40,18,89,14,611
"Kensington and Chelsea","16:00:00","2021-04-26",1629,146,29,411,75,2290
"Kingston upon Thames","16:00:00","2021-04-26",808,45,55,113,8,1029
"Redbridge","16:00:00","2021-04-26",4276,137,37,1115,163,5728
"Hillingdon","17:00:00","2021-04-26",969,8,29,93,8,1107
"Islington","17:00:00","2021-04-26",480,43,17,67,3,610
"Kensington and Chelsea","17:00:00","2021-04-26",1665,180,30,420,41,2336
"Kingston upon Thames","17:00:00","2021-04-26",756,53,45,77,9,940
"Redbridge","17:00:00","2021-04-26",4126,131,28,852,140,5277
"Hillingdon","18:00:00","2021-04-26",827,7,29,83,10,956
"Islington","18:00:00","2021-04-26",422,60,15,42,13,552
"Kensington and Chelsea","18:00:00","2021-04-26",1936,157,28,267,41,2429
"Kingston upon Thames","18:00:00","2021-04-26",662,58,45,42,8,815
"Redbridge","18:00:00","2021-04-26",3907,111,26,614,117,4775
"Bexley","07:00:00","2021-04-27",2919,82,12,1113,158,4284
"Brent","07:00:00","2021-04-27",844,28,136,135,31,1174
"Ealing","07:00:00","2021-04-27",4140,164,15,1726,482,6527
"Enfield","07:00:00","2021-04-27",3023,99,45,1191,273,4631
"Kensington and Chelsea","07:00:00","2021-04-27",1972,161,24,722,160,3039
"Redbridge","07:00:00","2021-04-27",950,86,23,300,84,1443
"Waltham Forest","07:00:00","2021-04-27",910,22,18,213,41,1204
"Bexley","08:00:00","2021-04-27",3083,56,15,862,168,4184
"Brent","08:00:00","2021-04-27",871,34,118,137,36,1196
"Ealing","08:00:00","2021-04-27",3942,111,10,1355,450,5868
"Enfield","08:00:00","2021-04-27",3094,99,28,975,353,4549
"Kensington and Chelsea","08:00:00","2021-04-27",2354,124,24,689,177,3368
"Redbridge","08:00:00","2021-04-27",1089,55,20,270,65,1499
"Waltham Forest","08:00:00","2021-04-27",1299,17,21,189,51,1577
"Bexley","09:00:00","2021-04-27",3093,41,10,746,175,4065
"Brent","09:00:00","2021-04-27",753,43,127,134,37,1094
"Ealing","09:00:00","2021-04-27",3884,80,14,1414,602,5994
"Enfield","09:00:00","2021-04-27",2937,45,48,999,381,4410
"Greenwich","09:00:00","2021-04-27",3804,95,55,1224,416,5594
"Kensington and Chelsea","09:00:00","2021-04-27",2183,97,19,679,175,3153
"Redbridge","09:00:00","2021-04-27",1183,20,30,290,103,1626
"Waltham Forest","09:00:00","2021-04-27",1038,11,20,234,48,1351
"Bexley","10:00:00","2021-04-27",2887,26,3,624,190,3730
"Brent","10:00:00","2021-04-27",734,52,116,140,34,1076
"Ealing","10:00:00","2021-04-27",3668,50,11,1409,646,5784
"Enfield","10:00:00","2021-04-27",2607,35,35,998,425,4100
"Greenwich","10:00:00","2021-04-27",3098,67,53,1042,423,4683
"Kensington and Chelsea","10:00:00","2021-04-27",2198,102,17,683,232,3232
"Redbridge","10:00:00","2021-04-27",1141,28,23,308,122,1622
"Waltham Forest","10:00:00","2021-04-27",953,18,16,231,57,1275
"Bexley","11:00:00","2021-04-27",2792,35,2,652,169,3650
"Brent","11:00:00","2021-04-27",748,62,117,158,31,1116
"Ealing","11:00:00","2021-04-27",3558,56,11,1360,656,5641
"Enfield","11:00:00","2021-04-27",2851,50,31,1022,441,4395
"Greenwich","11:00:00","2021-04-27",3150,59,57,1003,418,4687
"Kensington and Chelsea","11:00:00","2021-04-27",2047,80,20,627,187,2961
"Redbridge","11:00:00","2021-04-27",1128,24,23,349,94,1618
"Waltham Forest","11:00:00","2021-04-27",1077,26,15,227,60,1405
"Bexley","12:00:00","2021-04-27",2812,40,3,652,222,3729
"Brent","12:00:00","2021-04-27",801,76,118,138,29,1162
"Ealing","12:00:00","2021-04-27",3580,83,11,1294,599,5567
"Enfield","12:00:00","2021-04-27",2965,49,34,1062,405,4515
"Greenwich","12:00:00","2021-04-27",3347,88,48,1100,492,5075
"Kensington and Chelsea","12:00:00","2021-04-27",2176,109,17,702,161,3165
"Redbridge","12:00:00","2021-04-27",1321,40,20,358,98,1837
"Waltham Forest","12:00:00","2021-04-27",964,28,16,207,63,1278
"Bexley","13:00:00","2021-04-27",2864,37,4,689,182,3776
"Brent","13:00:00","2021-04-27",809,123,115,138,31,1216
"Ealing","13:00:00","2021-04-27",3678,89,11,1157,576,5511
"Enfield","13:00:00","2021-04-27",2865,48,33,1045,455,4446
"Greenwich","13:00:00","2021-04-27",3478,102,48,1247,440,5315
"Kensington and Chelsea","13:00:00","2021-04-27",2115,114,26,712,147,3114
"Redbridge","13:00:00","2021-04-27",1358,35,24,356,100,1873
"Waltham Forest","13:00:00","2021-04-27",1029,33,20,247,45,1374
"Bexley","14:00:00","2021-04-27",3038,37,10,765,169,4019
"Brent","14:00:00","2021-04-27",845,103,117,124,22,1211
"Ealing","14:00:00","2021-04-27",3780,87,11,1218,529,5625
"Enfield","14:00:00","2021-04-27",2943,68,38,1000,339,4388
"Greenwich","14:00:00","2021-04-27",3916,104,49,1421,436,5926
"Kensington and Chelsea","14:00:00","2021-04-27",2172,100,19,666,160,3117
"Redbridge","14:00:00","2021-04-27",1387,45,26,320,112,1890
"Waltham Forest","14:00:00","2021-04-27",1026,29,16,209,33,1313
"Bexley","15:00:00","2021-04-27",3273,54,7,941,122,4397
"Brent","15:00:00","2021-04-27",817,89,114,123,33,1176
"Ealing","15:00:00","2021-04-27",3719,71,9,1217,425,5441
"Enfield","15:00:00","2021-04-27",2806,54,36,964,312,4172
"Kensington and Chelsea","15:00:00","2021-04-27",2483,132,18,717,105,3455
"Redbridge","15:00:00","2021-04-27",1409,45,26,394,70,1944
"Waltham Forest","15:00:00","2021-04-27",1141,22,16,187,38,1404
"Bexley","16:00:00","2021-04-27",3676,90,5,996,93,4860
"Brent","16:00:00","2021-04-27",862,113,111,133,19,1238
"Ealing","16:00:00","2021-04-27",3817,127,11,1064,298,5317
"Enfield","16:00:00","2021-04-27",3095,122,38,1016,199,4470
"Kensington and Chelsea","16:00:00","2021-04-27",2324,156,26,587,77,3170
"Redbridge","16:00:00","2021-04-27",1649,82,24,331,48,2134
"Waltham Forest","16:00:00","2021-04-27",1164,36,18,199,23,1440
"Bexley","17:00:00","2021-04-27",4044,114,4,867,72,5101
"Brent","17:00:00","2021-04-27",966,116,94,130,11,1317
"Ealing","17:00:00","2021-04-27",4365,172,8,1019,205,5769
"Enfield","17:00:00","2021-04-27",3274,127,30,812,129,4372
"Kensington and Chelsea","17:00:00","2021-04-27",2501,192,23,467,38,3221
"Redbridge","17:00:00","2021-04-27",1727,62,26,294,47,2156
"Waltham Forest","17:00:00","2021-04-27",1263,36,18,165,23,1505
"Bexley","18:00:00","2021-04-27",3651,60,5,605,55,4376
"Brent","18:00:00","2021-04-27",909,140,116,82,7,1254
"Ealing","18:00:00","2021-04-27",4753,128,12,846,173,5912
"Enfield","18:00:00","2021-04-27",2787,109,30,550,97,3573
"Kensington and Chelsea","18:00:00","2021-04-27",2712,217,16,342,41,3328
"Redbridge","18:00:00","2021-04-27",1846,62,20,242,39,2209
"Waltham Forest","18:00:00","2021-04-27",1193,33,17,126,25,1394
"Brent","07:00:00","2021-04-28",5081,198,32,1956,567,7834
"Croydon","07:00:00","2021-04-28",1703,49,20,436,108,2316
"Harrow","07:00:00","2021-04-28",1321,25,90,254,39,1729
"Havering","07:00:00","2021-04-28",2003,49,10,698,106,2866
"Lambeth","07:00:00","2021-04-28",351,42,38,148,28,607
"Redbridge","07:00:00","2021-04-28",3198,144,8,1361,295,5006
"Waltham Forest","07:00:00","2021-04-28",452,14,39,195,38,738
"Brent","08:00:00","2021-04-28",4908,143,25,1627,585,7288
"Croydon","08:00:00","2021-04-28",2038,54,14,344,82,2532
"Harrow","08:00:00","2021-04-28",1562,20,59,178,33,1852
"Havering","08:00:00","2021-04-28",1953,22,1,459,87,2522
"Lambeth","08:00:00","2021-04-28",358,27,25,114,21,545
"Redbridge","08:00:00","2021-04-28",3245,70,4,981,311,4611
"Waltham Forest","08:00:00","2021-04-28",475,18,46,167,47,753
"Brent","09:00:00","2021-04-28",4648,110,26,1703,710,7197
"Croydon","09:00:00","2021-04-28",1550,28,17,425,83,2103
"Harrow","09:00:00","2021-04-28",1291,20,74,215,52,1652
"Havering","09:00:00","2021-04-28",1997,20,1,508,121,2647
"Lambeth","09:00:00","2021-04-28",372,23,34,107,28,564
"Redbridge","09:00:00","2021-04-28",3019,45,10,988,346,4408
"Waltham Forest","09:00:00","2021-04-28",448,18,42,160,65,733
"Brent","10:00:00","2021-04-28",4281,84,22,1774,830,6991
"Croydon","10:00:00","2021-04-28",1428,34,15,332,104,1913
"Harrow","10:00:00","2021-04-28",1124,29,69,238,47,1507
"Havering","10:00:00","2021-04-28",1859,19,1,559,125,2563
"Lambeth","10:00:00","2021-04-28",308,31,36,112,45,532
"Redbridge","10:00:00","2021-04-28",2777,47,10,960,413,4207
"Waltham Forest","10:00:00","2021-04-28",461,19,45,155,62,742
"Brent","11:00:00","2021-04-28",4405,87,25,1696,799,7012
"Croydon","11:00:00","2021-04-28",1529,48,12,371,113,2073
"Harrow","11:00:00","2021-04-28",1213,29,61,222,56,1581
"Havering","11:00:00","2021-04-28",1859,32,0,502,126,2519
"Lambeth","11:00:00","2021-04-28",299,27,32,130,33,521
"Redbridge","11:00:00","2021-04-28",2904,32,5,1007,402,4350
"Waltham Forest","11:00:00","2021-04-28",475,37,46,151,56,765
"Brent","12:00:00","2021-04-28",4318,96,22,1515,779,6730
"Croydon","12:00:00","2021-04-28",1558,40,11,365,126,2100
"Harrow","12:00:00","2021-04-28",1208,41,66,207,42,1564
"Havering","12:00:00","2021-04-28",1918,36,2,507,124,2587
"Lambeth","12:00:00","2021-04-28",310,45,40,122,33,550
"Redbridge","12:00:00","2021-04-28",2985,33,3,1053,414,4488
"Waltham Forest","12:00:00","2021-04-28",531,44,43,161,50,829
"Brent","13:00:00","2021-04-28",4620,96,27,1354,738,6835
"Croydon","13:00:00","2021-04-28",1685,50,14,411,97,2257
"Harrow","13:00:00","2021-04-28",1314,47,67,198,46,1672
"Havering","13:00:00","2021-04-28",2018,29,0,514,130,2691
"Lambeth","13:00:00","2021-04-28",367,47,28,113,34,589
"Redbridge","13:00:00","2021-04-28",3249,42,6,1084,342,4723
"Waltham Forest","13:00:00","2021-04-28",567,35,41,118,36,797
"Brent","14:00:00","2021-04-28",4694,88,24,1418,597,6821
"Croydon","14:00:00","2021-04-28",1867,57,13,370,102,2409
"Harrow","14:00:00","2021-04-28",1347,39,70,230,46,1732
"Havering","14:00:00","2021-04-28",2118,25,1,513,105,2762
"Lambeth","14:00:00","2021-04-28",376,59,33,115,24,607
"Redbridge","14:00:00","2021-04-28",3338,48,7,1139,332,4864
"Waltham Forest","14:00:00","2021-04-28",588,42,45,134,44,853
"Brent","15:00:00","2021-04-28",4712,108,23,1448,485,6776
"Croydon","15:00:00","2021-04-28",2027,59,12,312,96,2506
"Harrow","15:00:00","2021-04-28",1374,29,64,182,24,1673
"Havering","15:00:00","2021-04-28",2055,39,1,478,73,2646
"Lambeth","15:00:00","2021-04-28",425,48,30,112,26,641
"Redbridge","15:00:00","2021-04-28",3328,76,3,1180,239,4826
"Waltham Forest","15:00:00","2021-04-28",563,40,39,127,40,809
"Brent","16:00:00","2021-04-28",5635,163,25,1406,372,7601
"Croydon","16:00:00","2021-04-28",1897,76,16,385,46,2420
"Harrow","16:00:00","2021-04-28",1472,60,63,176,25,1796
"Havering","16:00:00","2021-04-28",1967,50,9,518,54,2598
"Lambeth","16:00:00","2021-04-28",467,47,34,123,12,683
"Redbridge","16:00:00","2021-04-28",3270,92,4,960,151,4477
"Waltham Forest","16:00:00","2021-04-28",463,39,46,111,18,677
"Brent","17:00:00","2021-04-28",5913,178,18,1333,241,7683
"Croydon","17:00:00","2021-04-28",2075,69,12,318,51,2525
"Harrow","17:00:00","2021-04-28",1415,70,59,174,15,1733
"Havering","17:00:00","2021-04-28",2311,57,1,410,52,2831
"Lambeth","17:00:00","2021-04-28",462,83,29,84,5,663
"Redbridge","17:00:00","2021-04-28",3301,124,1,777,109,4312
"Waltham Forest","17:00:00","2021-04-28",572,30,38,89,15,744
"Brent","18:00:00","2021-04-28",6676,138,27,1088,223,8152
"Croydon","18:00:00","2021-04-28",1784,67,11,228,43,2133
"Harrow","18:00:00","2021-04-28",1370,45,62,164,11,1652
"Havering","18:00:00","2021-04-28",2327,43,4,362,36,2772
"Lambeth","18:00:00","2021-04-28",481,61,33,66,6,647
"Redbridge","18:00:00","2021-04-28",3551,83,3,638,109,4384
"Waltham Forest","18:00:00","2021-04-28",694,54,34,95,7,884
"Barnet","07:00:00","2021-04-29",1625,25,34,368,42,2094
"Greenwich","07:00:00","2021-04-29",1587,30,33,341,143,2134
"Kensington and Chelsea","07:00:00","2021-04-29",811,54,3,293,70,1231
"Redbridge","07:00:00","2021-04-29",389,2,38,88,18,535
"Tower Hamlets","07:00:00","2021-04-29",2113,319,11,1253,366,4062
"Barnet","08:00:00","2021-04-29",1946,16,32,254,34,2282
"Enfield","08:00:00","2021-04-29",6669,152,70,2206,761,9858
"Greenwich","08:00:00","2021-04-29",1829,14,9,361,116,2329
"Kensington and Chelsea","08:00:00","2021-04-29",942,49,3,259,68,1321
"Redbridge","08:00:00","2021-04-29",587,4,44,81,13,729
"Tower Hamlets","08:00:00","2021-04-29",2351,184,7,1095,376,4013
"Barnet","09:00:00","2021-04-29",1502,29,17,254,57,1859
"Enfield","09:00:00","2021-04-29",6191,119,90,2203,848,9451
"Greenwich","09:00:00","2021-04-29",1400,15,10,359,114,1898
"Kensington and Chelsea","09:00:00","2021-04-29",852,52,3,276,89,1272
"Redbridge","09:00:00","2021-04-29",590,5,49,69,17,730
"Tower Hamlets","09:00:00","2021-04-29",2291,131,6,1086,424,3938
"Barnet","10:00:00","2021-04-29",1201,12,17,259,51,1540
"Enfield","10:00:00","2021-04-29",5974,94,87,2157,1000,9312
"Greenwich","10:00:00","2021-04-29",1148,20,4,418,142,1732
"Kensington and Chelsea","10:00:00","2021-04-29",828,47,0,317,89,1281
"Redbridge","10:00:00","2021-04-29",495,10,47,81,15,648
"Tower Hamlets","10:00:00","2021-04-29",2296,83,3,1024,453,3859
"Barnet","11:00:00","2021-04-29",1241,30,12,246,54,1583
"Enfield","11:00:00","2021-04-29",6139,100,68,2213,1039,9559
"Greenwich","11:00:00","2021-04-29",1244,8,4,368,122,1746
"Kensington and Chelsea","11:00:00","2021-04-29",834,63,0,336,100,1333
"Redbridge","11:00:00","2021-04-29",572,12,45,77,16,722
"Tower Hamlets","11:00:00","2021-04-29",2240,125,2,1037,410,3814
"Barnet","12:00:00","2021-04-29",1274,19,13,238,67,1611
"Enfield","12:00:00","2021-04-29",6391,95,64,2354,932,9836
"Greenwich","12:00:00","2021-04-29",1355,17,4,314,159,1849
"Kensington and Chelsea","12:00:00","2021-04-29",853,75,2,303,89,1322
"Redbridge","12:00:00","2021-04-29",650,20,47,99,26,842
"Tower Hamlets","12:00:00","2021-04-29",2386,157,3,1102,411,4059
"Barnet","13:00:00","2021-04-29",1324,36,11,260,36,1667
"Greenwich","13:00:00","2021-04-29",1461,28,8,317,117,1931
"Kensington and Chelsea","13:00:00","2021-04-29",902,96,6,335,111,1450
"Redbridge","13:00:00","2021-04-29",692,19,45,78,15,849
"Tower Hamlets","13:00:00","2021-04-29",2498,120,4,1065,438,4125
"Barnet","14:00:00","2021-04-29",1485,21,19,255,45,1825
"Greenwich","14:00:00","2021-04-29",1618,29,18,300,161,2126
"Kensington and Chelsea","14:00:00","2021-04-29",967,76,2,320,69,1434
"Redbridge","14:00:00","2021-04-29",747,14,46,67,17,891
"Tower Hamlets","14:00:00","2021-04-29",2474,158,1,1018,415,4066
"Barnet","15:00:00","2021-04-29",1825,27,30,257,32,2171
"Enfield","15:00:00","2021-04-29",6647,137,87,2175,626,9672
"Greenwich","15:00:00","2021-04-29",1780,33,13,257,127,2210
"Kensington and Chelsea","15:00:00","2021-04-29",1022,83,8,285,63,1461
"Redbridge","15:00:00","2021-04-29",817,23,46,90,13,989
"Tower Hamlets","15:00:00","2021-04-29",2740,196,9,1167,284,4396
"Barnet","16:00:00","2021-04-29",1832,41,30,310,28,2241
"Enfield","16:00:00","2021-04-29",6990,194,89,2059,494,9826
"Greenwich","16:00:00","2021-04-29",1887,55,28,262,88,2320
"Kensington and Chelsea","16:00:00","2021-04-29",992,71,4,257,41,1365
"Redbridge","16:00:00","2021-04-29",828,22,46,89,12,997
"Tower Hamlets","16:00:00","2021-04-29",2748,256,8,1059,226,4297
"Barnet","17:00:00","2021-04-29",1904,31,18,285,23,2261
"Enfield","17:00:00","2021-04-29",6788,246,68,1562,256,8920
"Greenwich","17:00:00","2021-04-29",2077,50,4,236,77,2444
"Kensington and Chelsea","17:00:00","2021-04-29",1127,108,6,264,18,1523
"Redbridge","17:00:00","2021-04-29",871,24,47,80,5,1027
"Tower Hamlets","17:00:00","2021-04-29",2846,350,11,875,133,4215
"Barnet","18:00:00","2021-04-29",1865,57,15,177,12,2126
"Enfield","18:00:00","2021-04-29",6343,183,76,1237,209,8048
"Greenwich","18:00:00","2021-04-29",1969,45,6,186,74,2280
"Kensington and Chelsea","18:00:00","2021-04-29",1151,124,0,189,23,1487
"Redbridge","18:00:00","2021-04-29",883,41,48,84,5,1061
"Tower Hamlets","18:00:00","2021-04-29",3311,293,5,637,90,4336
"Bexley","07:00:00","2021-04-30",135,3,0,29,1,168
"Brent","07:00:00","2021-04-30",1082,23,32,248,37,1422
"Croydon","07:00:00","2021-04-30",601,15,42,190,36,884
"Hillingdon","07:00:00","2021-04-30",1597,30,35,382,138,2182
"Hounslow","07:00:00","2021-04-30",2725,55,72,718,151,3721
"Lambeth","07:00:00","2021-04-30",1293,185,92,670,170,2410
"Bexley","08:00:00","2021-04-30",242,7,0,16,3,268
"Brent","08:00:00","2021-04-30",1429,12,20,167,38,1666
"Croydon","08:00:00","2021-04-30",689,22,38,160,29,938
"Hillingdon","08:00:00","2021-04-30",1526,19,25,312,158,2040
"Hounslow","08:00:00","2021-04-30",3079,34,59,551,167,3890
"Lambeth","08:00:00","2021-04-30",1220,125,90,504,157,2096
"Bexley","09:00:00","2021-04-30",157,5,0,21,2,185
"Brent","09:00:00","2021-04-30",1056,23,25,184,49,1337
"Croydon","09:00:00","2021-04-30",544,21,44,147,30,786
"Hillingdon","09:00:00","2021-04-30",1125,19,22,272,181,1619
"Hounslow","09:00:00","2021-04-30",2370,53,55,545,182,3205
"Lambeth","09:00:00","2021-04-30",1223,127,73,514,181,2118
"Bexley","10:00:00","2021-04-30",139,8,1,19,6,173
"Brent","10:00:00","2021-04-30",1026,15,21,171,49,1282
"Croydon","10:00:00","2021-04-30",485,14,44,135,26,704
"Hillingdon","10:00:00","2021-04-30",855,14,18,278,160,1325
"Hounslow","10:00:00","2021-04-30",1987,36,53,523,174,2773
"Lambeth","10:00:00","2021-04-30",1183,105,75,496,194,2053
"Bexley","11:00:00","2021-04-30",122,7,1,31,5,166
"Brent","11:00:00","2021-04-30",1084,28,19,152,49,1332
"Croydon","11:00:00","2021-04-30",413,14,43,113,36,619
"Hillingdon","11:00:00","2021-04-30",993,20,20,246,169,1448
"Hounslow","11:00:00","2021-04-30",2193,56,48,506,163,2966
"Lambeth","11:00:00","2021-04-30",1168,103,60,479,188,1998
"Bexley","12:00:00","2021-04-30",156,11,0,19,5,191
"Brent","12:00:00","2021-04-30",1107,51,15,168,46,1387
"Croydon","12:00:00","2021-04-30",472,25,40,113,28,678
"Hillingdon","12:00:00","2021-04-30",1151,23,21,292,163,1650
"Hounslow","12:00:00","2021-04-30",2652,70,51,567,159,3499
"Lambeth","12:00:00","2021-04-30",1223,164,72,460,171,2090
"Bexley","13:00:00","2021-04-30",141,8,0,23,1,173
"Brent","13:00:00","2021-04-30",1097,54,18,161,35,1365
"Croydon","13:00:00","2021-04-30",502,25,47,118,21,713
"Hillingdon","13:00:00","2021-04-30",1299,21,21,272,144,1757
"Hounslow","13:00:00","2021-04-30",2788,65,56,554,135,3598
"Lambeth","13:00:00","2021-04-30",1186,162,65,418,168,1999
"Bexley","14:00:00","2021-04-30",162,7,0,19,6,194
"Brent","14:00:00","2021-04-30",1159,33,35,166,37,1430
"Croydon","14:00:00","2021-04-30",487,27,40,110,20,684
"Hillingdon","14:00:00","2021-04-30",1446,15,21,324,158,1964
"Hounslow","14:00:00","2021-04-30",3082,78,58,554,136,3908
"Lambeth","14:00:00","2021-04-30",1321,147,68,423,115,2074
"Bexley","15:00:00","2021-04-30",246,5,0,28,2,281
"Brent","15:00:00","2021-04-30",1335,20,19,171,28,1573
"Croydon","15:00:00","2021-04-30",545,23,35,95,13,711
"Hillingdon","15:00:00","2021-04-30",1561,18,24,323,159,2085
"Hounslow","15:00:00","2021-04-30",3462,82,59,549,115,4267
"Lambeth","15:00:00","2021-04-30",1333,143,69,348,92,1985
"Bexley","16:00:00","2021-04-30",215,8,0,32,2,257
"Brent","16:00:00","2021-04-30",1244,39,25,174,25,1507
"Croydon","16:00:00","2021-04-30",481,32,36,94,15,658
"Hillingdon","16:00:00","2021-04-30",1795,32,30,341,132,2330
"Hounslow","16:00:00","2021-04-30",3354,94,65,479,85,4077
"Lambeth","16:00:00","2021-04-30",1481,176,85,326,71,2139
"Bexley","17:00:00","2021-04-30",272,11,0,24,2,309
"Brent","17:00:00","2021-04-30",1215,43,19,157,22,1456
"Croydon","17:00:00","2021-04-30",494,52,45,69,5,665
"Hillingdon","17:00:00","2021-04-30",1863,36,26,285,118,2328
"Hounslow","17:00:00","2021-04-30",3529,101,55,476,75,4236
"Lambeth","17:00:00","2021-04-30",1519,223,78,284,54,2158
"Bexley","18:00:00","2021-04-30",214,17,0,17,0,248
"Brent","18:00:00","2021-04-30",1171,50,20,146,16,1403
"Croydon","18:00:00","2021-04-30",546,64,43,60,9,722
"Hillingdon","18:00:00","2021-04-30",1650,33,23,242,96,2044
"Hounslow","18:00:00","2021-04-30",3378,112,50,347,48,3935
"Lambeth","18:00:00","2021-04-30",1725,216,81,233,52,2307
"Barnet","07:00:00","2021-05-04",105,0,44,16,7,172
"Hillingdon","07:00:00","2021-05-04",34,0,0,9,0,43
"Hounslow","07:00:00","2021-05-04",1355,11,20,350,53,1789
"Barnet","08:00:00","2021-05-04",234,2,42,26,2,306
"Hillingdon","08:00:00","2021-05-04",39,0,0,3,4,46
"Hounslow","08:00:00","2021-05-04",1371,16,19,225,51,1682
"Barnet","09:00:00","2021-05-04",556,19,51,61,9,696
"Hillingdon","09:00:00","2021-05-04",29,0,0,4,0,33
"Hounslow","09:00:00","2021-05-04",896,15,16,182,39,1148
"Barnet","10:00:00","2021-05-04",713,34,46,31,7,831
"Hillingdon","10:00:00","2021-05-04",28,0,0,5,0,33
"Hounslow","10:00:00","2021-05-04",555,7,11,157,38,768
"Barnet","11:00:00","2021-05-04",896,25,44,34,16,1015
"Hillingdon","11:00:00","2021-05-04",16,0,0,5,0,21
"Hounslow","11:00:00","2021-05-04",609,14,14,151,57,845
"Barnet","12:00:00","2021-05-04",884,45,38,29,12,1008
"Hillingdon","12:00:00","2021-05-04",36,0,0,4,0,40
"Hounslow","12:00:00","2021-05-04",750,11,14,169,41,985
"Barnet","13:00:00","2021-05-04",953,64,43,31,8,1099
"Hillingdon","13:00:00","2021-05-04",25,0,0,5,1,31
"Hounslow","13:00:00","2021-05-04",806,11,14,179,39,1049
"Barnet","14:00:00","2021-05-04",857,46,45,28,7,983
"Hillingdon","14:00:00","2021-05-04",27,1,0,12,1,41
"Hounslow","14:00:00","2021-05-04",997,8,15,190,40,1250
"Barnet","15:00:00","2021-05-04",743,39,44,30,3,859
"Hillingdon","15:00:00","2021-05-04",30,0,0,5,0,35
"Hounslow","15:00:00","2021-05-04",1178,13,17,191,31,1430
"Barnet","16:00:00","2021-05-04",770,51,44,19,1,885
"Hillingdon","16:00:00","2021-05-04",40,0,0,11,3,54
"Hounslow","16:00:00","2021-05-04",1217,26,16,204,26,1489
"Barnet","17:00:00","2021-05-04",701,45,44,25,4,819
"Hillingdon","17:00:00","2021-05-04",34,1,0,11,1,47
"Hounslow","17:00:00","2021-05-04",1238,25,13,169,21,1466
"Barnet","18:00:00","2021-05-04",680,35,39,22,3,779
"Hillingdon","18:00:00","2021-05-04",24,1,0,4,0,29
"Hounslow","18:00:00","2021-05-04",1125,21,12,121,19,1298
"Bromley","07:00:00","2021-05-05",142,2,4,61,9,218
"Greenwich","07:00:00","2021-05-05",4,0,0,0,1,5
"Havering","07:00:00","2021-05-05",563,12,8,187,20,790
"Wandsworth","07:00:00","2021-05-05",1746,173,124,754,151,2948
"Bromley","08:00:00","2021-05-05",206,0,2,37,4,249
"Greenwich","08:00:00","2021-05-05",15,0,1,1,0,17
"Havering","08:00:00","2021-05-05",657,4,12,148,28,849
"Wandsworth","08:00:00","2021-05-05",1877,178,123,504,169,2851
"Bromley","09:00:00","2021-05-05",126,0,2,26,9,163
"Greenwich","09:00:00","2021-05-05",8,0,0,4,0,12
"Havering","09:00:00","2021-05-05",508,5,12,120,34,679
"Wandsworth","09:00:00","2021-05-05",1788,151,139,596,215,2889
"Bromley","10:00:00","2021-05-05",123,2,4,27,9,165
"Greenwich","10:00:00","2021-05-05",7,0,0,1,4,12
"Havering","10:00:00","2021-05-05",461,2,11,94,25,593
"Wandsworth","10:00:00","2021-05-05",1676,137,126,617,218,2774
"Bromley","11:00:00","2021-05-05",146,1,4,35,9,195
"Greenwich","11:00:00","2021-05-05",12,0,0,5,0,17
"Havering","11:00:00","2021-05-05",493,3,11,100,32,639
"Wandsworth","11:00:00","2021-05-05",1591,121,128,564,189,2593
"Bromley","12:00:00","2021-05-05",133,1,2,29,8,173
"Greenwich","12:00:00","2021-05-05",14,0,0,1,0,15
"Havering","12:00:00","2021-05-05",515,0,9,95,27,646
"Wandsworth","12:00:00","2021-05-05",1668,197,126,520,177,2688
"Bromley","13:00:00","2021-05-05",143,0,4,39,6,192
"Greenwich","13:00:00","2021-05-05",9,0,0,1,0,10
"Havering","13:00:00","2021-05-05",511,3,11,96,26,647
"Wandsworth","13:00:00","2021-05-05",1668,224,120,481,138,2631
"Bromley","14:00:00","2021-05-05",158,1,2,40,6,207
"Greenwich","14:00:00","2021-05-05",18,0,0,0,0,18
"Havering","14:00:00","2021-05-05",557,0,9,112,19,697
"Wandsworth","14:00:00","2021-05-05",1745,173,129,469,128,2644
"Bromley","15:00:00","2021-05-05",187,4,3,49,9,252
"Greenwich","15:00:00","2021-05-05",14,0,1,7,1,23
"Havering","15:00:00","2021-05-05",601,3,12,147,13,776
"Wandsworth","15:00:00","2021-05-05",1971,167,123,475,94,2830
"Bromley","16:00:00","2021-05-05",174,0,3,43,5,225
"Greenwich","16:00:00","2021-05-05",11,1,0,1,1,14
"Havering","16:00:00","2021-05-05",635,5,11,143,23,817
"Wandsworth","16:00:00","2021-05-05",2108,167,133,396,66,2870
"Bromley","17:00:00","2021-05-05",211,0,4,49,2,266
"Greenwich","17:00:00","2021-05-05",10,0,0,3,1,14
"Havering","17:00:00","2021-05-05",707,9,10,130,18,874
"Wandsworth","17:00:00","2021-05-05",2298,183,123,370,64,3038
"Bromley","18:00:00","2021-05-05",134,0,2,21,1,158
"Greenwich","18:00:00","2021-05-05",10,0,0,2,0,12
"Havering","18:00:00","2021-05-05",493,1,9,87,6,596
"Wandsworth","18:00:00","2021-05-05",2254,230,127,252,39,2902
"Barking and Dagenham","07:00:00","2021-05-06",3365,123,41,1242,664,5435
"Barnet","07:00:00","2021-05-06",831,2,25,189,6,1053
"Greenwich","07:00:00","2021-05-06",149,0,0,19,2,170
"Havering","07:00:00","2021-05-06",1062,9,51,276,24,1422
"Hillingdon","07:00:00","2021-05-06",344,0,4,70,5,423
"Waltham Forest","07:00:00","2021-05-06",14,0,0,3,2,19
"Barking and Dagenham","08:00:00","2021-05-06",3717,74,29,1101,850,5771
"Barnet","08:00:00","2021-05-06",947,10,12,140,17,1126
"Greenwich","08:00:00","2021-05-06",266,1,0,15,0,282
"Havering","08:00:00","2021-05-06",1395,6,44,205,28,1678
"Hillingdon","08:00:00","2021-05-06",399,2,6,44,15,466
"Waltham Forest","08:00:00","2021-05-06",30,0,0,1,1,32
"Barking and Dagenham","09:00:00","2021-05-06",3519,43,28,1264,954,5808
"Barnet","09:00:00","2021-05-06",683,15,17,125,26,866
"Greenwich","09:00:00","2021-05-06",113,0,0,12,1,126
"Havering","09:00:00","2021-05-06",1040,6,49,196,29,1320
"Hillingdon","09:00:00","2021-05-06",248,0,8,48,8,312
"Waltham Forest","09:00:00","2021-05-06",25,0,0,6,1,32
"Barking and Dagenham","10:00:00","2021-05-06",3363,31,28,1257,1052,5731
"Barnet","10:00:00","2021-05-06",651,9,11,121,15,807
"Greenwich","10:00:00","2021-05-06",93,3,0,15,4,115
"Havering","10:00:00","2021-05-06",948,2,36,191,47,1224
"Hillingdon","10:00:00","2021-05-06",183,2,6,48,17,256
"Waltham Forest","10:00:00","2021-05-06",12,2,0,3,2,19
"Barking and Dagenham","11:00:00","2021-05-06",3486,63,23,1331,1023,5926
"Barnet","11:00:00","2021-05-06",710,7,11,120,24,872
"Greenwich","11:00:00","2021-05-06",83,0,0,13,0,96
"Havering","11:00:00","2021-05-06",948,5,35,196,39,1223
"Hillingdon","11:00:00","2021-05-06",215,0,6,48,11,280
"Waltham Forest","11:00:00","2021-05-06",27,0,0,4,1,32
"Barking and Dagenham","12:00:00","2021-05-06",3623,48,23,1259,971,5924
"Barnet","12:00:00","2021-05-06",730,24,14,143,22,933
"Greenwich","12:00:00","2021-05-06",113,3,0,9,0,125
"Havering","12:00:00","2021-05-06",1060,11,39,181,43,1334
"Hillingdon","12:00:00","2021-05-06",227,0,6,72,7,312
"Waltham Forest","12:00:00","2021-05-06",36,3,0,9,1,49
"Barking and Dagenham","13:00:00","2021-05-06",2887,31,25,835,748,4526
"Barnet","13:00:00","2021-05-06",759,9,13,151,20,952
"Greenwich","13:00:00","2021-05-06",102,0,0,11,1,114
"Havering","13:00:00","2021-05-06",1060,8,37,234,35,1374
"Hillingdon","13:00:00","2021-05-06",217,2,6,46,6,277
"Waltham Forest","13:00:00","2021-05-06",36,1,0,8,1,46
"Barking and Dagenham","14:00:00","2021-05-06",2980,52,40,855,692,4619
"Barnet","14:00:00","2021-05-06",833,16,12,115,17,993
"Greenwich","14:00:00","2021-05-06",151,2,0,17,2,172
"Havering","14:00:00","2021-05-06",1176,6,43,187,33,1445
"Hillingdon","14:00:00","2021-05-06",251,0,6,54,7,318
"Waltham Forest","14:00:00","2021-05-06",25,4,0,2,3,34
"Barking and Dagenham","15:00:00","2021-05-06",4249,90,34,1266,661,6300
"Barnet","15:00:00","2021-05-06",897,14,16,153,13,1093
"Greenwich","15:00:00","2021-05-06",245,2,0,23,1,271
"Havering","15:00:00","2021-05-06",1259,15,43,222,30,1569
"Hillingdon","15:00:00","2021-05-06",359,0,6,67,7,439
"Waltham Forest","15:00:00","2021-05-06",24,0,0,6,1,31
"Barking and Dagenham","16:00:00","2021-05-06",5338,139,31,1537,483,7528
"Barnet","16:00:00","2021-05-06",933,20,19,137,13,1122
"Greenwich","16:00:00","2021-05-06",219,2,0,37,2,260
"Havering","16:00:00","2021-05-06",1266,20,44,251,23,1604
"Hillingdon","16:00:00","2021-05-06",320,1,6,88,11,426
"Waltham Forest","16:00:00","2021-05-06",20,0,0,6,0,26
"Barking and Dagenham","17:00:00","2021-05-06",5716,175,33,1327,340,7591
"Barnet","17:00:00","2021-05-06",968,20,17,142,7,1154
"Greenwich","17:00:00","2021-05-06",214,3,0,28,1,246
"Havering","17:00:00","2021-05-06",1469,19,32,199,5,1724
"Hillingdon","17:00:00","2021-05-06",375,4,4,55,1,439
"Waltham Forest","17:00:00","2021-05-06",35,1,1,2,0,39
"Barking and Dagenham","18:00:00","2021-05-06",5624,140,34,896,249,6943
"Barnet","18:00:00","2021-05-06",896,23,12,66,5,1002
"Greenwich","18:00:00","2021-05-06",196,7,0,22,1,226
"Havering","18:00:00","2021-05-06",1224,8,40,141,4,1417
"Hillingdon","18:00:00","2021-05-06",328,6,6,48,1,389
"Waltham Forest","18:00:00","2021-05-06",30,2,0,3,1,36
"Barnet","07:00:00","2021-05-07",4476,166,22,1965,497,7126
"Hackney","07:00:00","2021-05-07",365,16,54,91,23,549
"Hammersmith and Fulham","07:00:00","2021-05-07",3001,224,27,1183,363,4798
"Kensington and Chelsea","07:00:00","2021-05-07",348,40,47,165,43,643
"Newham","07:00:00","2021-05-07",1287,74,110,354,77,1902
"Wandsworth","07:00:00","2021-05-07",695,79,37,268,63,1142
"Barnet","08:00:00","2021-05-07",4446,108,21,1577,590,6742
"Hackney","08:00:00","2021-05-07",582,20,43,154,39,838
"Hammersmith and Fulham","08:00:00","2021-05-07",3088,152,26,1178,409,4853
"Kensington and Chelsea","08:00:00","2021-05-07",384,51,54,131,42,662
"Newham","08:00:00","2021-05-07",1802,86,112,354,89,2443
"Wandsworth","08:00:00","2021-05-07",701,96,29,197,77,1100
"Barnet","09:00:00","2021-05-07",4302,92,26,1619,635,6674
"Hackney","09:00:00","2021-05-07",566,27,41,179,41,854
"Hammersmith and Fulham","09:00:00","2021-05-07",2945,152,36,1178,462,4773
"Kensington and Chelsea","09:00:00","2021-05-07",366,57,54,134,41,652
"Newham","09:00:00","2021-05-07",1483,110,111,308,100,2112
"Wandsworth","09:00:00","2021-05-07",623,74,43,216,93,1049
"Barnet","10:00:00","2021-05-07",4321,61,21,1765,708,6876
"Hackney","10:00:00","2021-05-07",561,37,43,161,49,851
"Hammersmith and Fulham","10:00:00","2021-05-07",2872,108,20,1141,487,4628
"Kensington and Chelsea","10:00:00","2021-05-07",361,36,57,102,47,603
"Newham","10:00:00","2021-05-07",1401,150,100,329,109,2089
"Wandsworth","10:00:00","2021-05-07",657,79,29,239,89,1093
"Barnet","11:00:00","2021-05-07",4394,92,18,1655,674,6833
"Hackney","11:00:00","2021-05-07",555,40,40,157,37,829
"Hammersmith and Fulham","11:00:00","2021-05-07",2779,118,29,1022,466,4414
"Kensington and Chelsea","11:00:00","2021-05-07",333,41,50,103,43,570
"Newham","11:00:00","2021-05-07",1556,194,103,336,110,2299
"Wandsworth","11:00:00","2021-05-07",711,93,30,286,82,1202
"Barnet","12:00:00","2021-05-07",4613,102,19,1563,596,6893
"Hackney","12:00:00","2021-05-07",516,75,45,186,44,866
"Hammersmith and Fulham","12:00:00","2021-05-07",2848,109,21,933,384,4295
"Kensington and Chelsea","12:00:00","2021-05-07",351,52,53,90,30,576
"Newham","12:00:00","2021-05-07",1694,228,106,342,103,2473
"Wandsworth","12:00:00","2021-05-07",748,109,31,251,92,1231
"Barnet","13:00:00","2021-05-07",4644,107,20,1483,597,6851
"Hackney","13:00:00","2021-05-07",585,69,40,193,38,925
"Hammersmith and Fulham","13:00:00","2021-05-07",2901,123,32,952,401,4409
"Kensington and Chelsea","13:00:00","2021-05-07",317,54,44,102,27,544
"Newham","13:00:00","2021-05-07",1704,252,108,340,102,2506
"Wandsworth","13:00:00","2021-05-07",625,145,35,223,69,1097
"Barnet","14:00:00","2021-05-07",4951,108,24,1559,532,7174
"Hackney","14:00:00","2021-05-07",617,67,40,167,45,936
"Hammersmith and Fulham","14:00:00","2021-05-07",3068,139,33,939,359,4538
"Kensington and Chelsea","14:00:00","2021-05-07",407,55,47,85,34,628
"Newham","14:00:00","2021-05-07",2081,224,108,305,97,2815
"Wandsworth","14:00:00","2021-05-07",675,109,36,233,72,1125
"Barnet","15:00:00","2021-05-07",4979,123,35,1500,396,7033
"Hackney","15:00:00","2021-05-07",641,66,41,223,30,1001
"Hammersmith and Fulham","15:00:00","2021-05-07",3243,136,29,944,307,4659
"Kensington and Chelsea","15:00:00","2021-05-07",406,60,48,80,22,616
"Newham","15:00:00","2021-05-07",2213,213,94,302,68,2890
"Wandsworth","15:00:00","2021-05-07",721,119,27,188,39,1094
"Barnet","16:00:00","2021-05-07",5782,161,35,1583,286,7847
"Hackney","16:00:00","2021-05-07",693,61,37,130,18,939
"Hammersmith and Fulham","16:00:00","2021-05-07",3207,193,33,880,172,4485
"Kensington and Chelsea","16:00:00","2021-05-07",437,69,44,86,10,646
"Newham","16:00:00","2021-05-07",2264,282,97,285,56,2984
"Wandsworth","16:00:00","2021-05-07",666,112,35,134,37,984
"Barnet","17:00:00","2021-05-07",6066,200,40,1344,230,7880
"Hackney","17:00:00","2021-05-07",646,104,47,110,12,919
"Hammersmith and Fulham","17:00:00","2021-05-07",3241,218,27,706,114,4306
"Kensington and Chelsea","17:00:00","2021-05-07",427,66,40,58,7,598
"Newham","17:00:00","2021-05-07",2350,279,94,240,42,3005
"Wandsworth","17:00:00","2021-05-07",731,142,30,124,20,1047
"Barnet","18:00:00","2021-05-07",6104,144,33,998,199,7478
"Hackney","18:00:00","2021-05-07",734,105,41,82,11,973
"Hammersmith and Fulham","18:00:00","2021-05-07",3776,184,24,517,103,4604
"Kensington and Chelsea","18:00:00","2021-05-07",458,79,41,42,15,635
"Newham","18:00:00","2021-05-07",2064,344,93,194,45,2740
"Wandsworth","18:00:00","2021-05-07",817,224,30,94,12,1177
"Barnet","07:00:00","2021-05-10",432,6,33,120,11,602
"Bromley","07:00:00","2021-05-10",131,0,0,10,2,143
"Camden","07:00:00","2021-05-10",42,3,0,34,14,93
"Enfield","07:00:00","2021-05-10",57,0,0,25,6,88
"Merton","07:00:00","2021-05-10",236,6,0,46,4,292
"Tower Hamlets","07:00:00","2021-05-10",283,6,0,46,6,341
"Barnet","08:00:00","2021-05-10",514,2,24,56,6,602
"Bromley","08:00:00","2021-05-10",333,0,0,20,2,355
"Camden","08:00:00","2021-05-10",95,5,0,41,16,157
"Enfield","08:00:00","2021-05-10",119,6,2,15,2,144
"Merton","08:00:00","2021-05-10",253,5,0,28,6,292
"Tower Hamlets","08:00:00","2021-05-10",329,1,5,28,5,368
"Barnet","09:00:00","2021-05-10",406,4,25,69,8,512
"Bromley","09:00:00","2021-05-10",133,1,0,14,1,149
"Camden","09:00:00","2021-05-10",81,9,1,41,22,154
"Enfield","09:00:00","2021-05-10",85,1,0,18,0,104
"Merton","09:00:00","2021-05-10",151,4,0,39,9,203
"Tower Hamlets","09:00:00","2021-05-10",253,4,2,37,2,298
"Barnet","10:00:00","2021-05-10",297,4,20,59,7,387
"Bromley","10:00:00","2021-05-10",80,0,0,20,3,103
"Camden","10:00:00","2021-05-10",111,15,0,56,17,199
"Enfield","10:00:00","2021-05-10",57,8,0,11,4,80
"Merton","10:00:00","2021-05-10",125,3,0,31,5,164
"Tower Hamlets","10:00:00","2021-05-10",212,9,0,52,5,278
"Barnet","11:00:00","2021-05-10",295,2,22,48,9,376
"Bromley","11:00:00","2021-05-10",111,0,0,15,2,128
"Camden","11:00:00","2021-05-10",118,16,0,50,15,199
"Enfield","11:00:00","2021-05-10",64,0,0,14,3,81
"Merton","11:00:00","2021-05-10",101,6,0,30,6,143
"Tower Hamlets","11:00:00","2021-05-10",202,15,0,51,3,271
"Barnet","12:00:00","2021-05-10",347,4,20,57,6,434
"Bromley","12:00:00","2021-05-10",121,0,0,14,1,136
"Camden","12:00:00","2021-05-10",124,12,0,55,12,203
"Enfield","12:00:00","2021-05-10",66,6,0,14,2,88
"Merton","12:00:00","2021-05-10",153,6,0,47,3,209
"Tower Hamlets","12:00:00","2021-05-10",215,9,0,34,3,261
"Barnet","13:00:00","2021-05-10",331,3,24,61,4,423
"Bromley","13:00:00","2021-05-10",120,1,0,18,1,140
"Camden","13:00:00","2021-05-10",139,14,0,37,11,201
"Enfield","13:00:00","2021-05-10",99,8,0,8,2,117
"Merton","13:00:00","2021-05-10",141,14,0,32,4,191
"Tower Hamlets","13:00:00","2021-05-10",245,19,0,46,2,312
"Barnet","14:00:00","2021-05-10",396,3,26,59,7,491
"Bromley","14:00:00","2021-05-10",138,0,0,10,2,150
"Camden","14:00:00","2021-05-10",136,17,0,50,13,216
"Enfield","14:00:00","2021-05-10",105,6,1,8,1,121
"Merton","14:00:00","2021-05-10",159,5,0,27,3,194
"Tower Hamlets","14:00:00","2021-05-10",354,12,0,41,1,408
"Barnet","15:00:00","2021-05-10",536,4,30,58,6,634
"Bromley","15:00:00","2021-05-10",206,1,0,15,3,225
"Camden","15:00:00","2021-05-10",127,15,2,41,9,194
"Enfield","15:00:00","2021-05-10",143,3,3,11,0,160
"Merton","15:00:00","2021-05-10",225,8,0,28,3,264
"Tower Hamlets","15:00:00","2021-05-10",449,11,1,50,4,515
"Barnet","16:00:00","2021-05-10",587,6,27,76,2,698
"Bromley","16:00:00","2021-05-10",153,2,0,21,0,176
"Camden","16:00:00","2021-05-10",142,21,0,35,9,207
"Enfield","16:00:00","2021-05-10",141,10,0,13,0,164
"Merton","16:00:00","2021-05-10",246,9,0,35,5,295
"Tower Hamlets","16:00:00","2021-05-10",483,17,3,47,5,555
"Barnet","17:00:00","2021-05-10",617,7,24,84,10,742
"Bromley","17:00:00","2021-05-10",172,1,0,11,1,185
"Camden","17:00:00","2021-05-10",158,22,0,20,1,201
"Enfield","17:00:00","2021-05-10",117,6,0,12,1,136
"Merton","17:00:00","2021-05-10",208,10,0,33,2,253
"Tower Hamlets","17:00:00","2021-05-10",425,18,0,42,2,487
"Barnet","18:00:00","2021-05-10",546,6,26,43,1,622
"Bromley","18:00:00","2021-05-10",138,1,0,17,1,157
"Camden","18:00:00","2021-05-10",143,20,0,10,1,174
"Enfield","18:00:00","2021-05-10",114,15,0,10,1,140
"Merton","18:00:00","2021-05-10",166,8,0,23,0,197
"Tower Hamlets","18:00:00","2021-05-10",404,26,0,23,2,455
"Barnet","07:00:00","2021-05-11",168,2,2,34,4,210
"Croydon","07:00:00","2021-05-11",281,4,0,46,1,332
"Harrow","07:00:00","2021-05-11",699,8,50,154,29,940
"Hounslow","07:00:00","2021-05-11",949,37,25,240,60,1311
"Westminster","07:00:00","2021-05-11",374,55,57,219,57,762
"Barnet","08:00:00","2021-05-11",321,8,1,35,7,372
"Croydon","08:00:00","2021-05-11",234,4,0,28,2,268
"Harrow","08:00:00","2021-05-11",866,13,48,124,28,1079
"Hounslow","08:00:00","2021-05-11",1015,35,34,201,79,1364
"Westminster","08:00:00","2021-05-11",669,53,46,250,87,1105
"Barnet","09:00:00","2021-05-11",257,9,0,20,3,289
"Croydon","09:00:00","2021-05-11",238,2,0,38,2,280
"Harrow","09:00:00","2021-05-11",740,10,47,140,38,975
"Hounslow","09:00:00","2021-05-11",1017,40,44,229,63,1393
"Westminster","09:00:00","2021-05-11",560,54,60,270,113,1057
"Barnet","10:00:00","2021-05-11",204,2,2,47,5,260
"Croydon","10:00:00","2021-05-11",172,2,0,33,8,215
"Harrow","10:00:00","2021-05-11",718,8,48,110,39,923
"Hounslow","10:00:00","2021-05-11",929,31,32,213,76,1281
"Westminster","10:00:00","2021-05-11",443,50,54,257,87,891
"Barnet","11:00:00","2021-05-11",190,4,0,21,5,220
"Croydon","11:00:00","2021-05-11",202,0,0,28,2,232
"Harrow","11:00:00","2021-05-11",803,14,45,106,38,1006
"Hounslow","11:00:00","2021-05-11",934,22,27,229,77,1289
"Westminster","11:00:00","2021-05-11",531,61,51,297,92,1032
"Barnet","12:00:00","2021-05-11",262,14,0,37,7,320
"Croydon","12:00:00","2021-05-11",176,5,0,28,7,216
"Harrow","12:00:00","2021-05-11",784,32,48,124,29,1017
"Hounslow","12:00:00","2021-05-11",995,53,27,209,60,1344
"Westminster","12:00:00","2021-05-11",592,78,45,284,76,1075
"Barnet","13:00:00","2021-05-11",244,7,0,29,11,291
"Croydon","13:00:00","2021-05-11",181,2,0,33,8,224
"Harrow","13:00:00","2021-05-11",825,30,47,116,25,1043
"Hounslow","13:00:00","2021-05-11",1069,28,29,198,71,1395
"Westminster","13:00:00","2021-05-11",557,88,54,229,52,980
"Barnet","14:00:00","2021-05-11",260,21,0,39,7,327
"Croydon","14:00:00","2021-05-11",225,4,0,27,7,263
"Harrow","14:00:00","2021-05-11",821,24,44,103,28,1020
"Hounslow","14:00:00","2021-05-11",1145,48,44,199,64,1500
"Westminster","14:00:00","2021-05-11",693,83,48,181,57,1062
"Barnet","15:00:00","2021-05-11",296,10,0,39,2,347
"Croydon","15:00:00","2021-05-11",296,4,0,39,2,341
"Harrow","15:00:00","2021-05-11",888,20,45,90,29,1072
"Hounslow","15:00:00","2021-05-11",1213,35,34,207,61,1550
"Westminster","15:00:00","2021-05-11",777,86,66,201,32,1162
"Barnet","16:00:00","2021-05-11",314,12,3,43,4,376
"Croydon","16:00:00","2021-05-11",336,5,0,49,3,393
"Harrow","16:00:00","2021-05-11",913,24,45,98,14,1094
"Hounslow","16:00:00","2021-05-11",1208,46,32,187,45,1518
"Westminster","16:00:00","2021-05-11",733,99,71,214,19,1136
"Barnet","17:00:00","2021-05-11",306,14,2,31,2,355
"Croydon","17:00:00","2021-05-11",274,14,0,39,2,329
"Harrow","17:00:00","2021-05-11",921,33,49,131,13,1147
"Hounslow","17:00:00","2021-05-11",1314,41,33,180,31,1599
"Westminster","17:00:00","2021-05-11",729,103,70,125,19,1046
"Barnet","18:00:00","2021-05-11",258,15,0,14,2,289
"Croydon","18:00:00","2021-05-11",191,11,0,27,1,230
"Harrow","18:00:00","2021-05-11",881,40,48,105,12,1086
"Hounslow","18:00:00","2021-05-11",1275,44,32,123,16,1490
"Westminster","18:00:00","2021-05-11",694,148,73,71,24,1010
"Bexley","07:00:00","2021-05-12",1324,23,4,355,44,1750
"Camden","07:00:00","2021-05-12",287,29,67,135,29,547
"Hammersmith and Fulham","07:00:00","2021-05-12",19,0,0,6,0,25
"Hounslow","07:00:00","2021-05-12",1823,54,49,447,139,2512
"Merton","07:00:00","2021-05-12",793,47,19,291,30,1180
"Newham","07:00:00","2021-05-12",380,38,75,85,17,595
"Bexley","08:00:00","2021-05-12",1394,12,7,244,39,1696
"Camden","08:00:00","2021-05-12",371,29,70,145,57,672
"Hammersmith and Fulham","08:00:00","2021-05-12",42,0,0,9,0,51
"Hounslow","08:00:00","2021-05-12",1945,23,44,399,135,2546
"Merton","08:00:00","2021-05-12",778,42,23,233,39,1115
"Newham","08:00:00","2021-05-12",458,45,63,83,24,673
"Bexley","09:00:00","2021-05-12",1357,16,4,257,56,1690
"Camden","09:00:00","2021-05-12",359,29,71,141,55,655
"Hammersmith and Fulham","09:00:00","2021-05-12",28,0,0,16,2,46
"Hounslow","09:00:00","2021-05-12",1842,20,49,460,152,2523
"Merton","09:00:00","2021-05-12",671,25,24,222,51,993
"Newham","09:00:00","2021-05-12",383,35,65,68,27,578
"Bexley","10:00:00","2021-05-12",1173,7,7,241,61,1489
"Camden","10:00:00","2021-05-12",410,49,70,138,60,727
"Hammersmith and Fulham","10:00:00","2021-05-12",24,3,0,11,0,38
"Hounslow","10:00:00","2021-05-12",1583,35,40,358,161,2177
"Merton","10:00:00","2021-05-12",598,24,23,195,47,887
"Newham","10:00:00","2021-05-12",358,44,63,79,19,563
"Bexley","11:00:00","2021-05-12",1257,17,5,256,76,1611
"Camden","11:00:00","2021-05-12",447,83,64,156,50,800
"Hammersmith and Fulham","11:00:00","2021-05-12",24,2,0,5,2,33
"Hounslow","11:00:00","2021-05-12",1672,60,36,359,151,2278
"Merton","11:00:00","2021-05-12",599,36,19,204,56,914
"Newham","11:00:00","2021-05-12",347,49,60,57,20,533
"Bexley","12:00:00","2021-05-12",1416,25,4,275,65,1785
"Camden","12:00:00","2021-05-12",459,103,65,151,51,829
"Hammersmith and Fulham","12:00:00","2021-05-12",25,6,0,6,1,38
"Hounslow","12:00:00","2021-05-12",1860,57,37,344,157,2455
"Merton","12:00:00","2021-05-12",677,28,21,205,45,976
"Newham","12:00:00","2021-05-12",386,61,57,87,15,606
"Bexley","13:00:00","2021-05-12",1305,16,7,279,37,1644
"Camden","13:00:00","2021-05-12",430,121,63,190,42,846
"Hammersmith and Fulham","13:00:00","2021-05-12",34,8,0,10,1,53
"Hounslow","13:00:00","2021-05-12",2047,86,43,336,156,2668
"Merton","13:00:00","2021-05-12",625,37,18,180,50,910
"Newham","13:00:00","2021-05-12",429,80,64,71,20,664
"Bexley","14:00:00","2021-05-12",1489,16,9,250,46,1810
"Camden","14:00:00","2021-05-12",547,108,65,165,45,930
"Hammersmith and Fulham","14:00:00","2021-05-12",32,2,0,4,0,38
"Hounslow","14:00:00","2021-05-12",2065,60,45,386,137,2693
"Merton","14:00:00","2021-05-12",751,40,22,185,47,1045
"Newham","14:00:00","2021-05-12",466,65,57,64,10,662
"Bexley","15:00:00","2021-05-12",1508,11,6,324,35,1884
"Camden","15:00:00","2021-05-12",618,112,64,156,28,978
"Hammersmith and Fulham","15:00:00","2021-05-12",37,3,0,13,3,56
"Hounslow","15:00:00","2021-05-12",2240,72,46,418,110,2886
"Merton","15:00:00","2021-05-12",834,49,22,177,26,1108
"Newham","15:00:00","2021-05-12",494,71,58,63,17,703
"Bexley","16:00:00","2021-05-12",1538,27,3,348,38,1954
"Camden","16:00:00","2021-05-12",611,149,64,176,40,1040
"Hammersmith and Fulham","16:00:00","2021-05-12",38,8,0,6,2,54
"Hounslow","16:00:00","2021-05-12",2333,85,50,338,67,2873
"Merton","16:00:00","2021-05-12",739,62,18,162,28,1009
"Newham","16:00:00","2021-05-12",502,82,62,65,10,721
"Bexley","17:00:00","2021-05-12",1629,29,4,238,19,1919
"Camden","17:00:00","2021-05-12",701,140,56,123,13,1033
"Hammersmith and Fulham","17:00:00","2021-05-12",22,3,0,3,0,28
"Hounslow","17:00:00","2021-05-12",2519,88,38,277,44,2966
"Merton","17:00:00","2021-05-12",839,60,20,163,21,1103
"Newham","17:00:00","2021-05-12",532,98,58,60,7,755
"Bexley","18:00:00","2021-05-12",1588,20,7,206,13,1834
"Camden","18:00:00","2021-05-12",666,163,60,83,18,990
"Hammersmith and Fulham","18:00:00","2021-05-12",33,2,0,2,0,37
"Hounslow","18:00:00","2021-05-12",2432,82,38,248,35,2835
"Merton","18:00:00","2021-05-12",853,63,22,132,10,1080
"Newham","18:00:00","2021-05-12",509,109,57,42,9,726
"Brent","07:00:00","2021-05-13",408,38,50,155,7,658
"Bromley","07:00:00","2021-05-13",467,5,3,153,5,633
"Greenwich","07:00:00","2021-05-13",404,4,31,90,16,545
"Hillingdon","07:00:00","2021-05-13",20,0,0,4,1,25
"Islington","07:00:00","2021-05-13",726,103,56,307,113,1305
"Merton","07:00:00","2021-05-13",655,25,0,187,43,910
"Tower Hamlets","07:00:00","2021-05-13",1548,220,58,637,165,2628
"Westminster","07:00:00","2021-05-13",62,3,0,14,4,83
"Brent","08:00:00","2021-05-13",453,41,44,117,13,668
"Bromley","08:00:00","2021-05-13",599,2,1,148,7,757
"Greenwich","08:00:00","2021-05-13",548,2,33,94,12,689
"Hillingdon","08:00:00","2021-05-13",24,0,0,6,1,31
"Islington","08:00:00","2021-05-13",660,83,65,287,81,1176
"Merton","08:00:00","2021-05-13",596,8,2,191,49,846
"Tower Hamlets","08:00:00","2021-05-13",1772,136,44,559,208,2719
"Wandsworth","08:00:00","2021-05-13",2990,140,34,760,144,4068
"Westminster","08:00:00","2021-05-13",117,1,0,37,5,160
"Brent","09:00:00","2021-05-13",399,33,44,109,12,597
"Bromley","09:00:00","2021-05-13",476,1,1,115,10,603
"Greenwich","09:00:00","2021-05-13",438,4,38,90,13,583
"Hillingdon","09:00:00","2021-05-13",16,0,0,5,2,23
"Islington","09:00:00","2021-05-13",653,65,69,275,103,1165
"Merton","09:00:00","2021-05-13",583,12,3,166,52,816
"Tower Hamlets","09:00:00","2021-05-13",1565,111,38,549,193,2456
"Wandsworth","09:00:00","2021-05-13",2917,95,39,738,161,3950
"Westminster","09:00:00","2021-05-13",71,2,0,24,2,99
"Brent","10:00:00","2021-05-13",382,28,45,120,17,592
"Bromley","10:00:00","2021-05-13",376,0,2,110,14,502
"Greenwich","10:00:00","2021-05-13",385,5,26,80,20,516
"Hillingdon","10:00:00","2021-05-13",17,4,0,3,1,25
"Islington","10:00:00","2021-05-13",545,72,65,254,97,1033
"Merton","10:00:00","2021-05-13",657,7,3,163,72,902
"Tower Hamlets","10:00:00","2021-05-13",1527,95,42,492,260,2416
"Wandsworth","10:00:00","2021-05-13",2794,82,35,755,185,3851
"Westminster","10:00:00","2021-05-13",58,1,0,13,2,74
"Brent","11:00:00","2021-05-13",395,26,48,120,19,608
"Bromley","11:00:00","2021-05-13",359,0,2,83,12,456
"Greenwich","11:00:00","2021-05-13",351,4,27,74,20,476
"Hillingdon","11:00:00","2021-05-13",15,0,0,4,0,19
"Islington","11:00:00","2021-05-13",633,89,50,213,82,1067
"Merton","11:00:00","2021-05-13",632,13,0,155,60,860
"Tower Hamlets","11:00:00","2021-05-13",1605,119,42,517,188,2471
"Wandsworth","11:00:00","2021-05-13",2729,72,28,820,191,3840
"Westminster","11:00:00","2021-05-13",74,1,0,17,2,94
"Brent","12:00:00","2021-05-13",427,38,44,104,8,621
"Bromley","12:00:00","2021-05-13",352,3,1,87,9,452
"Greenwich","12:00:00","2021-05-13",356,7,28,87,14,492
"Hillingdon","12:00:00","2021-05-13",26,1,0,8,0,35
"Islington","12:00:00","2021-05-13",648,113,59,231,65,1116
"Merton","12:00:00","2021-05-13",624,5,0,170,66,865
"Tower Hamlets","12:00:00","2021-05-13",1740,123,36,498,165,2562
"Wandsworth","12:00:00","2021-05-13",2827,94,38,731,183,3873
"Westminster","12:00:00","2021-05-13",104,3,0,26,3,136
"Brent","13:00:00","2021-05-13",439,40,48,114,15,656
"Bromley","13:00:00","2021-05-13",371,0,1,116,16,504
"Greenwich","13:00:00","2021-05-13",437,5,26,73,17,558
"Hillingdon","13:00:00","2021-05-13",19,0,0,6,0,25
"Islington","13:00:00","2021-05-13",582,120,51,192,59,1004
"Merton","13:00:00","2021-05-13",667,12,2,166,46,893
"Tower Hamlets","13:00:00","2021-05-13",1803,131,40,506,170,2650
"Wandsworth","13:00:00","2021-05-13",2922,80,34,731,181,3948
"Westminster","13:00:00","2021-05-13",96,4,0,17,0,117
"Brent","14:00:00","2021-05-13",526,45,45,92,12,720
"Bromley","14:00:00","2021-05-13",442,2,2,137,12,595
"Greenwich","14:00:00","2021-05-13",492,7,34,95,10,638
"Hillingdon","14:00:00","2021-05-13",25,1,0,8,1,35
"Islington","14:00:00","2021-05-13",614,98,54,158,54,978
"Merton","14:00:00","2021-05-13",681,13,1,152,43,890
"Tower Hamlets","14:00:00","2021-05-13",1936,159,39,504,146,2784
"Wandsworth","14:00:00","2021-05-13",3241,85,36,907,156,4425
"Westminster","14:00:00","2021-05-13",96,4,0,24,1,125
"Brent","15:00:00","2021-05-13",576,30,46,114,12,778
"Bromley","15:00:00","2021-05-13",464,2,2,149,12,629
"Greenwich","15:00:00","2021-05-13",547,4,34,99,10,694
"Hillingdon","15:00:00","2021-05-13",33,1,0,5,1,40
"Islington","15:00:00","2021-05-13",654,90,62,175,69,1050
"Merton","15:00:00","2021-05-13",696,12,1,153,52,914
"Tower Hamlets","15:00:00","2021-05-13",1911,164,48,522,118,2763
"Westminster","15:00:00","2021-05-13",127,6,0,21,0,154
"Brent","16:00:00","2021-05-13",610,55,45,155,14,879
"Bromley","16:00:00","2021-05-13",495,5,1,165,11,677
"Greenwich","16:00:00","2021-05-13",554,14,29,58,9,664
"Hillingdon","16:00:00","2021-05-13",31,0,0,5,0,36
"Islington","16:00:00","2021-05-13",744,111,53,182,45,1135
"Merton","16:00:00","2021-05-13",750,22,0,131,38,941
"Tower Hamlets","16:00:00","2021-05-13",1738,225,53,359,89,2464
"Westminster","16:00:00","2021-05-13",127,3,0,21,0,151
"Brent","17:00:00","2021-05-13",643,46,48,129,7,873
"Bromley","17:00:00","2021-05-13",569,3,2,97,6,677
"Greenwich","17:00:00","2021-05-13",580,5,28,53,7,673
"Hillingdon","17:00:00","2021-05-13",33,0,0,8,0,41
"Islington","17:00:00","2021-05-13",1025,167,47,162,40,1441
"Merton","17:00:00","2021-05-13",795,22,0,136,27,980
"Tower Hamlets","17:00:00","2021-05-13",2032,243,51,323,69,2718
"Westminster","17:00:00","2021-05-13",138,5,0,14,0,157
"Brent","18:00:00","2021-05-13",655,86,43,56,2,842
"Bromley","18:00:00","2021-05-13",381,3,1,39,4,428
"Greenwich","18:00:00","2021-05-13",499,8,28,45,5,585
"Hillingdon","18:00:00","2021-05-13",34,1,0,3,1,39
"Islington","18:00:00","2021-05-13",1071,176,60,156,31,1494
"Merton","18:00:00","2021-05-13",782,28,2,119,22,953
"Tower Hamlets","18:00:00","2021-05-13",2367,251,46,286,49,2999
"Westminster","18:00:00","2021-05-13",122,7,0,7,4,140
"Brent","07:00:00","2021-05-14",199,22,17,69,17,324
"Bromley","07:00:00","2021-05-14",30,0,0,8,1,39
"Brent","08:00:00","2021-05-14",333,20,21,51,21,446
"Bromley","08:00:00","2021-05-14",47,3,0,12,0,62
"Brent","09:00:00","2021-05-14",222,30,17,71,14,354
"Bromley","09:00:00","2021-05-14",49,1,0,8,1,59
"Brent","10:00:00","2021-05-14",205,38,16,57,24,340
"Bromley","10:00:00","2021-05-14",25,3,0,11,5,44
"Brent","11:00:00","2021-05-14",224,40,17,57,25,363
"Bromley","11:00:00","2021-05-14",33,3,0,15,1,52
"Brent","12:00:00","2021-05-14",258,43,18,56,13,388
"Bromley","12:00:00","2021-05-14",34,2,0,11,1,48
"Brent","13:00:00","2021-05-14",232,49,15,50,18,364
"Bromley","13:00:00","2021-05-14",40,4,0,12,0,56
"Brent","14:00:00","2021-05-14",308,45,17,55,13,438
"Bromley","14:00:00","2021-05-14",49,6,0,4,1,60
"Brent","15:00:00","2021-05-14",344,54,17,71,9,495
"Bromley","15:00:00","2021-05-14",78,6,0,7,0,91
"Brent","16:00:00","2021-05-14",370,52,17,73,5,517
"Bromley","16:00:00","2021-05-14",44,1,0,11,0,56
"Brent","17:00:00","2021-05-14",387,59,19,58,9,532
"Bromley","17:00:00","2021-05-14",40,3,0,6,1,50
"Brent","18:00:00","2021-05-14",372,99,16,33,2,522
"Bromley","18:00:00","2021-05-14",54,11,0,4,3,72
"Ealing","07:00:00","2021-05-17",1121,51,33,365,92,1662
"Hillingdon","07:00:00","2021-05-17",119,0,0,23,2,144
"Hounslow","07:00:00","2021-05-17",3081,56,71,702,161,4071
"Kensington and Chelsea","07:00:00","2021-05-17",534,51,76,190,37,888
"Ealing","08:00:00","2021-05-17",1258,29,21,285,107,1700
"Hillingdon","08:00:00","2021-05-17",285,1,1,28,6,321
"Hounslow","08:00:00","2021-05-17",3847,32,61,615,176,4731
"Kensington and Chelsea","08:00:00","2021-05-17",815,76,71,177,39,1178
"Ealing","09:00:00","2021-05-17",1235,36,32,373,104,1780
"Hillingdon","09:00:00","2021-05-17",147,5,0,22,5,179
"Hounslow","09:00:00","2021-05-17",2593,46,53,538,167,3397
"Kensington and Chelsea","09:00:00","2021-05-17",700,68,71,185,41,1065
"Ealing","10:00:00","2021-05-17",1161,48,27,372,143,1751
"Hillingdon","10:00:00","2021-05-17",100,6,0,18,3,127
"Hounslow","10:00:00","2021-05-17",2030,28,48,486,166,2758
"Kensington and Chelsea","10:00:00","2021-05-17",690,70,67,198,43,1068
"Ealing","11:00:00","2021-05-17",1113,67,26,338,147,1691
"Hillingdon","11:00:00","2021-05-17",125,7,0,14,5,151
"Hounslow","11:00:00","2021-05-17",2144,35,45,483,154,2861
"Kensington and Chelsea","11:00:00","2021-05-17",697,84,72,188,36,1077
"Ealing","12:00:00","2021-05-17",1220,63,27,329,150,1789
"Hillingdon","12:00:00","2021-05-17",129,0,0,15,1,145
"Hounslow","12:00:00","2021-05-17",2423,45,44,468,166,3146
"Kensington and Chelsea","12:00:00","2021-05-17",691,100,75,183,38,1087
"Ealing","13:00:00","2021-05-17",1320,59,28,329,151,1887
"Hillingdon","13:00:00","2021-05-17",131,4,0,26,4,165
"Hounslow","13:00:00","2021-05-17",2445,62,51,486,153,3197
"Kensington and Chelsea","13:00:00","2021-05-17",690,121,74,157,32,1074
"Ealing","14:00:00","2021-05-17",1407,59,27,314,119,1926
"Hillingdon","14:00:00","2021-05-17",173,1,0,21,6,201
"Hounslow","14:00:00","2021-05-17",2813,59,54,505,139,3570
"Kensington and Chelsea","14:00:00","2021-05-17",707,89,77,137,30,1040
"Ealing","15:00:00","2021-05-17",1408,61,26,312,108,1915
"Hillingdon","15:00:00","2021-05-17",256,1,0,27,2,286
"Hounslow","15:00:00","2021-05-17",3507,52,62,538,139,4298
"Kensington and Chelsea","15:00:00","2021-05-17",799,92,72,158,20,1141
"Ealing","16:00:00","2021-05-17",1444,83,26,316,62,1931
"Hillingdon","16:00:00","2021-05-17",168,0,1,38,2,209
"Hounslow","16:00:00","2021-05-17",3289,92,62,467,93,4003
"Kensington and Chelsea","16:00:00","2021-05-17",822,88,77,112,12,1111
"Ealing","17:00:00","2021-05-17",1473,74,22,293,48,1910
"Hillingdon","17:00:00","2021-05-17",165,4,0,30,2,201
"Hounslow","17:00:00","2021-05-17",3549,110,57,475,75,4266
"Kensington and Chelsea","17:00:00","2021-05-17",748,101,72,60,11,992
"Ealing","18:00:00","2021-05-17",1488,86,29,220,48,1871
"Hillingdon","18:00:00","2021-05-17",149,3,0,15,0,167
"Hounslow","18:00:00","2021-05-17",3078,80,50,312,45,3565
"Kensington and Chelsea","18:00:00","2021-05-17",907,103,76,57,2,1145
"City of London","07:00:00","2021-05-18",55,2,0,6,4,67
"Haringey","07:00:00","2021-05-18",41,2,0,10,1,54
"Kingston upon Thames","07:00:00","2021-05-18",2047,79,77,471,68,2742
"Waltham Forest","07:00:00","2021-05-18",140,2,0,34,3,179
"City of London","08:00:00","2021-05-18",50,2,0,9,7,68
"Haringey","08:00:00","2021-05-18",67,5,0,13,2,87
"Kingston upon Thames","08:00:00","2021-05-18",2126,61,77,327,75,2666
"Waltham Forest","08:00:00","2021-05-18",266,7,0,44,5,322
"City of London","09:00:00","2021-05-18",38,2,0,17,5,62
"Haringey","09:00:00","2021-05-18",39,6,1,13,3,62
"Kingston upon Thames","09:00:00","2021-05-18",1803,62,76,361,98,2400
"Waltham Forest","09:00:00","2021-05-18",168,3,0,42,8,221
"City of London","10:00:00","2021-05-18",19,2,0,15,7,43
"Haringey","10:00:00","2021-05-18",62,6,2,21,1,92
"Kingston upon Thames","10:00:00","2021-05-18",1562,57,72,325,106,2122
"Waltham Forest","10:00:00","2021-05-18",179,3,0,24,8,214
"City of London","11:00:00","2021-05-18",17,2,0,12,3,34
"Haringey","11:00:00","2021-05-18",62,4,0,15,3,84
"Kingston upon Thames","11:00:00","2021-05-18",1649,61,70,343,96,2219
"Waltham Forest","11:00:00","2021-05-18",154,4,0,33,6,197
"City of London","12:00:00","2021-05-18",23,3,0,15,1,42
"Haringey","12:00:00","2021-05-18",55,11,0,10,2,78
"Kingston upon Thames","12:00:00","2021-05-18",1639,73,72,299,94,2177
"Waltham Forest","12:00:00","2021-05-18",175,7,0,22,9,213
"City of London","13:00:00","2021-05-18",23,1,0,8,4,36
"Haringey","13:00:00","2021-05-18",50,5,0,14,3,72
"Kingston upon Thames","13:00:00","2021-05-18",1737,79,74,301,84,2275
"Waltham Forest","13:00:00","2021-05-18",182,5,0,25,5,217
"City of London","14:00:00","2021-05-18",24,7,0,11,6,48
"Haringey","14:00:00","2021-05-18",74,4,1,18,0,97
"Kingston upon Thames","14:00:00","2021-05-18",1763,53,84,298,73,2271
"Waltham Forest","14:00:00","2021-05-18",222,5,1,42,5,275
"City of London","15:00:00","2021-05-18",34,2,0,9,2,47
"Haringey","15:00:00","2021-05-18",84,7,1,17,2,111
"Kingston upon Thames","15:00:00","2021-05-18",1983,50,77,311,50,2471
"Waltham Forest","15:00:00","2021-05-18",222,8,0,40,4,274
"City of London","16:00:00","2021-05-18",53,3,0,11,1,68
"Haringey","16:00:00","2021-05-18",93,5,0,23,0,121
"Kingston upon Thames","16:00:00","2021-05-18",2176,80,65,345,35,2701
"Waltham Forest","16:00:00","2021-05-18",220,10,0,40,7,277
"City of London","17:00:00","2021-05-18",86,1,0,5,0,92
"Haringey","17:00:00","2021-05-18",106,12,0,14,1,133
"Kingston upon Thames","17:00:00","2021-05-18",2249,101,67,281,39,2737
"Waltham Forest","17:00:00","2021-05-18",256,12,0,25,3,296
"City of London","18:00:00","2021-05-18",146,5,0,5,2,158
"Haringey","18:00:00","2021-05-18",84,14,0,8,1,107
"Kingston upon Thames","18:00:00","2021-05-18",2064,97,77,182,35,2455
"Waltham Forest","18:00:00","2021-05-18",221,12,0,32,3,268
"Barnet","07:00:00","2021-05-19",116,1,0,15,0,132
"Bexley","07:00:00","2021-05-19",64,0,0,6,1,71
"Croydon","07:00:00","2021-05-19",146,1,1,27,2,177
"Hounslow","07:00:00","2021-05-19",36,1,0,9,0,46
"Islington","07:00:00","2021-05-19",548,19,57,197,37,858
"Lambeth","07:00:00","2021-05-19",1279,79,79,492,81,2010
"Barnet","08:00:00","2021-05-19",268,3,1,17,4,293
"Bexley","08:00:00","2021-05-19",95,0,0,12,0,107
"Croydon","08:00:00","2021-05-19",250,0,2,21,2,275
"Hounslow","08:00:00","2021-05-19",34,0,0,2,0,36
"Islington","08:00:00","2021-05-19",609,35,59,189,49,941
"Lambeth","08:00:00","2021-05-19",1176,86,65,329,68,1724
"Barnet","09:00:00","2021-05-19",151,2,1,18,4,176
"Bexley","09:00:00","2021-05-19",69,1,1,8,0,79
"Croydon","09:00:00","2021-05-19",131,0,1,17,3,152
"Hounslow","09:00:00","2021-05-19",25,0,0,4,0,29
"Islington","09:00:00","2021-05-19",646,29,68,199,51,993
"Lambeth","09:00:00","2021-05-19",1015,59,68,365,100,1607
"Barnet","10:00:00","2021-05-19",58,0,0,10,0,68
"Bexley","10:00:00","2021-05-19",49,0,0,7,0,56
"Croydon","10:00:00","2021-05-19",64,6,0,24,1,95
"Hounslow","10:00:00","2021-05-19",19,0,0,10,0,29
"Islington","10:00:00","2021-05-19",574,23,61,211,87,956
"Lambeth","10:00:00","2021-05-19",935,83,61,368,110,1557
"Barnet","11:00:00","2021-05-19",99,2,0,14,3,118
"Bexley","11:00:00","2021-05-19",65,0,0,5,6,76
"Croydon","11:00:00","2021-05-19",80,0,0,10,2,92
"Hounslow","11:00:00","2021-05-19",23,0,0,8,0,31
"Islington","11:00:00","2021-05-19",617,53,55,212,80,1017
"Lambeth","11:00:00","2021-05-19",1014,67,53,423,97,1654
"Barnet","12:00:00","2021-05-19",94,1,0,15,1,111
"Bexley","12:00:00","2021-05-19",48,0,0,8,2,58
"Croydon","12:00:00","2021-05-19",83,1,0,17,1,102
"Hounslow","12:00:00","2021-05-19",18,2,0,9,0,29
"Islington","12:00:00","2021-05-19",628,70,58,245,70,1071
"Lambeth","12:00:00","2021-05-19",960,87,59,416,86,1608
"Barnet","13:00:00","2021-05-19",87,4,0,15,2,108
"Bexley","13:00:00","2021-05-19",61,0,0,7,0,68
"Croydon","13:00:00","2021-05-19",69,6,0,15,3,93
"Hounslow","13:00:00","2021-05-19",33,2,0,11,0,46
"Islington","13:00:00","2021-05-19",642,75,55,248,58,1078
"Lambeth","13:00:00","2021-05-19",1073,109,55,414,110,1761
"Barnet","14:00:00","2021-05-19",170,2,0,15,3,190
"Bexley","14:00:00","2021-05-19",79,2,0,13,0,94
"Croydon","14:00:00","2021-05-19",155,1,1,28,4,189
"Hounslow","14:00:00","2021-05-19",34,1,0,7,0,42
"Islington","14:00:00","2021-05-19",727,68,59,261,55,1170
"Lambeth","14:00:00","2021-05-19",1143,76,62,385,84,1750
"Barnet","15:00:00","2021-05-19",278,5,0,28,2,313
"Bexley","15:00:00","2021-05-19",82,0,0,14,0,96
"Croydon","15:00:00","2021-05-19",240,4,4,44,7,299
"Hounslow","15:00:00","2021-05-19",49,0,0,7,1,57
"Islington","15:00:00","2021-05-19",720,75,67,273,66,1201
"Lambeth","15:00:00","2021-05-19",1109,103,56,389,67,1724
"Barnet","16:00:00","2021-05-19",274,2,0,32,2,310
"Bexley","16:00:00","2021-05-19",67,0,2,6,2,77
"Croydon","16:00:00","2021-05-19",175,1,0,23,1,200
"Hounslow","16:00:00","2021-05-19",29,0,0,12,1,42
"Islington","16:00:00","2021-05-19",788,103,58,274,36,1259
"Lambeth","16:00:00","2021-05-19",1337,118,82,408,37,1982
"Barnet","17:00:00","2021-05-19",345,2,0,44,1,392
"Bexley","17:00:00","2021-05-19",86,1,0,4,0,91
"Croydon","17:00:00","2021-05-19",155,3,0,23,2,183
"Hounslow","17:00:00","2021-05-19",27,1,0,6,1,35
"Islington","17:00:00","2021-05-19",797,140,66,179,25,1207
"Lambeth","17:00:00","2021-05-19",1509,158,51,334,27,2079
"Barnet","18:00:00","2021-05-19",262,5,0,13,3,283
"Bexley","18:00:00","2021-05-19",88,0,0,7,2,97
"Croydon","18:00:00","2021-05-19",136,5,0,14,1,156
"Hounslow","18:00:00","2021-05-19",41,0,0,2,1,44
"Islington","18:00:00","2021-05-19",910,160,56,147,13,1286
"Lambeth","18:00:00","2021-05-19",1463,167,55,224,29,1938
"Bexley","07:00:00","2021-05-20",478,3,0,126,13,620
"Bromley","07:00:00","2021-05-20",1221,22,11,351,122,1727
"Enfield","07:00:00","2021-05-20",21,0,0,4,2,27
"Greenwich","07:00:00","2021-05-20",12,0,0,3,0,15
"Hackney","07:00:00","2021-05-20",1122,118,85,425,142,1892
"Havering","07:00:00","2021-05-20",44,0,0,9,1,54
"Hounslow","07:00:00","2021-05-20",1018,30,44,273,44,1409
"Kingston upon Thames","07:00:00","2021-05-20",965,51,106,239,41,1402
"Lambeth","07:00:00","2021-05-20",1239,78,26,426,61,1830
"Merton","07:00:00","2021-05-20",3499,154,35,1247,181,5116
"Newham","07:00:00","2021-05-20",550,14,12,128,87,791
"Sutton","07:00:00","2021-05-20",1153,17,39,320,18,1547
"Bexley","08:00:00","2021-05-20",727,2,0,107,11,847
"Bromley","08:00:00","2021-05-20",1301,8,7,267,120,1703
"Enfield","08:00:00","2021-05-20",30,0,0,2,2,34
"Greenwich","08:00:00","2021-05-20",34,0,0,3,0,37
"Hackney","08:00:00","2021-05-20",1340,80,74,388,112,1994
"Havering","08:00:00","2021-05-20",137,0,0,12,1,150
"Hounslow","08:00:00","2021-05-20",885,13,41,153,40,1132
"Kingston upon Thames","08:00:00","2021-05-20",1015,28,111,111,55,1320
"Lambeth","08:00:00","2021-05-20",1234,57,29,260,72,1652
"Merton","08:00:00","2021-05-20",3539,130,19,876,165,4729
"Newham","08:00:00","2021-05-20",753,8,23,136,95,1015
"Sutton","08:00:00","2021-05-20",1161,26,35,222,23,1467
"Bexley","09:00:00","2021-05-20",406,9,1,92,17,525
"Bromley","09:00:00","2021-05-20",1314,4,5,293,154,1770
"Enfield","09:00:00","2021-05-20",33,0,0,3,1,37
"Greenwich","09:00:00","2021-05-20",10,0,0,2,0,12
"Hackney","09:00:00","2021-05-20",1213,92,70,449,157,1981
"Havering","09:00:00","2021-05-20",82,0,0,18,1,101
"Hounslow","09:00:00","2021-05-20",983,25,43,207,50,1308
"Kingston upon Thames","09:00:00","2021-05-20",939,33,117,168,70,1327
"Lambeth","09:00:00","2021-05-20",1067,45,21,301,77,1511
"Merton","09:00:00","2021-05-20",3266,69,18,823,156,4332
"Newham","09:00:00","2021-05-20",427,10,12,127,84,660
"Sutton","09:00:00","2021-05-20",1033,30,33,211,34,1341
"Bexley","10:00:00","2021-05-20",326,3,0,59,14,402
"Bromley","10:00:00","2021-05-20",1263,9,7,273,118,1670
"Enfield","10:00:00","2021-05-20",21,2,0,1,3,27
"Greenwich","10:00:00","2021-05-20",15,0,0,2,2,19
"Hackney","10:00:00","2021-05-20",1254,85,72,424,128,1963
"Havering","10:00:00","2021-05-20",43,0,0,12,6,61
"Hounslow","10:00:00","2021-05-20",1033,15,39,234,63,1384
"Kingston upon Thames","10:00:00","2021-05-20",998,33,113,165,73,1382
"Lambeth","10:00:00","2021-05-20",980,38,20,336,101,1475
"Merton","10:00:00","2021-05-20",2999,60,16,719,185,3979
"Newham","10:00:00","2021-05-20",381,7,14,110,76,588
"Sutton","10:00:00","2021-05-20",1035,22,34,218,33,1342
"Bexley","11:00:00","2021-05-20",364,11,0,65,14,454
"Bromley","11:00:00","2021-05-20",1256,9,1,248,117,1631
"Enfield","11:00:00","2021-05-20",16,1,0,10,1,28
"Greenwich","11:00:00","2021-05-20",16,0,0,2,0,18
"Hackney","11:00:00","2021-05-20",1196,117,74,392,120,1899
"Havering","11:00:00","2021-05-20",62,0,0,15,0,77
"Hounslow","11:00:00","2021-05-20",987,20,31,242,61,1341
"Kingston upon Thames","11:00:00","2021-05-20",935,48,108,158,60,1309
"Lambeth","11:00:00","2021-05-20",956,33,16,352,99,1456
"Merton","11:00:00","2021-05-20",2947,53,13,807,181,4001
"Newham","11:00:00","2021-05-20",412,10,14,134,77,647
"Sutton","11:00:00","2021-05-20",1010,29,37,231,25,1332
"Bexley","12:00:00","2021-05-20",391,15,0,80,15,501
"Bromley","12:00:00","2021-05-20",1294,8,6,256,127,1691
"Enfield","12:00:00","2021-05-20",24,1,0,5,1,31
"Greenwich","12:00:00","2021-05-20",21,0,0,1,1,23
"Hackney","12:00:00","2021-05-20",1250,92,72,429,103,1946
"Havering","12:00:00","2021-05-20",67,0,0,10,1,78
"Hounslow","12:00:00","2021-05-20",1091,29,39,236,77,1472
"Kingston upon Thames","12:00:00","2021-05-20",999,51,108,176,62,1396
"Lambeth","12:00:00","2021-05-20",988,46,17,339,94,1484
"Merton","12:00:00","2021-05-20",3036,55,29,774,166,4060
"Newham","12:00:00","2021-05-20",505,26,14,131,72,748
"Sutton","12:00:00","2021-05-20",1112,31,31,235,29,1438
"Bexley","13:00:00","2021-05-20",383,17,1,81,9,491
"Bromley","13:00:00","2021-05-20",1238,6,7,244,123,1618
"Enfield","13:00:00","2021-05-20",26,0,0,6,0,32
"Greenwich","13:00:00","2021-05-20",24,0,0,2,0,26
"Hackney","13:00:00","2021-05-20",1354,103,77,379,115,2028
"Havering","13:00:00","2021-05-20",64,0,0,9,1,74
"Hounslow","13:00:00","2021-05-20",1072,35,38,214,68,1427
"Kingston upon Thames","13:00:00","2021-05-20",1013,59,118,165,51,1406
"Lambeth","13:00:00","2021-05-20",1027,58,20,332,92,1529
"Merton","13:00:00","2021-05-20",2961,61,16,794,171,4003
"Newham","13:00:00","2021-05-20",525,16,14,133,50,738
"Sutton","13:00:00","2021-05-20",1132,33,31,247,30,1473
"Bexley","14:00:00","2021-05-20",457,15,1,84,18,575
"Bromley","14:00:00","2021-05-20",1337,11,6,269,112,1735
"Enfield","14:00:00","2021-05-20",25,0,0,5,0,30
"Greenwich","14:00:00","2021-05-20",18,1,0,2,1,22
"Hackney","14:00:00","2021-05-20",1365,102,70,391,111,2039
"Havering","14:00:00","2021-05-20",75,1,0,8,1,85
"Hounslow","14:00:00","2021-05-20",1112,31,38,228,46,1455
"Kingston upon Thames","14:00:00","2021-05-20",974,55,112,173,37,1351
"Lambeth","14:00:00","2021-05-20",1023,38,20,372,87,1540
"Merton","14:00:00","2021-05-20",3325,62,17,924,166,4494
"Newham","14:00:00","2021-05-20",594,18,17,152,61,842
"Sutton","14:00:00","2021-05-20",1162,42,36,248,21,1509
"Bexley","15:00:00","2021-05-20",622,14,1,88,13,738
"Bromley","15:00:00","2021-05-20",1438,8,5,297,87,1835
"Enfield","15:00:00","2021-05-20",33,0,0,4,0,37
"Greenwich","15:00:00","2021-05-20",43,1,2,3,0,49
"Hackney","15:00:00","2021-05-20",1437,127,72,420,94,2150
"Havering","15:00:00","2021-05-20",89,0,0,10,0,99
"Hounslow","15:00:00","2021-05-20",1029,35,44,199,26,1333
"Kingston upon Thames","15:00:00","2021-05-20",1016,59,109,145,36,1365
"Lambeth","15:00:00","2021-05-20",1178,63,22,317,43,1623
"Merton","15:00:00","2021-05-20",3693,75,23,1036,129,4956
"Newham","15:00:00","2021-05-20",774,18,16,147,57,1012
"Sutton","15:00:00","2021-05-20",1171,42,37,222,16,1488
"Bexley","16:00:00","2021-05-20",629,12,0,104,5,750
"Bromley","16:00:00","2021-05-20",1467,12,5,287,53,1824
"Enfield","16:00:00","2021-05-20",33,2,0,1,2,38
"Greenwich","16:00:00","2021-05-20",26,0,0,3,0,29
"Hackney","16:00:00","2021-05-20",1461,126,80,394,77,2138
"Havering","16:00:00","2021-05-20",73,0,0,14,1,88
"Hounslow","16:00:00","2021-05-20",1223,31,41,177,22,1494
"Kingston upon Thames","16:00:00","2021-05-20",1045,56,112,166,24,1403
"Lambeth","16:00:00","2021-05-20",1282,86,32,361,43,1804
"Merton","16:00:00","2021-05-20",3913,115,29,1083,81,5221
"Newham","16:00:00","2021-05-20",897,27,19,192,40,1175
"Sutton","16:00:00","2021-05-20",1165,41,37,255,17,1515
"Bexley","17:00:00","2021-05-20",646,11,0,91,11,759
"Bromley","17:00:00","2021-05-20",1664,13,6,219,32,1934
"Enfield","17:00:00","2021-05-20",32,2,0,6,0,40
"Greenwich","17:00:00","2021-05-20",20,0,0,5,1,26
"Hackney","17:00:00","2021-05-20",1546,161,77,283,40,2107
"Havering","17:00:00","2021-05-20",104,0,0,10,0,114
"Hounslow","17:00:00","2021-05-20",1181,44,35,160,16,1436
"Kingston upon Thames","17:00:00","2021-05-20",1082,71,111,156,17,1437
"Lambeth","17:00:00","2021-05-20",1465,104,17,364,44,1994
"Newham","17:00:00","2021-05-20",983,14,13,188,36,1234
"Sutton","17:00:00","2021-05-20",1348,49,32,193,1,1623
"Bexley","18:00:00","2021-05-20",489,20,0,58,4,571
"Bromley","18:00:00","2021-05-20",1431,14,3,177,35,1660
"Enfield","18:00:00","2021-05-20",22,2,0,1,1,26
"Greenwich","18:00:00","2021-05-20",17,0,0,6,0,23
"Hackney","18:00:00","2021-05-20",1710,172,72,243,39,2236
"Havering","18:00:00","2021-05-20",78,0,0,9,0,87
"Hounslow","18:00:00","2021-05-20",1291,70,39,128,17,1545
"Kingston upon Thames","18:00:00","2021-05-20",1121,72,118,91,15,1417
"Lambeth","18:00:00","2021-05-20",1324,92,22,191,31,1660
"Merton","18:00:00","2021-05-20",4240,104,27,500,47,4918
"Newham","18:00:00","2021-05-20",834,30,17,117,23,1021
"Sutton","18:00:00","2021-05-20",1281,59,38,145,1,1524
"Barnet","07:00:00","2021-05-21",1010,43,78,308,57,1496
"City of London","07:00:00","2021-05-21",590,32,90,270,55,1037
"Croydon","07:00:00","2021-05-21",1575,45,22,437,81,2160
"Hackney","07:00:00","2021-05-21",726,107,52,326,91,1302
"Lewisham","07:00:00","2021-05-21",491,9,35,167,24,726
"Barnet","08:00:00","2021-05-21",1348,31,72,257,87,1795
"City of London","08:00:00","2021-05-21",635,37,110,229,51,1062
"Croydon","08:00:00","2021-05-21",1451,53,18,344,61,1927
"Hackney","08:00:00","2021-05-21",698,80,57,327,120,1282
"Lewisham","08:00:00","2021-05-21",540,18,33,100,16,707
"Barnet","09:00:00","2021-05-21",994,38,65,211,85,1393
"City of London","09:00:00","2021-05-21",654,39,98,210,51,1052
"Croydon","09:00:00","2021-05-21",1252,42,25,325,70,1714
"Hackney","09:00:00","2021-05-21",735,69,50,334,109,1297
"Lewisham","09:00:00","2021-05-21",576,23,38,135,13,785
"Barnet","10:00:00","2021-05-21",1108,32,54,216,80,1490
"City of London","10:00:00","2021-05-21",719,37,75,281,37,1149
"Croydon","10:00:00","2021-05-21",1179,41,19,299,76,1614
"Hackney","10:00:00","2021-05-21",676,64,46,278,112,1176
"Lewisham","10:00:00","2021-05-21",543,29,31,139,20,762
"Barnet","11:00:00","2021-05-21",1284,31,58,218,64,1655
"City of London","11:00:00","2021-05-21",779,60,66,247,36,1188
"Croydon","11:00:00","2021-05-21",1207,45,12,294,63,1621
"Hackney","11:00:00","2021-05-21",714,98,45,329,130,1316
"Lewisham","11:00:00","2021-05-21",513,32,32,125,24,726
"Barnet","12:00:00","2021-05-21",1212,32,55,227,51,1577
"City of London","12:00:00","2021-05-21",681,54,64,303,31,1133
"Croydon","12:00:00","2021-05-21",1321,44,15,262,64,1706
"Hackney","12:00:00","2021-05-21",818,174,44,296,77,1409
"Lewisham","12:00:00","2021-05-21",508,22,29,103,22,684
"Barnet","13:00:00","2021-05-21",1240,31,60,200,60,1591
"City of London","13:00:00","2021-05-21",682,46,64,282,29,1103
"Croydon","13:00:00","2021-05-21",1387,33,18,250,44,1732
"Hackney","13:00:00","2021-05-21",750,140,47,293,84,1314
"Lewisham","13:00:00","2021-05-21",559,28,41,85,22,735
"Barnet","14:00:00","2021-05-21",1357,43,61,183,52,1696
"City of London","14:00:00","2021-05-21",788,53,63,261,35,1200
"Croydon","14:00:00","2021-05-21",1545,44,18,243,45,1895
"Hackney","14:00:00","2021-05-21",860,138,51,294,67,1410
"Lewisham","14:00:00","2021-05-21",570,28,33,80,12,723
"Barnet","15:00:00","2021-05-21",1435,37,70,184,55,1781
"City of London","15:00:00","2021-05-21",767,52,63,223,28,1133
"Croydon","15:00:00","2021-05-21",1211,57,18,208,21,1515
"Hackney","15:00:00","2021-05-21",870,142,47,278,57,1394
"Lewisham","15:00:00","2021-05-21",585,34,33,96,15,763
"Barnet","16:00:00","2021-05-21",1415,64,53,210,34,1776
"City of London","16:00:00","2021-05-21",849,62,90,198,17,1216
"Croydon","16:00:00","2021-05-21",1387,54,21,256,28,1746
"Hackney","16:00:00","2021-05-21",966,166,54,247,51,1484
"Lewisham","16:00:00","2021-05-21",652,33,34,102,8,829
"Barnet","17:00:00","2021-05-21",1444,48,52,173,22,1739
"City of London","17:00:00","2021-05-21",871,61,102,136,15,1185
"Croydon","17:00:00","2021-05-21",1475,60,19,192,13,1759
"Hackney","17:00:00","2021-05-21",1006,161,49,192,39,1447
"Lewisham","17:00:00","2021-05-21",675,45,29,102,6,857
"Barnet","18:00:00","2021-05-21",1383,56,67,155,22,1683
"City of London","18:00:00","2021-05-21",979,59,79,82,8,1207
"Croydon","18:00:00","2021-05-21",1364,43,19,274,27,1727
"Hackney","18:00:00","2021-05-21",1026,155,44,102,26,1353
"Lewisham","18:00:00","2021-05-21",737,42,29,89,9,906
"Barnet","07:00:00","2021-05-24",542,4,17,162,7,732
"Haringey","07:00:00","2021-05-24",889,45,159,301,52,1446
"Hillingdon","07:00:00","2021-05-24",27,0,0,5,0,32
"Tower Hamlets","07:00:00","2021-05-24",187,10,29,56,9,291
"Barnet","08:00:00","2021-05-24",594,5,13,94,5,711
"Haringey","08:00:00","2021-05-24",920,46,145,262,73,1446
"Hillingdon","08:00:00","2021-05-24",98,0,0,4,0,102
"Tower Hamlets","08:00:00","2021-05-24",317,4,27,58,19,425
"Barnet","09:00:00","2021-05-24",366,4,13,79,10,472
"Haringey","09:00:00","2021-05-24",883,40,151,223,60,1357
"Hillingdon","09:00:00","2021-05-24",18,0,0,2,0,20
"Tower Hamlets","09:00:00","2021-05-24",276,10,30,65,15,396
"Barnet","10:00:00","2021-05-24",336,1,11,62,15,425
"Haringey","10:00:00","2021-05-24",730,34,150,223,87,1224
"Hillingdon","10:00:00","2021-05-24",23,0,0,5,0,28
"Tower Hamlets","10:00:00","2021-05-24",282,18,28,77,16,421
"Barnet","11:00:00","2021-05-24",338,6,11,78,16,449
"Haringey","11:00:00","2021-05-24",845,70,134,237,83,1369
"Hillingdon","11:00:00","2021-05-24",40,1,0,5,1,47
"Tower Hamlets","11:00:00","2021-05-24",280,27,27,76,29,439
"Barnet","12:00:00","2021-05-24",346,5,10,51,9,421
"Haringey","12:00:00","2021-05-24",770,45,138,206,73,1232
"Hillingdon","12:00:00","2021-05-24",21,0,0,3,1,25
"Tower Hamlets","12:00:00","2021-05-24",317,18,26,84,35,480
"Barnet","13:00:00","2021-05-24",315,4,10,51,6,386
"Haringey","13:00:00","2021-05-24",826,54,138,192,67,1277
"Hillingdon","13:00:00","2021-05-24",13,1,0,10,0,24
"Tower Hamlets","13:00:00","2021-05-24",324,21,29,63,19,456
"Barnet","14:00:00","2021-05-24",428,7,11,68,2,516
"Haringey","14:00:00","2021-05-24",849,66,145,193,60,1313
"Hillingdon","14:00:00","2021-05-24",49,1,0,5,0,55
"Tower Hamlets","14:00:00","2021-05-24",360,20,24,78,17,499
"Barnet","15:00:00","2021-05-24",552,7,11,55,3,628
"Haringey","15:00:00","2021-05-24",932,71,134,162,50,1349
"Hillingdon","15:00:00","2021-05-24",78,0,1,8,1,88
"Tower Hamlets","15:00:00","2021-05-24",441,21,28,82,19,591
"Barnet","16:00:00","2021-05-24",524,5,19,69,10,627
"Haringey","16:00:00","2021-05-24",976,78,156,176,35,1421
"Hillingdon","16:00:00","2021-05-24",49,1,0,6,0,56
"Tower Hamlets","16:00:00","2021-05-24",441,16,25,59,12,553
"Barnet","17:00:00","2021-05-24",574,6,14,62,4,660
"Haringey","17:00:00","2021-05-24",1032,85,147,179,23,1466
"Hillingdon","17:00:00","2021-05-24",36,0,0,2,0,38
"Tower Hamlets","17:00:00","2021-05-24",432,34,24,61,14,565
"Barnet","18:00:00","2021-05-24",445,5,12,45,3,510
"Haringey","18:00:00","2021-05-24",1043,75,152,145,18,1433
"Hillingdon","18:00:00","2021-05-24",28,0,0,2,1,31
"Tower Hamlets","18:00:00","2021-05-24",452,28,26,31,11,548
"Barnet","07:00:00","2021-05-25",2028,20,17,486,97,2648
"Bromley","07:00:00","2021-05-25",8,0,0,5,0,13
"Greenwich","07:00:00","2021-05-25",1130,37,68,318,105,1658
"Hillingdon","07:00:00","2021-05-25",524,5,2,188,16,735
"Lewisham","07:00:00","2021-05-25",3,1,0,9,0,13
"Merton","07:00:00","2021-05-25",1189,23,15,311,47,1585
"Westminster","07:00:00","2021-05-25",1577,227,110,801,188,2903
"Barnet","08:00:00","2021-05-25",2294,16,37,376,102,2825
"Bromley","08:00:00","2021-05-25",6,0,0,3,0,9
"Greenwich","08:00:00","2021-05-25",1170,18,61,254,115,1618
"Hillingdon","08:00:00","2021-05-25",570,7,1,158,12,748
"Lewisham","08:00:00","2021-05-25",17,2,0,9,1,29
"Merton","08:00:00","2021-05-25",1128,19,17,256,66,1486
"Westminster","08:00:00","2021-05-25",1658,215,101,729,225,2928
"Barnet","09:00:00","2021-05-25",1548,9,4,358,150,2069
"Bromley","09:00:00","2021-05-25",13,0,0,7,0,20
"Greenwich","09:00:00","2021-05-25",1065,30,61,262,145,1563
"Hillingdon","09:00:00","2021-05-25",550,5,0,160,23,738
"Lewisham","09:00:00","2021-05-25",11,0,0,3,2,16
"Merton","09:00:00","2021-05-25",948,20,21,214,69,1272
"Westminster","09:00:00","2021-05-25",1697,147,104,723,247,2918
"Barnet","10:00:00","2021-05-25",1377,10,0,336,111,1834
"Bromley","10:00:00","2021-05-25",9,0,0,10,1,20
"Greenwich","10:00:00","2021-05-25",993,26,60,328,152,1559
"Hillingdon","10:00:00","2021-05-25",471,3,0,157,24,655
"Lewisham","10:00:00","2021-05-25",7,0,0,5,0,12
"Merton","10:00:00","2021-05-25",835,15,14,238,61,1163
"Westminster","10:00:00","2021-05-25",1721,138,89,685,243,2876
"Barnet","11:00:00","2021-05-25",1423,7,1,295,112,1838
"Bromley","11:00:00","2021-05-25",9,0,0,3,0,12
"Greenwich","11:00:00","2021-05-25",982,21,48,294,143,1488
"Hillingdon","11:00:00","2021-05-25",510,12,0,137,27,686
"Lewisham","11:00:00","2021-05-25",15,1,0,5,0,21
"Merton","11:00:00","2021-05-25",879,21,12,209,69,1190
"Westminster","11:00:00","2021-05-25",1579,127,86,611,255,2658
"Barnet","12:00:00","2021-05-25",1477,13,4,260,106,1860
"Bromley","12:00:00","2021-05-25",4,0,0,1,0,5
"Greenwich","12:00:00","2021-05-25",1138,24,62,237,127,1588
"Hillingdon","12:00:00","2021-05-25",559,11,1,139,16,726
"Lewisham","12:00:00","2021-05-25",14,0,0,4,0,18
"Merton","12:00:00","2021-05-25",923,22,11,238,56,1250
"Westminster","12:00:00","2021-05-25",1603,137,85,607,214,2646
"Barnet","13:00:00","2021-05-25",1537,12,6,300,127,1982
"Bromley","13:00:00","2021-05-25",11,0,0,7,1,19
"Greenwich","13:00:00","2021-05-25",1176,29,61,237,139,1642
"Hillingdon","13:00:00","2021-05-25",577,12,0,155,19,763
"Lewisham","13:00:00","2021-05-25",15,3,0,6,0,24
"Merton","13:00:00","2021-05-25",907,25,16,208,58,1214
"Westminster","13:00:00","2021-05-25",1685,169,82,552,185,2673
"Barnet","14:00:00","2021-05-25",1686,19,9,270,116,2100
"Bromley","14:00:00","2021-05-25",13,0,0,4,0,17
"Greenwich","14:00:00","2021-05-25",1224,34,59,252,122,1691
"Hillingdon","14:00:00","2021-05-25",610,13,1,122,24,770
"Lewisham","14:00:00","2021-05-25",19,0,0,4,0,23
"Merton","14:00:00","2021-05-25",950,24,16,200,65,1255
"Westminster","14:00:00","2021-05-25",1626,185,93,615,167,2686
"Barnet","15:00:00","2021-05-25",1868,27,20,353,91,2359
"Bromley","15:00:00","2021-05-25",6,0,0,3,0,9
"Greenwich","15:00:00","2021-05-25",1313,47,53,226,79,1718
"Hillingdon","15:00:00","2021-05-25",580,8,0,130,15,733
"Lewisham","15:00:00","2021-05-25",23,1,0,6,1,31
"Merton","15:00:00","2021-05-25",1023,18,18,246,41,1346
"Westminster","15:00:00","2021-05-25",1729,195,89,583,132,2728
"Barnet","16:00:00","2021-05-25",2264,15,22,401,83,2785
"Bromley","16:00:00","2021-05-25",15,0,0,3,0,18
"Greenwich","16:00:00","2021-05-25",1459,42,62,242,65,1870
"Hillingdon","16:00:00","2021-05-25",645,10,0,124,11,790
"Lewisham","16:00:00","2021-05-25",10,5,0,5,0,20
"Merton","16:00:00","2021-05-25",1219,31,12,277,42,1581
"Westminster","16:00:00","2021-05-25",1751,260,104,514,100,2729
"Barnet","17:00:00","2021-05-25",2377,23,8,397,33,2838
"Bromley","17:00:00","2021-05-25",10,0,0,0,0,10
"Greenwich","17:00:00","2021-05-25",1494,56,58,181,50,1839
"Hillingdon","17:00:00","2021-05-25",664,12,0,82,5,763
"Lewisham","17:00:00","2021-05-25",20,2,0,1,0,23
"Merton","17:00:00","2021-05-25",1238,29,15,205,19,1506
"Westminster","17:00:00","2021-05-25",2010,295,84,429,63,2881
"Barnet","18:00:00","2021-05-25",2112,23,12,279,30,2456
"Bromley","18:00:00","2021-05-25",3,0,0,0,0,3
"Greenwich","18:00:00","2021-05-25",1463,36,65,134,37,1735
"Hillingdon","18:00:00","2021-05-25",663,1,0,115,7,786
"Lewisham","18:00:00","2021-05-25",17,1,0,3,0,21
"Merton","18:00:00","2021-05-25",1224,44,16,151,11,1446
"Westminster","18:00:00","2021-05-25",2158,277,90,265,59,2849
"Barnet","07:00:00","2021-05-26",1201,19,83,356,49,1708
"Brent","07:00:00","2021-05-26",318,12,45,100,7,482
"Ealing","07:00:00","2021-05-26",5914,114,96,1803,555,8482
"Waltham Forest","07:00:00","2021-05-26",16,0,0,1,2,19
"Barnet","08:00:00","2021-05-26",1564,18,64,193,34,1873
"Brent","08:00:00","2021-05-26",531,11,44,96,10,692
"Ealing","08:00:00","2021-05-26",5790,113,88,1463,657,8111
"Waltham Forest","08:00:00","2021-05-26",24,1,0,5,0,30
"Barnet","09:00:00","2021-05-26",989,24,79,209,32,1333
"Brent","09:00:00","2021-05-26",250,14,44,71,4,383
"Ealing","09:00:00","2021-05-26",4982,86,95,1395,803,7361
"Waltham Forest","09:00:00","2021-05-26",13,0,0,5,0,18
"Barnet","10:00:00","2021-05-26",895,23,66,192,38,1214
"Brent","10:00:00","2021-05-26",227,26,39,55,4,351
"Ealing","10:00:00","2021-05-26",4659,89,83,1341,777,6949
"Waltham Forest","10:00:00","2021-05-26",17,0,0,3,1,21
"Barnet","11:00:00","2021-05-26",778,29,66,177,31,1081
"Brent","11:00:00","2021-05-26",248,15,39,66,11,379
"Ealing","11:00:00","2021-05-26",4855,104,89,1362,731,7141
"Waltham Forest","11:00:00","2021-05-26",30,3,0,14,1,48
"Barnet","12:00:00","2021-05-26",908,33,63,140,27,1171
"Brent","12:00:00","2021-05-26",268,30,39,56,11,404
"Ealing","12:00:00","2021-05-26",4731,112,83,1380,728,7034
"Waltham Forest","12:00:00","2021-05-26",22,0,0,5,0,27
"Barnet","13:00:00","2021-05-26",984,20,61,137,30,1232
"Brent","13:00:00","2021-05-26",272,23,36,50,4,385
"Ealing","13:00:00","2021-05-26",4906,119,83,1356,726,7190
"Waltham Forest","13:00:00","2021-05-26",32,0,0,13,1,46
"Barnet","14:00:00","2021-05-26",1045,32,66,176,36,1355
"Brent","14:00:00","2021-05-26",373,27,46,56,9,511
"Ealing","14:00:00","2021-05-26",5523,121,87,1534,762,8027
"Waltham Forest","14:00:00","2021-05-26",30,4,0,2,1,37
"Barnet","15:00:00","2021-05-26",1374,34,65,168,21,1662
"Brent","15:00:00","2021-05-26",496,30,40,63,6,635
"Ealing","15:00:00","2021-05-26",5916,135,85,1677,646,8459
"Waltham Forest","15:00:00","2021-05-26",33,1,0,8,4,46
"Barnet","16:00:00","2021-05-26",1297,46,75,197,13,1628
"Brent","16:00:00","2021-05-26",394,30,37,77,6,544
"Waltham Forest","16:00:00","2021-05-26",29,3,0,4,2,38
"Barnet","17:00:00","2021-05-26",1312,56,66,197,20,1651
"Brent","17:00:00","2021-05-26",422,34,39,71,6,572
"Waltham Forest","17:00:00","2021-05-26",20,1,0,5,0,26
"Barnet","18:00:00","2021-05-26",1214,57,66,94,11,1442
"Brent","18:00:00","2021-05-26",460,25,44,58,1,588
"Waltham Forest","18:00:00","2021-05-26",18,4,0,2,1,25
"Bromley","07:00:00","2021-05-27",912,19,50,387,50,1418
"Camden","07:00:00","2021-05-27",1402,139,59,580,141,2321
"Croydon","07:00:00","2021-05-27",106,0,0,10,0,116
"Ealing","07:00:00","2021-05-27",1454,22,32,316,48,1872
"Enfield","07:00:00","2021-05-27",645,3,5,190,34,877
"Haringey","07:00:00","2021-05-27",279,12,1,100,7,399
"Hillingdon","07:00:00","2021-05-27",379,1,0,55,4,439
"Islington","07:00:00","2021-05-27",170,9,11,66,7,263
"Lewisham","07:00:00","2021-05-27",72,3,0,21,1,97
"Richmond upon Thames","07:00:00","2021-05-27",66,1,0,11,3,81
"Southwark","07:00:00","2021-05-27",768,15,27,221,33,1064
"Bromley","08:00:00","2021-05-27",1189,16,44,284,58,1591
"Camden","08:00:00","2021-05-27",1804,110,35,407,153,2509
"Croydon","08:00:00","2021-05-27",226,2,0,20,2,250
"Ealing","08:00:00","2021-05-27",1675,21,18,228,51,1993
"Enfield","08:00:00","2021-05-27",879,6,4,179,33,1101
"Haringey","08:00:00","2021-05-27",381,22,3,76,11,493
"Hillingdon","08:00:00","2021-05-27",606,8,6,58,10,688
"Islington","08:00:00","2021-05-27",351,9,17,83,17,477
"Lewisham","08:00:00","2021-05-27",130,2,0,33,6,171
"Richmond upon Thames","08:00:00","2021-05-27",109,1,0,10,3,123
"Southwark","08:00:00","2021-05-27",731,18,30,153,36,968
"Bromley","09:00:00","2021-05-27",1118,15,49,294,90,1566
"Camden","09:00:00","2021-05-27",1732,105,70,440,167,2514
"Croydon","09:00:00","2021-05-27",75,4,0,11,1,91
"Ealing","09:00:00","2021-05-27",1282,23,29,230,80,1644
"Enfield","09:00:00","2021-05-27",581,9,6,109,28,733
"Haringey","09:00:00","2021-05-27",318,18,2,79,11,428
"Hillingdon","09:00:00","2021-05-27",331,3,2,40,3,379
"Islington","09:00:00","2021-05-27",281,10,12,79,15,397
"Lewisham","09:00:00","2021-05-27",125,5,0,35,4,169
"Richmond upon Thames","09:00:00","2021-05-27",85,0,1,11,0,97
"Southwark","09:00:00","2021-05-27",673,28,28,180,47,956
"Bromley","10:00:00","2021-05-27",1135,18,39,312,78,1582
"Camden","10:00:00","2021-05-27",1771,94,52,496,164,2577
"Croydon","10:00:00","2021-05-27",61,0,0,17,3,81
"Ealing","10:00:00","2021-05-27",1107,20,24,255,88,1494
"Enfield","10:00:00","2021-05-27",493,2,4,98,15,612
"Haringey","10:00:00","2021-05-27",182,30,0,89,10,311
"Hillingdon","10:00:00","2021-05-27",242,5,0,39,13,299
"Islington","10:00:00","2021-05-27",171,8,9,67,17,272
"Lewisham","10:00:00","2021-05-27",106,3,0,33,4,146
"Richmond upon Thames","10:00:00","2021-05-27",64,1,0,15,0,80
"Southwark","10:00:00","2021-05-27",710,28,24,214,44,1020
"Bromley","11:00:00","2021-05-27",1191,20,40,278,71,1600
"Camden","11:00:00","2021-05-27",1847,98,65,479,158,2647
"Croydon","11:00:00","2021-05-27",59,1,0,13,0,73
"Ealing","11:00:00","2021-05-27",1236,28,21,228,67,1580
"Enfield","11:00:00","2021-05-27",547,7,4,86,21,665
"Haringey","11:00:00","2021-05-27",230,33,0,59,8,330
"Hillingdon","11:00:00","2021-05-27",205,8,0,45,9,267
"Islington","11:00:00","2021-05-27",178,8,11,70,9,276
"Lewisham","11:00:00","2021-05-27",112,1,0,41,4,158
"Richmond upon Thames","11:00:00","2021-05-27",74,0,0,19,1,94
"Southwark","11:00:00","2021-05-27",663,43,23,193,43,965
"Bromley","12:00:00","2021-05-27",1243,16,38,278,58,1633
"Camden","12:00:00","2021-05-27",1837,158,41,465,130,2631
"Croydon","12:00:00","2021-05-27",64,0,0,23,3,90
"Ealing","12:00:00","2021-05-27",1379,22,15,264,68,1748
"Enfield","12:00:00","2021-05-27",542,5,5,80,24,656
"Haringey","12:00:00","2021-05-27",231,36,0,66,7,340
"Hillingdon","12:00:00","2021-05-27",261,3,0,28,3,295
"Islington","12:00:00","2021-05-27",178,18,9,78,12,295
"Lewisham","12:00:00","2021-05-27",142,7,0,37,3,189
"Richmond upon Thames","12:00:00","2021-05-27",71,3,0,11,2,87
"Southwark","12:00:00","2021-05-27",723,53,26,193,45,1040
"Bromley","13:00:00","2021-05-27",1265,40,39,266,60,1670
"Camden","13:00:00","2021-05-27",1827,145,57,420,90,2539
"Croydon","13:00:00","2021-05-27",68,1,0,12,0,81
"Ealing","13:00:00","2021-05-27",1722,38,13,251,61,2085
"Enfield","13:00:00","2021-05-27",522,5,4,72,25,628
"Haringey","13:00:00","2021-05-27",258,36,0,60,16,370
"Hillingdon","13:00:00","2021-05-27",256,7,0,45,4,312
"Islington","13:00:00","2021-05-27",160,20,10,52,8,250
"Lewisham","13:00:00","2021-05-27",187,11,0,57,5,260
"Richmond upon Thames","13:00:00","2021-05-27",54,0,0,17,2,73
"Southwark","13:00:00","2021-05-27",736,46,27,185,39,1033
"Bromley","14:00:00","2021-05-27",1316,22,39,255,61,1693
"Camden","14:00:00","2021-05-27",1813,106,68,449,107,2543
"Croydon","14:00:00","2021-05-27",95,2,0,25,3,125
"Ealing","14:00:00","2021-05-27",1726,27,25,258,65,2101
"Enfield","14:00:00","2021-05-27",591,3,4,101,31,730
"Haringey","14:00:00","2021-05-27",339,41,0,114,19,513
"Hillingdon","14:00:00","2021-05-27",328,10,3,35,10,386
"Islington","14:00:00","2021-05-27",229,18,11,74,7,339
"Lewisham","14:00:00","2021-05-27",213,10,0,61,1,285
"Richmond upon Thames","14:00:00","2021-05-27",77,0,0,11,1,89
"Southwark","14:00:00","2021-05-27",766,48,24,154,35,1027
"Bromley","15:00:00","2021-05-27",1341,25,46,267,62,1741
"Camden","15:00:00","2021-05-27",1998,129,65,405,89,2686
"Croydon","15:00:00","2021-05-27",155,2,0,23,4,184
"Ealing","15:00:00","2021-05-27",1673,36,18,233,55,2015
"Enfield","15:00:00","2021-05-27",630,6,4,95,23,758
"Haringey","15:00:00","2021-05-27",438,38,4,116,27,623
"Hillingdon","15:00:00","2021-05-27",538,8,7,54,7,614
"Islington","15:00:00","2021-05-27",319,16,15,80,7,437
"Lewisham","15:00:00","2021-05-27",258,15,0,87,5,365
"Richmond upon Thames","15:00:00","2021-05-27",115,3,0,11,0,129
"Southwark","15:00:00","2021-05-27",752,51,24,166,28,1021
"Bromley","16:00:00","2021-05-27",1387,30,47,252,41,1757
"Camden","16:00:00","2021-05-27",1859,141,82,418,75,2575
"Croydon","16:00:00","2021-05-27",149,1,0,24,2,176
"Ealing","16:00:00","2021-05-27",1791,59,19,242,40,2151
"Enfield","16:00:00","2021-05-27",783,9,2,155,22,971
"Haringey","16:00:00","2021-05-27",429,32,0,114,6,581
"Hillingdon","16:00:00","2021-05-27",447,7,0,53,3,510
"Islington","16:00:00","2021-05-27",279,15,13,73,2,382
"Lewisham","16:00:00","2021-05-27",340,9,0,137,9,495
"Richmond upon Thames","16:00:00","2021-05-27",89,2,0,8,0,99
"Southwark","16:00:00","2021-05-27",773,48,26,159,16,1022
"Bromley","17:00:00","2021-05-27",1467,29,38,206,10,1750
"Camden","17:00:00","2021-05-27",1968,200,69,370,51,2658
"Croydon","17:00:00","2021-05-27",165,1,0,24,0,190
"Ealing","17:00:00","2021-05-27",1797,46,15,235,35,2128
"Enfield","17:00:00","2021-05-27",863,7,5,122,11,1008
"Haringey","17:00:00","2021-05-27",508,42,1,115,12,678
"Hillingdon","17:00:00","2021-05-27",442,13,0,45,2,502
"Islington","17:00:00","2021-05-27",293,20,11,30,10,364
"Lewisham","17:00:00","2021-05-27",356,12,0,90,3,461
"Richmond upon Thames","17:00:00","2021-05-27",89,2,0,18,0,109
"Southwark","17:00:00","2021-05-27",771,53,23,115,21,983
"Bromley","18:00:00","2021-05-27",1252,31,45,116,20,1464
"Camden","18:00:00","2021-05-27",2229,202,64,243,53,2791
"Croydon","18:00:00","2021-05-27",102,9,0,5,1,117
"Ealing","18:00:00","2021-05-27",1547,51,12,207,20,1837
"Enfield","18:00:00","2021-05-27",608,9,5,90,8,720
"Haringey","18:00:00","2021-05-27",487,54,1,77,8,627
"Hillingdon","18:00:00","2021-05-27",329,7,0,41,3,380
"Islington","18:00:00","2021-05-27",253,38,9,21,5,326
"Lewisham","18:00:00","2021-05-27",272,24,0,52,2,350
"Richmond upon Thames","18:00:00","2021-05-27",89,4,0,5,0,98
"Southwark","18:00:00","2021-05-27",888,77,25,83,8,1081
"Camden","07:00:00","2021-05-28",332,16,30,115,18,511
"Croydon","07:00:00","2021-05-28",1070,91,29,336,64,1590
"Enfield","07:00:00","2021-05-28",806,4,19,202,45,1076
"Newham","07:00:00","2021-05-28",203,7,13,47,7,277
"Richmond upon Thames","07:00:00","2021-05-28",20,0,0,7,2,29
"Westminster","07:00:00","2021-05-28",1647,240,118,718,210,2933
"Camden","08:00:00","2021-05-28",503,17,26,110,21,677
"Croydon","08:00:00","2021-05-28",1098,80,24,271,48,1521
"Enfield","08:00:00","2021-05-28",1062,10,7,141,27,1247
"Newham","08:00:00","2021-05-28",384,4,12,44,11,455
"Richmond upon Thames","08:00:00","2021-05-28",61,0,0,14,2,77
"Westminster","08:00:00","2021-05-28",1657,207,109,658,263,2894
"Camden","09:00:00","2021-05-28",372,23,29,113,29,566
"Croydon","09:00:00","2021-05-28",1029,66,29,309,52,1485
"Enfield","09:00:00","2021-05-28",891,9,7,148,28,1083
"Newham","09:00:00","2021-05-28",303,9,10,57,11,390
"Richmond upon Thames","09:00:00","2021-05-28",55,0,0,21,1,77
"Westminster","09:00:00","2021-05-28",1636,182,117,598,266,2799
"Camden","10:00:00","2021-05-28",327,23,22,104,36,512
"Croydon","10:00:00","2021-05-28",968,64,22,230,53,1337
"Enfield","10:00:00","2021-05-28",906,7,7,156,26,1102
"Newham","10:00:00","2021-05-28",324,25,10,53,4,416
"Richmond upon Thames","10:00:00","2021-05-28",44,0,0,6,2,52
"Westminster","10:00:00","2021-05-28",1818,128,89,586,198,2819
"Camden","11:00:00","2021-05-28",341,36,25,107,30,539
"Croydon","11:00:00","2021-05-28",948,66,28,235,41,1318
"Enfield","11:00:00","2021-05-28",952,6,6,157,27,1148
"Newham","11:00:00","2021-05-28",390,8,9,55,7,469
"Richmond upon Thames","11:00:00","2021-05-28",57,2,0,16,5,80
"Westminster","11:00:00","2021-05-28",1678,147,89,503,215,2632
"Camden","12:00:00","2021-05-28",348,35,23,101,22,529
"Croydon","12:00:00","2021-05-28",1214,101,21,250,41,1627
"Enfield","12:00:00","2021-05-28",919,12,10,130,20,1091
"Newham","12:00:00","2021-05-28",381,7,11,64,7,470
"Richmond upon Thames","12:00:00","2021-05-28",77,0,0,14,2,93
"Westminster","12:00:00","2021-05-28",1676,185,86,492,176,2615
"Camden","13:00:00","2021-05-28",412,43,23,89,33,600
"Croydon","13:00:00","2021-05-28",1060,102,22,226,52,1462
"Enfield","13:00:00","2021-05-28",931,9,8,151,26,1125
"Newham","13:00:00","2021-05-28",382,25,11,58,9,485
"Richmond upon Thames","13:00:00","2021-05-28",60,0,0,13,1,74
"Westminster","13:00:00","2021-05-28",1851,204,92,460,181,2788
"Camden","14:00:00","2021-05-28",453,44,24,105,21,647
"Croydon","14:00:00","2021-05-28",1028,76,20,214,39,1377
"Enfield","14:00:00","2021-05-28",1023,6,7,166,23,1225
"Newham","14:00:00","2021-05-28",392,26,11,46,7,482
"Richmond upon Thames","14:00:00","2021-05-28",57,2,0,9,1,69
"Westminster","14:00:00","2021-05-28",1818,192,100,478,152,2740
"Camden","15:00:00","2021-05-28",619,29,25,125,15,813
"Croydon","15:00:00","2021-05-28",1244,93,23,207,42,1609
"Enfield","15:00:00","2021-05-28",1095,9,7,158,21,1290
"Newham","15:00:00","2021-05-28",458,37,12,47,8,562
"Richmond upon Thames","15:00:00","2021-05-28",72,1,0,8,0,81
"Westminster","15:00:00","2021-05-28",1629,147,86,416,133,2411
"Camden","16:00:00","2021-05-28",613,37,22,110,20,802
"Croydon","16:00:00","2021-05-28",1079,119,28,190,21,1437
"Enfield","16:00:00","2021-05-28",1039,10,15,138,26,1228
"Newham","16:00:00","2021-05-28",469,16,12,69,8,574
"Richmond upon Thames","16:00:00","2021-05-28",86,0,0,5,0,91
"Westminster","16:00:00","2021-05-28",1705,214,87,351,84,2441
"Camden","17:00:00","2021-05-28",690,56,24,98,15,883
"Croydon","17:00:00","2021-05-28",1190,138,30,159,15,1532
"Enfield","17:00:00","2021-05-28",1082,20,9,117,7,1235
"Newham","17:00:00","2021-05-28",485,31,10,60,7,593
"Richmond upon Thames","17:00:00","2021-05-28",97,2,0,7,1,107
"Westminster","17:00:00","2021-05-28",1827,272,90,329,59,2577
"Camden","18:00:00","2021-05-28",665,81,23,59,13,841
"Croydon","18:00:00","2021-05-28",1089,127,23,148,13,1400
"Enfield","18:00:00","2021-05-28",1149,12,9,85,16,1271
"Newham","18:00:00","2021-05-28",520,24,10,53,5,612
"Richmond upon Thames","18:00:00","2021-05-28",86,7,0,4,1,98
"Westminster","18:00:00","2021-05-28",2037,217,98,240,42,2634
"Croydon","07:00:00","2021-06-07",223,2,0,36,3,264
"Tower Hamlets","07:00:00","2021-06-07",327,53,26,287,55,748
"Croydon","08:00:00","2021-06-07",255,0,0,32,3,290
"Tower Hamlets","08:00:00","2021-06-07",314,46,25,193,50,628
"Croydon","09:00:00","2021-06-07",197,3,0,26,3,229
"Tower Hamlets","09:00:00","2021-06-07",301,47,28,209,71,656
"Croydon","10:00:00","2021-06-07",178,2,0,35,1,216
"Tower Hamlets","10:00:00","2021-06-07",337,40,25,228,72,702
"Croydon","11:00:00","2021-06-07",155,3,0,23,6,187
"Tower Hamlets","11:00:00","2021-06-07",333,38,25,197,65,658
"Croydon","12:00:00","2021-06-07",174,5,0,33,5,217
"Tower Hamlets","12:00:00","2021-06-07",330,67,26,206,59,688
"Croydon","13:00:00","2021-06-07",158,8,0,27,5,198
"Tower Hamlets","13:00:00","2021-06-07",295,69,27,156,50,597
"Croydon","14:00:00","2021-06-07",184,1,0,29,5,219
"Tower Hamlets","14:00:00","2021-06-07",328,66,24,186,49,653
"Croydon","15:00:00","2021-06-07",261,8,0,35,4,308
"Tower Hamlets","15:00:00","2021-06-07",316,80,27,170,32,625
"Croydon","16:00:00","2021-06-07",244,6,0,54,3,307
"Tower Hamlets","16:00:00","2021-06-07",408,80,24,197,34,743
"Croydon","17:00:00","2021-06-07",250,9,0,50,3,312
"Tower Hamlets","17:00:00","2021-06-07",441,104,29,140,19,733
"Croydon","18:00:00","2021-06-07",207,2,0,24,1,234
"Tower Hamlets","18:00:00","2021-06-07",495,105,32,96,18,746
"Bexley","07:00:00","2021-06-08",131,4,0,21,32,188
"Brent","07:00:00","2021-06-08",30,0,10,4,1,45
"Bromley","07:00:00","2021-06-08",110,0,3,18,1,132
"Hillingdon","07:00:00","2021-06-08",2807,15,42,944,264,4072
"Newham","07:00:00","2021-06-08",300,10,21,61,19,411
"Sutton","07:00:00","2021-06-08",10,0,0,2,0,12
"Bexley","08:00:00","2021-06-08",66,6,0,29,37,138
"Brent","08:00:00","2021-06-08",43,3,10,6,3,65
"Bromley","08:00:00","2021-06-08",204,0,2,21,0,227
"Hillingdon","08:00:00","2021-06-08",2645,22,22,671,271,3631
"Newham","08:00:00","2021-06-08",413,19,15,51,16,514
"Sutton","08:00:00","2021-06-08",15,0,0,3,0,18
"Bexley","09:00:00","2021-06-08",80,5,0,37,48,170
"Brent","09:00:00","2021-06-08",37,0,13,7,3,60
"Bromley","09:00:00","2021-06-08",93,1,0,18,5,117
"Hillingdon","09:00:00","2021-06-08",2016,8,26,655,237,2942
"Newham","09:00:00","2021-06-08",407,7,16,69,16,515
"Sutton","09:00:00","2021-06-08",18,0,0,3,1,22
"Bexley","10:00:00","2021-06-08",103,5,0,23,45,176
"Brent","10:00:00","2021-06-08",31,3,12,8,4,58
"Bromley","10:00:00","2021-06-08",88,0,0,20,7,115
"Hillingdon","10:00:00","2021-06-08",1549,9,24,673,292,2547
"Newham","10:00:00","2021-06-08",341,23,15,71,31,481
"Sutton","10:00:00","2021-06-08",6,1,0,2,1,10
"Bexley","11:00:00","2021-06-08",99,7,0,27,68,201
"Brent","11:00:00","2021-06-08",36,4,9,10,2,61
"Bromley","11:00:00","2021-06-08",88,0,0,12,2,102
"Hillingdon","11:00:00","2021-06-08",1519,10,18,601,311,2459
"Newham","11:00:00","2021-06-08",395,35,16,83,23,552
"Sutton","11:00:00","2021-06-08",15,0,0,1,2,18
"Bexley","12:00:00","2021-06-08",109,1,0,18,61,189
"Brent","12:00:00","2021-06-08",37,15,10,14,4,80
"Bromley","12:00:00","2021-06-08",96,0,0,12,1,109
"Hillingdon","12:00:00","2021-06-08",1717,9,17,581,238,2562
"Newham","12:00:00","2021-06-08",403,46,14,85,21,569
"Sutton","12:00:00","2021-06-08",13,0,0,2,0,15
"Bexley","13:00:00","2021-06-08",142,3,0,43,50,238
"Brent","13:00:00","2021-06-08",37,5,8,7,2,59
"Bromley","13:00:00","2021-06-08",81,0,0,21,2,104
"Hillingdon","13:00:00","2021-06-08",1871,11,24,566,304,2776
"Newham","13:00:00","2021-06-08",420,78,14,83,28,623
"Sutton","13:00:00","2021-06-08",7,0,0,1,0,8
"Bexley","14:00:00","2021-06-08",131,1,0,32,47,211
"Brent","14:00:00","2021-06-08",36,3,12,6,3,60
"Bromley","14:00:00","2021-06-08",105,0,0,17,0,122
"Hillingdon","14:00:00","2021-06-08",2040,11,26,588,314,2979
"Newham","14:00:00","2021-06-08",426,41,16,64,20,567
"Sutton","14:00:00","2021-06-08",12,0,0,1,1,14
"Bexley","15:00:00","2021-06-08",163,3,0,23,52,241
"Brent","15:00:00","2021-06-08",54,6,13,6,3,82
"Bromley","15:00:00","2021-06-08",132,2,1,24,3,162
"Hillingdon","15:00:00","2021-06-08",2339,25,38,678,263,3343
"Newham","15:00:00","2021-06-08",458,42,15,43,14,572
"Sutton","15:00:00","2021-06-08",13,4,0,1,0,18
"Bexley","16:00:00","2021-06-08",150,2,0,34,53,239
"Brent","16:00:00","2021-06-08",51,1,10,0,1,63
"Bromley","16:00:00","2021-06-08",157,4,3,24,1,189
"Hillingdon","16:00:00","2021-06-08",2581,22,35,670,176,3484
"Newham","16:00:00","2021-06-08",455,28,16,51,14,564
"Sutton","16:00:00","2021-06-08",17,3,0,7,2,29
"Bexley","17:00:00","2021-06-08",266,2,0,13,37,318
"Brent","17:00:00","2021-06-08",61,9,9,2,0,81
"Bromley","17:00:00","2021-06-08",201,0,0,11,0,212
"Hillingdon","17:00:00","2021-06-08",3170,33,33,636,133,4005
"Newham","17:00:00","2021-06-08",505,49,15,48,9,626
"Sutton","17:00:00","2021-06-08",8,0,0,2,0,10
"Bexley","18:00:00","2021-06-08",165,5,0,14,33,217
"Brent","18:00:00","2021-06-08",43,8,11,0,3,65
"Bromley","18:00:00","2021-06-08",136,1,0,4,0,141
"Hillingdon","18:00:00","2021-06-08",2631,25,25,511,118,3310
"Newham","18:00:00","2021-06-08",526,64,16,50,9,665
"Sutton","18:00:00","2021-06-08",13,0,0,2,0,15
"Barking and Dagenham","07:00:00","2021-06-09",1066,10,2,275,29,1382
"Bromley","07:00:00","2021-06-09",50,0,0,15,0,65
"Camden","07:00:00","2021-06-09",132,18,24,69,12,255
"Greenwich","07:00:00","2021-06-09",756,14,17,196,15,998
"Islington","07:00:00","2021-06-09",470,38,19,201,41,769
"Redbridge","07:00:00","2021-06-09",500,5,9,112,4,630
"Wandsworth","07:00:00","2021-06-09",89,3,0,18,2,112
"Barking and Dagenham","08:00:00","2021-06-09",973,10,0,195,23,1201
"Bromley","08:00:00","2021-06-09",66,1,0,10,1,78
"Camden","08:00:00","2021-06-09",201,14,23,70,17,325
"Greenwich","08:00:00","2021-06-09",757,17,17,167,14,972
"Islington","08:00:00","2021-06-09",522,38,19,185,31,795
"Redbridge","08:00:00","2021-06-09",669,5,9,87,9,779
"Wandsworth","08:00:00","2021-06-09",100,7,0,36,2,145
"Barking and Dagenham","09:00:00","2021-06-09",944,15,4,193,26,1182
"Bromley","09:00:00","2021-06-09",83,0,0,8,1,92
"Camden","09:00:00","2021-06-09",193,23,30,67,24,337
"Greenwich","09:00:00","2021-06-09",569,5,18,91,15,698
"Islington","09:00:00","2021-06-09",469,54,17,175,48,763
"Redbridge","09:00:00","2021-06-09",373,1,9,67,10,460
"Wandsworth","09:00:00","2021-06-09",109,4,0,33,16,162
"Barking and Dagenham","10:00:00","2021-06-09",992,27,6,162,30,1217
"Bromley","10:00:00","2021-06-09",93,1,0,13,0,107
"Camden","10:00:00","2021-06-09",142,18,24,73,18,275
"Greenwich","10:00:00","2021-06-09",532,11,16,123,22,704
"Islington","10:00:00","2021-06-09",453,42,16,197,50,758
"Redbridge","10:00:00","2021-06-09",221,0,10,35,4,270
"Wandsworth","10:00:00","2021-06-09",159,11,0,34,7,211
"Barking and Dagenham","11:00:00","2021-06-09",1016,27,3,181,31,1258
"Bromley","11:00:00","2021-06-09",76,0,0,10,3,89
"Camden","11:00:00","2021-06-09",201,28,25,68,21,343
"Greenwich","11:00:00","2021-06-09",551,10,16,103,29,709
"Islington","11:00:00","2021-06-09",463,39,13,203,55,773
"Redbridge","11:00:00","2021-06-09",277,2,7,55,7,348
"Wandsworth","11:00:00","2021-06-09",110,11,0,29,3,153
"Barking and Dagenham","12:00:00","2021-06-09",1185,23,1,183,30,1422
"Bromley","12:00:00","2021-06-09",66,0,0,8,0,74
"Camden","12:00:00","2021-06-09",246,42,21,88,17,414
"Greenwich","12:00:00","2021-06-09",613,10,16,112,19,770
"Islington","12:00:00","2021-06-09",485,54,16,203,58,816
"Redbridge","12:00:00","2021-06-09",218,7,5,45,3,278
"Wandsworth","12:00:00","2021-06-09",111,14,0,28,8,161
"Barking and Dagenham","13:00:00","2021-06-09",1217,31,1,180,29,1458
"Bromley","13:00:00","2021-06-09",55,1,0,12,1,69
"Camden","13:00:00","2021-06-09",257,51,25,68,10,411
"Greenwich","13:00:00","2021-06-09",615,21,14,104,23,777
"Islington","13:00:00","2021-06-09",503,68,13,224,33,841
"Redbridge","13:00:00","2021-06-09",233,2,8,39,7,289
"Wandsworth","13:00:00","2021-06-09",116,21,0,33,6,176
"Barking and Dagenham","14:00:00","2021-06-09",1178,26,6,193,35,1438
"Bromley","14:00:00","2021-06-09",59,0,0,11,0,70
"Camden","14:00:00","2021-06-09",237,53,23,89,19,421
"Greenwich","14:00:00","2021-06-09",704,15,19,138,16,892
"Islington","14:00:00","2021-06-09",520,56,16,224,37,853
"Redbridge","14:00:00","2021-06-09",270,2,9,41,3,325
"Wandsworth","14:00:00","2021-06-09",129,10,0,34,2,175
"Barking and Dagenham","15:00:00","2021-06-09",1280,23,1,174,15,1493
"Bromley","15:00:00","2021-06-09",58,0,0,10,0,68
"Camden","15:00:00","2021-06-09",301,54,24,61,21,461
"Greenwich","15:00:00","2021-06-09",724,12,15,124,20,895
"Islington","15:00:00","2021-06-09",581,42,14,190,23,850
"Redbridge","15:00:00","2021-06-09",438,6,9,57,7,517
"Wandsworth","15:00:00","2021-06-09",180,8,0,29,3,220
"Barking and Dagenham","16:00:00","2021-06-09",1282,28,1,187,20,1518
"Bromley","16:00:00","2021-06-09",67,0,0,7,0,74
"Camden","16:00:00","2021-06-09",290,42,27,67,16,442
"Greenwich","16:00:00","2021-06-09",670,21,19,123,6,839
"Islington","16:00:00","2021-06-09",526,58,17,147,23,771
"Redbridge","16:00:00","2021-06-09",415,6,9,67,3,500
"Wandsworth","16:00:00","2021-06-09",184,18,0,37,4,243
"Barking and Dagenham","17:00:00","2021-06-09",1336,31,4,218,9,1598
"Bromley","17:00:00","2021-06-09",78,0,0,9,2,89
"Camden","17:00:00","2021-06-09",299,63,24,54,24,464
"Greenwich","17:00:00","2021-06-09",749,30,15,112,7,913
"Islington","17:00:00","2021-06-09",616,78,13,119,14,840
"Redbridge","17:00:00","2021-06-09",357,3,7,48,5,420
"Wandsworth","17:00:00","2021-06-09",189,16,0,28,4,237
"Barking and Dagenham","18:00:00","2021-06-09",1353,44,2,180,6,1585
"Bromley","18:00:00","2021-06-09",42,1,0,6,0,49
"Camden","18:00:00","2021-06-09",321,69,27,36,17,470
"Greenwich","18:00:00","2021-06-09",708,18,18,63,7,814
"Islington","18:00:00","2021-06-09",635,95,17,76,8,831
"Redbridge","18:00:00","2021-06-09",360,7,8,35,2,412
"Wandsworth","18:00:00","2021-06-09",181,17,0,15,1,214
"Greenwich","07:00:00","2021-06-10",1135,35,46,524,184,1924
"Kingston upon Thames","07:00:00","2021-06-10",5821,168,50,2096,296,8431
"Lambeth","07:00:00","2021-06-10",464,36,52,176,27,755
"Merton","07:00:00","2021-06-10",1261,49,40,405,69,1824
"Redbridge","07:00:00","2021-06-10",24,0,0,4,0,28
"Southwark","07:00:00","2021-06-10",130,4,7,29,3,173
"Tower Hamlets","07:00:00","2021-06-10",1888,97,29,783,234,3031
"Westminster","07:00:00","2021-06-10",2596,243,21,1090,270,4220
"Greenwich","08:00:00","2021-06-10",1322,36,40,431,240,2069
"Kingston upon Thames","08:00:00","2021-06-10",5857,150,34,1465,376,7882
"Lambeth","08:00:00","2021-06-10",740,26,52,177,23,1018
"Merton","08:00:00","2021-06-10",1300,28,39,289,66,1722
"Redbridge","08:00:00","2021-06-10",60,0,0,1,0,61
"Southwark","08:00:00","2021-06-10",240,1,9,31,4,285
"Tower Hamlets","08:00:00","2021-06-10",1803,66,27,627,261,2784
"Westminster","08:00:00","2021-06-10",2739,237,13,959,294,4242
"Greenwich","09:00:00","2021-06-10",1192,53,40,370,278,1933
"Kingston upon Thames","09:00:00","2021-06-10",5332,103,22,1331,384,7172
"Lambeth","09:00:00","2021-06-10",669,32,47,181,27,956
"Merton","09:00:00","2021-06-10",1088,27,39,284,88,1526
"Redbridge","09:00:00","2021-06-10",45,1,0,9,1,56
"Southwark","09:00:00","2021-06-10",181,2,8,35,6,232
"Tower Hamlets","09:00:00","2021-06-10",1760,75,32,668,366,2901
"Westminster","09:00:00","2021-06-10",2734,158,11,1051,320,4274
"Greenwich","10:00:00","2021-06-10",995,50,40,353,243,1681
"Kingston upon Thames","10:00:00","2021-06-10",4717,85,15,1209,368,6394
"Lambeth","10:00:00","2021-06-10",427,26,43,94,34,624
"Merton","10:00:00","2021-06-10",925,34,26,331,102,1418
"Redbridge","10:00:00","2021-06-10",56,1,0,5,0,62
"Southwark","10:00:00","2021-06-10",117,3,9,44,6,179
"Tower Hamlets","10:00:00","2021-06-10",1588,77,22,671,364,2722
"Westminster","10:00:00","2021-06-10",2712,124,7,1073,300,4216
"Greenwich","11:00:00","2021-06-10",1236,70,38,365,241,1950
"Kingston upon Thames","11:00:00","2021-06-10",4661,85,16,1277,415,6454
"Lambeth","11:00:00","2021-06-10",374,30,42,136,28,610
"Merton","11:00:00","2021-06-10",1016,42,33,292,99,1482
"Redbridge","11:00:00","2021-06-10",50,0,0,7,0,57
"Southwark","11:00:00","2021-06-10",117,6,8,43,7,181
"Tower Hamlets","11:00:00","2021-06-10",1640,83,18,555,298,2594
"Westminster","11:00:00","2021-06-10",2691,135,5,1098,305,4234
"Greenwich","12:00:00","2021-06-10",1263,108,32,299,233,1935
"Kingston upon Thames","12:00:00","2021-06-10",4736,108,23,1270,388,6525
"Lambeth","12:00:00","2021-06-10",472,46,41,117,23,699
"Merton","12:00:00","2021-06-10",959,43,30,267,94,1393
"Redbridge","12:00:00","2021-06-10",51,1,0,4,0,56
"Southwark","12:00:00","2021-06-10",143,5,9,47,6,210
"Tower Hamlets","12:00:00","2021-06-10",1641,97,23,568,285,2614
"Westminster","12:00:00","2021-06-10",2769,121,7,972,272,4141
"Greenwich","13:00:00","2021-06-10",1331,109,43,316,249,2048
"Kingston upon Thames","13:00:00","2021-06-10",4846,111,21,1332,369,6679
"Lambeth","13:00:00","2021-06-10",462,33,42,134,20,691
"Merton","13:00:00","2021-06-10",1068,51,27,269,83,1498
"Redbridge","13:00:00","2021-06-10",51,3,0,4,1,59
"Southwark","13:00:00","2021-06-10",165,8,8,64,6,251
"Tower Hamlets","13:00:00","2021-06-10",1873,101,21,630,321,2946
"Westminster","13:00:00","2021-06-10",2858,142,8,965,288,4261
"Greenwich","14:00:00","2021-06-10",1368,82,41,261,212,1964
"Kingston upon Thames","14:00:00","2021-06-10",5330,103,29,1530,351,7343
"Lambeth","14:00:00","2021-06-10",545,39,43,138,30,795
"Merton","14:00:00","2021-06-10",1164,43,38,301,76,1622
"Redbridge","14:00:00","2021-06-10",52,3,0,8,0,63
"Southwark","14:00:00","2021-06-10",273,11,7,85,9,385
"Tower Hamlets","14:00:00","2021-06-10",1896,116,25,593,267,2897
"Westminster","14:00:00","2021-06-10",2927,166,16,999,277,4385
"Greenwich","15:00:00","2021-06-10",1289,73,38,328,150,1878
"Kingston upon Thames","15:00:00","2021-06-10",5938,138,31,1712,285,8104
"Lambeth","15:00:00","2021-06-10",735,36,45,176,21,1013
"Merton","15:00:00","2021-06-10",1209,41,41,287,59,1637
"Redbridge","15:00:00","2021-06-10",74,0,0,9,1,84
"Southwark","15:00:00","2021-06-10",244,10,9,55,7,325
"Tower Hamlets","15:00:00","2021-06-10",1933,103,20,579,187,2822
"Westminster","15:00:00","2021-06-10",3013,183,10,964,213,4383
"Greenwich","16:00:00","2021-06-10",1463,103,34,318,120,2038
"Kingston upon Thames","16:00:00","2021-06-10",6677,183,39,1800,207,8906
"Lambeth","16:00:00","2021-06-10",780,53,48,197,13,1091
"Merton","16:00:00","2021-06-10",1352,65,34,302,46,1799
"Redbridge","16:00:00","2021-06-10",56,2,0,4,1,63
"Southwark","16:00:00","2021-06-10",276,15,8,61,6,366
"Tower Hamlets","16:00:00","2021-06-10",1784,143,19,459,122,2527
"Westminster","16:00:00","2021-06-10",3341,262,26,957,161,4747
"Greenwich","17:00:00","2021-06-10",1683,132,34,207,70,2126
"Kingston upon Thames","17:00:00","2021-06-10",7233,234,39,1329,126,8961
"Lambeth","17:00:00","2021-06-10",862,54,42,160,13,1131
"Merton","17:00:00","2021-06-10",1400,82,33,265,29,1809
"Redbridge","17:00:00","2021-06-10",48,5,0,3,1,57
"Southwark","17:00:00","2021-06-10",268,11,8,38,4,329
"Tower Hamlets","17:00:00","2021-06-10",2117,179,17,414,76,2803
"Westminster","17:00:00","2021-06-10",3403,274,12,745,120,4554
"Greenwich","18:00:00","2021-06-10",1700,114,39,172,62,2087
"Kingston upon Thames","18:00:00","2021-06-10",6687,178,29,994,124,8012
"Lambeth","18:00:00","2021-06-10",753,73,47,87,7,967
"Merton","18:00:00","2021-06-10",1414,62,26,216,24,1742
"Redbridge","18:00:00","2021-06-10",52,1,0,4,0,57
"Southwark","18:00:00","2021-06-10",240,10,10,42,0,302
"Tower Hamlets","18:00:00","2021-06-10",2349,146,22,398,72,2987
"Westminster","18:00:00","2021-06-10",3687,231,4,549,88,4559
"Greenwich","07:00:00","2021-06-11",695,57,86,475,52,1365
"Hackney","07:00:00","2021-06-11",118,11,37,44,12,222
"Harrow","07:00:00","2021-06-11",1053,24,29,237,49,1392
"Islington","07:00:00","2021-06-11",202,30,33,122,44,431
"Kingston upon Thames","07:00:00","2021-06-11",158,2,20,34,2,216
"Southwark","07:00:00","2021-06-11",123,35,2,147,38,345
"Westminster","07:00:00","2021-06-11",1602,268,227,926,218,3241
"Greenwich","08:00:00","2021-06-11",790,58,79,396,59,1382
"Hackney","08:00:00","2021-06-11",162,13,40,50,11,276
"Harrow","08:00:00","2021-06-11",1286,21,26,174,43,1550
"Islington","08:00:00","2021-06-11",232,28,32,101,42,435
"Kingston upon Thames","08:00:00","2021-06-11",325,4,16,39,4,388
"Southwark","08:00:00","2021-06-11",135,42,0,129,45,351
"Westminster","08:00:00","2021-06-11",1944,195,241,754,224,3358
"Greenwich","09:00:00","2021-06-11",742,47,76,362,72,1299
"Hackney","09:00:00","2021-06-11",153,19,42,67,20,301
"Harrow","09:00:00","2021-06-11",1003,13,24,203,64,1307
"Islington","09:00:00","2021-06-11",217,31,33,115,45,441
"Kingston upon Thames","09:00:00","2021-06-11",144,5,18,27,7,201
"Southwark","09:00:00","2021-06-11",143,37,0,99,40,319
"Westminster","09:00:00","2021-06-11",2013,141,231,667,229,3281
"Greenwich","10:00:00","2021-06-11",677,48,77,337,59,1198
"Hackney","10:00:00","2021-06-11",139,23,40,78,17,297
"Harrow","10:00:00","2021-06-11",1011,11,19,211,53,1305
"Islington","10:00:00","2021-06-11",204,27,30,120,43,424
"Kingston upon Thames","10:00:00","2021-06-11",123,3,16,21,4,167
"Southwark","10:00:00","2021-06-11",143,45,0,112,37,337
"Westminster","10:00:00","2021-06-11",2116,136,238,750,258,3498
"Greenwich","11:00:00","2021-06-11",767,74,72,315,60,1288
"Hackney","11:00:00","2021-06-11",152,22,40,86,25,325
"Harrow","11:00:00","2021-06-11",857,34,28,163,63,1145
"Islington","11:00:00","2021-06-11",209,36,30,119,46,440
"Kingston upon Thames","11:00:00","2021-06-11",157,2,18,36,4,217
"Southwark","11:00:00","2021-06-11",126,38,0,81,31,276
"Westminster","11:00:00","2021-06-11",2080,128,231,694,224,3357
"Greenwich","12:00:00","2021-06-11",752,85,73,264,51,1225
"Hackney","12:00:00","2021-06-11",184,41,38,73,13,349
"Harrow","12:00:00","2021-06-11",1042,54,24,191,62,1373
"Islington","12:00:00","2021-06-11",229,51,30,118,44,472
"Kingston upon Thames","12:00:00","2021-06-11",184,2,16,34,4,240
"Southwark","12:00:00","2021-06-11",141,65,1,82,30,319
"Westminster","12:00:00","2021-06-11",2282,187,216,634,191,3510
"Greenwich","13:00:00","2021-06-11",696,91,69,264,48,1168
"Hackney","13:00:00","2021-06-11",173,39,40,76,10,338
"Harrow","13:00:00","2021-06-11",1063,40,25,161,45,1334
"Islington","13:00:00","2021-06-11",227,36,29,127,25,444
"Kingston upon Thames","13:00:00","2021-06-11",196,4,19,33,5,257
"Southwark","13:00:00","2021-06-11",137,53,0,80,15,285
"Westminster","13:00:00","2021-06-11",2252,165,231,586,159,3393
"Greenwich","14:00:00","2021-06-11",791,90,71,225,50,1227
"Hackney","14:00:00","2021-06-11",189,48,34,74,10,355
"Harrow","14:00:00","2021-06-11",1125,49,18,191,48,1431
"Islington","14:00:00","2021-06-11",250,40,31,123,33,477
"Kingston upon Thames","14:00:00","2021-06-11",212,3,16,27,0,258
"Southwark","14:00:00","2021-06-11",130,38,0,77,12,257
"Westminster","14:00:00","2021-06-11",2189,192,210,540,140,3271
"Greenwich","15:00:00","2021-06-11",833,85,70,210,24,1222
"Hackney","15:00:00","2021-06-11",232,43,37,78,9,399
"Harrow","15:00:00","2021-06-11",1209,46,27,162,30,1474
"Islington","15:00:00","2021-06-11",256,49,21,116,18,460
"Kingston upon Thames","15:00:00","2021-06-11",274,6,17,48,6,351
"Southwark","15:00:00","2021-06-11",110,38,0,56,15,219
"Westminster","15:00:00","2021-06-11",2246,243,221,492,102,3304
"Greenwich","16:00:00","2021-06-11",896,104,66,211,42,1319
"Hackney","16:00:00","2021-06-11",229,52,38,62,8,389
"Harrow","16:00:00","2021-06-11",1239,52,24,193,32,1540
"Islington","16:00:00","2021-06-11",287,48,23,110,17,485
"Kingston upon Thames","16:00:00","2021-06-11",259,5,20,45,7,336
"Southwark","16:00:00","2021-06-11",81,25,0,63,10,179
"Westminster","16:00:00","2021-06-11",2355,241,234,527,67,3424
"Greenwich","17:00:00","2021-06-11",896,128,66,221,22,1333
"Hackney","17:00:00","2021-06-11",239,43,42,44,10,378
"Harrow","17:00:00","2021-06-11",1360,53,24,168,28,1633
"Islington","17:00:00","2021-06-11",306,41,24,81,15,467
"Kingston upon Thames","17:00:00","2021-06-11",281,10,18,49,3,361
"Southwark","17:00:00","2021-06-11",156,44,0,38,3,241
"Westminster","17:00:00","2021-06-11",2661,281,218,413,57,3630
"Greenwich","18:00:00","2021-06-11",984,181,84,118,22,1389
"Hackney","18:00:00","2021-06-11",285,65,34,42,6,432
"Harrow","18:00:00","2021-06-11",1373,65,20,166,19,1643
"Islington","18:00:00","2021-06-11",291,55,32,47,13,438
"Kingston upon Thames","18:00:00","2021-06-11",268,11,17,28,0,324
"Southwark","18:00:00","2021-06-11",194,67,0,30,12,303
"Westminster","18:00:00","2021-06-11",2828,235,223,288,49,3623
"Bexley","07:00:00","2021-06-14",3179,148,17,1047,276,4667
"Havering","07:00:00","2021-06-14",511,2,2,164,20,699
"Hillingdon","07:00:00","2021-06-14",2923,60,14,882,227,4106
"Lewisham","07:00:00","2021-06-14",546,23,17,161,15,762
"Richmond upon Thames","07:00:00","2021-06-14",552,23,75,148,30,828
"Bexley","08:00:00","2021-06-14",4335,95,20,1338,388,6176
"Havering","08:00:00","2021-06-14",548,2,1,118,18,687
"Hillingdon","08:00:00","2021-06-14",2572,41,11,666,195,3485
"Lewisham","08:00:00","2021-06-14",547,10,14,129,25,725
"Richmond upon Thames","08:00:00","2021-06-14",666,17,73,105,21,882
"Bexley","09:00:00","2021-06-14",3577,53,13,1212,456,5311
"Havering","09:00:00","2021-06-14",368,4,1,112,14,499
"Hillingdon","09:00:00","2021-06-14",2505,28,7,763,259,3562
"Lewisham","09:00:00","2021-06-14",484,20,17,122,18,661
"Richmond upon Thames","09:00:00","2021-06-14",589,19,76,135,24,843
"Bexley","10:00:00","2021-06-14",3379,46,14,941,453,4833
"Havering","10:00:00","2021-06-14",346,4,3,121,19,493
"Hillingdon","10:00:00","2021-06-14",2749,32,8,750,300,3839
"Lewisham","10:00:00","2021-06-14",492,4,15,123,18,652
"Richmond upon Thames","10:00:00","2021-06-14",542,26,67,140,33,808
"Bexley","11:00:00","2021-06-14",3415,38,11,990,432,4886
"Havering","11:00:00","2021-06-14",358,5,3,97,22,485
"Hillingdon","11:00:00","2021-06-14",2975,40,3,735,310,4063
"Lewisham","11:00:00","2021-06-14",429,16,13,101,16,575
"Richmond upon Thames","11:00:00","2021-06-14",602,37,65,155,33,892
"Bexley","12:00:00","2021-06-14",2970,46,6,844,328,4194
"Havering","12:00:00","2021-06-14",359,3,1,104,26,493
"Hillingdon","12:00:00","2021-06-14",3096,31,10,698,241,4076
"Lewisham","12:00:00","2021-06-14",498,21,16,98,17,650
"Richmond upon Thames","12:00:00","2021-06-14",611,47,64,126,18,866
"Bexley","13:00:00","2021-06-14",3544,48,9,1195,445,5241
"Havering","13:00:00","2021-06-14",384,11,3,107,15,520
"Hillingdon","13:00:00","2021-06-14",3323,43,20,694,278,4358
"Lewisham","13:00:00","2021-06-14",457,19,11,94,12,593
"Richmond upon Thames","13:00:00","2021-06-14",570,45,65,133,34,847
"Bexley","14:00:00","2021-06-14",3922,79,17,1446,439,5903
"Havering","14:00:00","2021-06-14",372,8,1,105,24,510
"Hillingdon","14:00:00","2021-06-14",3203,56,13,688,264,4224
"Lewisham","14:00:00","2021-06-14",476,23,17,101,12,629
"Richmond upon Thames","14:00:00","2021-06-14",631,36,71,106,20,864
"Bexley","15:00:00","2021-06-14",4101,84,7,1501,319,6012
"Havering","15:00:00","2021-06-14",393,8,1,121,14,537
"Hillingdon","15:00:00","2021-06-14",3234,53,15,739,237,4278
"Lewisham","15:00:00","2021-06-14",571,27,12,91,9,710
"Richmond upon Thames","15:00:00","2021-06-14",699,34,68,105,21,927
"Bexley","16:00:00","2021-06-14",4630,181,9,1533,208,6561
"Havering","16:00:00","2021-06-14",473,16,3,159,11,662
"Hillingdon","16:00:00","2021-06-14",3402,69,17,708,177,4373
"Lewisham","16:00:00","2021-06-14",527,23,15,66,7,638
"Richmond upon Thames","16:00:00","2021-06-14",759,59,66,109,14,1007
"Havering","17:00:00","2021-06-14",542,4,1,106,12,665
"Hillingdon","17:00:00","2021-06-14",3441,87,11,602,116,4257
"Lewisham","17:00:00","2021-06-14",584,21,11,70,6,692
"Richmond upon Thames","17:00:00","2021-06-14",763,66,62,68,3,962
"Bexley","18:00:00","2021-06-14",5025,154,22,883,146,6230
"Havering","18:00:00","2021-06-14",391,7,1,57,4,460
"Hillingdon","18:00:00","2021-06-14",3672,65,10,531,83,4361
"Lewisham","18:00:00","2021-06-14",568,28,17,45,8,666
"Richmond upon Thames","18:00:00","2021-06-14",678,68,66,47,9,868
"Brent","07:00:00","2021-06-15",784,39,50,275,83,1231
"Croydon","07:00:00","2021-06-15",1380,28,50,383,49,1890
"Greenwich","07:00:00","2021-06-15",3105,191,16,1495,378,5185
"Harrow","07:00:00","2021-06-15",1085,25,102,238,35,1485
"Havering","07:00:00","2021-06-15",1201,20,10,169,37,1437
"Hounslow","07:00:00","2021-06-15",688,19,9,175,26,917
"Lewisham","07:00:00","2021-06-15",1016,29,13,283,41,1382
"Tower Hamlets","07:00:00","2021-06-15",2137,128,39,805,271,3380
"Brent","08:00:00","2021-06-15",1032,47,35,196,74,1384
"Croydon","08:00:00","2021-06-15",1660,20,42,312,53,2087
"Greenwich","08:00:00","2021-06-15",3112,108,7,1110,386,4723
"Harrow","08:00:00","2021-06-15",1450,17,85,212,45,1809
"Havering","08:00:00","2021-06-15",1457,17,8,163,39,1684
"Hounslow","08:00:00","2021-06-15",704,16,8,108,32,868
"Lewisham","08:00:00","2021-06-15",1033,21,12,251,60,1377
"Tower Hamlets","08:00:00","2021-06-15",2264,117,27,746,295,3449
"Brent","09:00:00","2021-06-15",940,36,36,244,87,1343
"Croydon","09:00:00","2021-06-15",1320,13,41,250,62,1686
"Greenwich","09:00:00","2021-06-15",2913,83,13,1035,388,4432
"Harrow","09:00:00","2021-06-15",1188,21,76,196,45,1526
"Havering","09:00:00","2021-06-15",1374,14,10,178,67,1643
"Hounslow","09:00:00","2021-06-15",630,12,6,111,29,788
"Lewisham","09:00:00","2021-06-15",888,15,12,242,41,1198
"Tower Hamlets","09:00:00","2021-06-15",2022,124,31,845,347,3369
"Brent","10:00:00","2021-06-15",826,37,31,228,98,1220
"Croydon","10:00:00","2021-06-15",1127,14,35,209,60,1445
"Greenwich","10:00:00","2021-06-15",2543,43,10,843,442,3881
"Harrow","10:00:00","2021-06-15",1081,23,77,179,71,1431
"Havering","10:00:00","2021-06-15",1229,19,5,136,52,1441
"Hounslow","10:00:00","2021-06-15",595,6,7,107,36,751
"Lewisham","10:00:00","2021-06-15",710,18,14,186,57,985
"Tower Hamlets","10:00:00","2021-06-15",1877,133,28,831,317,3186
"Brent","11:00:00","2021-06-15",833,53,25,221,107,1239
"Croydon","11:00:00","2021-06-15",1146,20,37,261,58,1522
"Greenwich","11:00:00","2021-06-15",2667,39,7,866,427,4006
"Harrow","11:00:00","2021-06-15",1101,31,74,213,50,1469
"Havering","11:00:00","2021-06-15",1273,15,1,135,51,1475
"Hounslow","11:00:00","2021-06-15",615,21,5,102,47,790
"Lewisham","11:00:00","2021-06-15",705,25,12,198,48,988
"Tower Hamlets","11:00:00","2021-06-15",1843,162,39,767,326,3137
"Brent","12:00:00","2021-06-15",906,60,24,205,105,1300
"Croydon","12:00:00","2021-06-15",1212,17,37,257,50,1573
"Greenwich","12:00:00","2021-06-15",2629,52,4,912,447,4044
"Harrow","12:00:00","2021-06-15",1169,50,73,192,35,1519
"Havering","12:00:00","2021-06-15",1274,20,1,153,49,1497
"Hounslow","12:00:00","2021-06-15",668,15,7,131,36,857
"Lewisham","12:00:00","2021-06-15",826,16,13,182,69,1106
"Tower Hamlets","12:00:00","2021-06-15",1951,208,41,697,304,3201
"Brent","13:00:00","2021-06-15",978,59,29,222,98,1386
"Croydon","13:00:00","2021-06-15",1207,32,35,301,49,1624
"Greenwich","13:00:00","2021-06-15",2649,49,4,1068,445,4215
"Harrow","13:00:00","2021-06-15",1142,62,78,190,46,1518
"Havering","13:00:00","2021-06-15",1223,28,6,147,40,1444
"Hounslow","13:00:00","2021-06-15",640,22,7,118,37,824
"Lewisham","13:00:00","2021-06-15",787,33,11,178,39,1048
"Tower Hamlets","13:00:00","2021-06-15",1981,193,30,669,289,3162
"Brent","14:00:00","2021-06-15",1183,64,30,223,85,1585
"Croydon","14:00:00","2021-06-15",1562,23,39,266,53,1943
"Greenwich","14:00:00","2021-06-15",2845,68,7,1175,390,4485
"Harrow","14:00:00","2021-06-15",1320,70,82,169,65,1706
"Havering","14:00:00","2021-06-15",1358,29,7,162,43,1599
"Hounslow","14:00:00","2021-06-15",694,22,5,119,29,869
"Lewisham","14:00:00","2021-06-15",856,23,13,225,44,1161
"Tower Hamlets","14:00:00","2021-06-15",2015,183,30,655,285,3168
"Brent","15:00:00","2021-06-15",1108,69,25,216,72,1490
"Croydon","15:00:00","2021-06-15",1524,24,49,300,64,1961
"Greenwich","15:00:00","2021-06-15",3134,84,9,1356,310,4893
"Harrow","15:00:00","2021-06-15",1365,41,90,201,43,1740
"Havering","15:00:00","2021-06-15",1326,11,6,186,39,1568
"Hounslow","15:00:00","2021-06-15",691,22,8,75,18,814
"Lewisham","15:00:00","2021-06-15",978,26,10,235,36,1285
"Tower Hamlets","15:00:00","2021-06-15",2082,166,37,637,208,3130
"Brent","16:00:00","2021-06-15",1112,61,39,234,56,1502
"Croydon","16:00:00","2021-06-15",1579,49,41,338,43,2050
"Greenwich","16:00:00","2021-06-15",3311,153,4,1156,180,4804
"Harrow","16:00:00","2021-06-15",1460,59,88,199,31,1837
"Havering","16:00:00","2021-06-15",1431,25,5,188,23,1672
"Hounslow","16:00:00","2021-06-15",707,26,9,103,22,867
"Lewisham","16:00:00","2021-06-15",1046,40,14,243,32,1375
"Tower Hamlets","16:00:00","2021-06-15",2121,218,28,501,109,2977
"Brent","17:00:00","2021-06-15",1103,81,32,183,30,1429
"Croydon","17:00:00","2021-06-15",1578,50,37,298,18,1981
"Greenwich","17:00:00","2021-06-15",3685,186,13,949,149,4982
"Harrow","17:00:00","2021-06-15",1493,94,75,182,12,1856
"Havering","17:00:00","2021-06-15",1463,30,2,145,22,1662
"Hounslow","17:00:00","2021-06-15",732,37,7,77,18,871
"Lewisham","17:00:00","2021-06-15",1161,41,13,167,20,1402
"Tower Hamlets","17:00:00","2021-06-15",2338,254,26,482,75,3175
"Brent","18:00:00","2021-06-15",1140,95,26,157,18,1436
"Croydon","18:00:00","2021-06-15",1432,35,36,194,17,1714
"Greenwich","18:00:00","2021-06-15",3463,122,11,637,85,4318
"Harrow","18:00:00","2021-06-15",1343,82,73,148,12,1658
"Havering","18:00:00","2021-06-15",1229,35,4,84,5,1357
"Hounslow","18:00:00","2021-06-15",742,38,6,83,10,879
"Lewisham","18:00:00","2021-06-15",1087,30,12,118,20,1267
"Tower Hamlets","18:00:00","2021-06-15",2449,269,31,374,65,3188
"Bromley","07:00:00","2021-06-16",1102,27,23,356,92,1600
"Haringey","07:00:00","2021-06-16",6,0,0,2,0,8
"Kensington and Chelsea","07:00:00","2021-06-16",431,35,26,128,14,634
"Kingston upon Thames","07:00:00","2021-06-16",5669,203,32,1906,289,8099
"Lambeth","07:00:00","2021-06-16",188,5,9,45,13,260
"Bromley","08:00:00","2021-06-16",1059,19,19,262,102,1461
"Haringey","08:00:00","2021-06-16",18,0,0,2,3,23
"Kensington and Chelsea","08:00:00","2021-06-16",634,24,26,138,13,835
"Kingston upon Thames","08:00:00","2021-06-16",5587,166,11,1387,330,7481
"Lambeth","08:00:00","2021-06-16",173,1,6,27,5,212
"Bromley","09:00:00","2021-06-16",1143,15,13,301,114,1586
"Haringey","09:00:00","2021-06-16",14,0,0,3,1,18
"Kensington and Chelsea","09:00:00","2021-06-16",479,39,30,171,14,733
"Kingston upon Thames","09:00:00","2021-06-16",5023,96,20,1334,369,6842
"Lambeth","09:00:00","2021-06-16",137,5,8,44,7,201
"Bromley","10:00:00","2021-06-16",1093,9,13,300,129,1544
"Haringey","10:00:00","2021-06-16",14,0,0,7,2,23
"Kensington and Chelsea","10:00:00","2021-06-16",471,45,28,148,16,708
"Kingston upon Thames","10:00:00","2021-06-16",4636,96,12,1195,338,6277
"Lambeth","10:00:00","2021-06-16",123,6,12,39,9,189
"Bromley","11:00:00","2021-06-16",1157,12,13,246,139,1567
"Haringey","11:00:00","2021-06-16",13,0,0,5,1,19
"Kensington and Chelsea","11:00:00","2021-06-16",463,49,28,160,13,713
"Kingston upon Thames","11:00:00","2021-06-16",4496,78,6,1137,329,6046
"Lambeth","11:00:00","2021-06-16",127,3,12,43,11,196
"Bromley","12:00:00","2021-06-16",1117,14,13,241,112,1497
"Haringey","12:00:00","2021-06-16",13,0,0,2,0,15
"Kensington and Chelsea","12:00:00","2021-06-16",492,60,26,130,27,735
"Kingston upon Thames","12:00:00","2021-06-16",4485,105,9,1167,355,6121
"Lambeth","12:00:00","2021-06-16",117,6,9,33,6,171
"Bromley","13:00:00","2021-06-16",1056,16,11,257,125,1465
"Haringey","13:00:00","2021-06-16",7,0,0,2,1,10
"Kensington and Chelsea","13:00:00","2021-06-16",506,59,29,135,27,756
"Kingston upon Thames","13:00:00","2021-06-16",4259,105,16,1121,304,5805
"Lambeth","13:00:00","2021-06-16",134,13,11,31,7,196
"Bromley","14:00:00","2021-06-16",1107,11,14,243,107,1482
"Haringey","14:00:00","2021-06-16",14,0,0,0,1,15
"Kensington and Chelsea","14:00:00","2021-06-16",559,65,28,135,18,805
"Kingston upon Thames","14:00:00","2021-06-16",4704,109,24,1307,312,6456
"Lambeth","14:00:00","2021-06-16",162,2,11,31,5,211
"Bromley","15:00:00","2021-06-16",1182,20,19,310,88,1619
"Haringey","15:00:00","2021-06-16",14,1,0,2,0,17
"Kensington and Chelsea","15:00:00","2021-06-16",622,59,27,137,11,856
"Kingston upon Thames","15:00:00","2021-06-16",5102,110,14,1281,241,6748
"Lambeth","15:00:00","2021-06-16",152,8,11,29,7,207
"Bromley","16:00:00","2021-06-16",1352,29,18,306,70,1775
"Haringey","16:00:00","2021-06-16",12,0,0,5,0,17
"Kensington and Chelsea","16:00:00","2021-06-16",558,58,26,124,9,775
"Kingston upon Thames","16:00:00","2021-06-16",5982,188,25,1564,205,7964
"Lambeth","16:00:00","2021-06-16",190,12,8,36,3,249
"Bromley","17:00:00","2021-06-16",1532,24,14,234,47,1851
"Haringey","17:00:00","2021-06-16",22,0,0,1,0,23
"Kensington and Chelsea","17:00:00","2021-06-16",619,60,23,102,8,812
"Kingston upon Thames","17:00:00","2021-06-16",5876,214,21,999,110,7220
"Lambeth","17:00:00","2021-06-16",193,13,5,21,6,238
"Bromley","18:00:00","2021-06-16",1446,14,14,187,30,1691
"Haringey","18:00:00","2021-06-16",8,0,0,1,1,10
"Kensington and Chelsea","18:00:00","2021-06-16",605,90,26,51,9,781
"Kingston upon Thames","18:00:00","2021-06-16",6013,151,16,736,99,7015
"Lambeth","18:00:00","2021-06-16",146,14,6,15,0,181
"City of London","07:00:00","2021-06-17",113,24,0,113,41,291
"Harrow","07:00:00","2021-06-17",359,2,0,32,1,394
"Lambeth","07:00:00","2021-06-17",822,225,122,400,96,1665
"Richmond upon Thames","07:00:00","2021-06-17",914,26,38,213,36,1227
"Westminster","07:00:00","2021-06-17",1855,226,118,881,233,3313
"City of London","08:00:00","2021-06-17",127,40,1,107,46,321
"Harrow","08:00:00","2021-06-17",453,2,0,19,2,476
"Lambeth","08:00:00","2021-06-17",906,154,123,366,100,1649
"Richmond upon Thames","08:00:00","2021-06-17",1037,27,32,139,35,1270
"Westminster","08:00:00","2021-06-17",1989,215,111,759,250,3324
"City of London","09:00:00","2021-06-17",99,30,1,109,40,279
"Harrow","09:00:00","2021-06-17",230,3,0,20,3,256
"Lambeth","09:00:00","2021-06-17",890,123,119,403,114,1649
"Richmond upon Thames","09:00:00","2021-06-17",895,26,39,147,45,1152
"Westminster","09:00:00","2021-06-17",1995,168,115,774,254,3306
"City of London","10:00:00","2021-06-17",124,19,0,126,53,322
"Harrow","10:00:00","2021-06-17",175,4,0,21,1,201
"Lambeth","10:00:00","2021-06-17",745,84,120,374,134,1457
"Richmond upon Thames","10:00:00","2021-06-17",791,24,33,203,46,1097
"Westminster","10:00:00","2021-06-17",2090,142,102,723,241,3298
"City of London","11:00:00","2021-06-17",152,13,1,111,43,320
"Harrow","11:00:00","2021-06-17",165,0,0,15,2,182
"Lambeth","11:00:00","2021-06-17",789,108,100,390,136,1523
"Richmond upon Thames","11:00:00","2021-06-17",840,34,25,180,41,1120
"Westminster","11:00:00","2021-06-17",1983,198,98,714,249,3242
"City of London","12:00:00","2021-06-17",136,13,2,121,38,310
"Harrow","12:00:00","2021-06-17",227,2,0,19,0,248
"Lambeth","12:00:00","2021-06-17",807,134,103,404,137,1585
"Richmond upon Thames","12:00:00","2021-06-17",865,42,29,177,27,1140
"Westminster","12:00:00","2021-06-17",2076,197,104,723,231,3331
"City of London","13:00:00","2021-06-17",130,13,4,81,37,265
"Harrow","13:00:00","2021-06-17",182,3,0,16,1,202
"Lambeth","13:00:00","2021-06-17",871,139,104,408,104,1626
"Richmond upon Thames","13:00:00","2021-06-17",863,42,29,170,38,1142
"Westminster","13:00:00","2021-06-17",1998,229,89,704,214,3234
"City of London","14:00:00","2021-06-17",130,19,1,83,42,275
"Harrow","14:00:00","2021-06-17",239,7,0,22,0,268
"Lambeth","14:00:00","2021-06-17",986,130,110,400,99,1725
"Richmond upon Thames","14:00:00","2021-06-17",926,30,34,145,33,1168
"Westminster","14:00:00","2021-06-17",2215,255,114,650,223,3457
"City of London","15:00:00","2021-06-17",145,16,3,77,21,262
"Harrow","15:00:00","2021-06-17",371,4,0,21,0,396
"Lambeth","15:00:00","2021-06-17",1100,175,107,421,77,1880
"Richmond upon Thames","15:00:00","2021-06-17",1087,29,32,151,17,1316
"Westminster","15:00:00","2021-06-17",2211,238,112,692,141,3394
"City of London","16:00:00","2021-06-17",186,21,9,63,13,292
"Harrow","16:00:00","2021-06-17",388,7,0,43,0,438
"Lambeth","16:00:00","2021-06-17",1145,202,118,381,62,1908
"Richmond upon Thames","16:00:00","2021-06-17",1099,33,33,145,17,1327
"Westminster","16:00:00","2021-06-17",2195,256,123,575,118,3267
"City of London","17:00:00","2021-06-17",177,24,6,48,14,269
"Harrow","17:00:00","2021-06-17",400,1,0,23,1,425
"Lambeth","17:00:00","2021-06-17",1226,259,117,295,49,1946
"Richmond upon Thames","17:00:00","2021-06-17",1175,27,37,113,5,1357
"Westminster","17:00:00","2021-06-17",2543,353,108,525,71,3600
"City of London","18:00:00","2021-06-17",237,27,0,30,10,304
"Harrow","18:00:00","2021-06-17",296,3,0,22,3,324
"Lambeth","18:00:00","2021-06-17",1323,249,118,214,32,1936
"Richmond upon Thames","18:00:00","2021-06-17",1200,60,21,84,10,1375
"Westminster","18:00:00","2021-06-17",2673,352,111,394,64,3594
"Bromley","07:00:00","2021-06-18",352,0,0,105,10,467
"Kingston upon Thames","07:00:00","2021-06-18",44,0,0,3,0,47
"Bromley","08:00:00","2021-06-18",488,2,0,115,12,617
"Kingston upon Thames","08:00:00","2021-06-18",69,2,0,8,1,80
"Bromley","09:00:00","2021-06-18",359,1,0,78,15,453
"Kingston upon Thames","09:00:00","2021-06-18",47,0,0,11,0,58
"Bromley","10:00:00","2021-06-18",274,1,0,80,8,363
"Kingston upon Thames","10:00:00","2021-06-18",39,0,0,3,0,42
"Bromley","11:00:00","2021-06-18",378,2,0,98,16,494
"Kingston upon Thames","11:00:00","2021-06-18",37,0,0,7,2,46
"Bromley","12:00:00","2021-06-18",555,0,0,129,31,715
"Kingston upon Thames","12:00:00","2021-06-18",46,2,0,0,0,48
"Bromley","13:00:00","2021-06-18",525,3,1,117,18,664
"Kingston upon Thames","13:00:00","2021-06-18",39,0,0,11,1,51
"Bromley","14:00:00","2021-06-18",589,4,0,143,5,741
"Kingston upon Thames","14:00:00","2021-06-18",32,2,0,6,0,40
"Bromley","15:00:00","2021-06-18",481,2,0,114,13,610
"Kingston upon Thames","15:00:00","2021-06-18",38,0,0,3,0,41
"Bromley","16:00:00","2021-06-18",543,4,0,123,16,686
"Kingston upon Thames","16:00:00","2021-06-18",39,0,0,5,0,44
"Bromley","17:00:00","2021-06-18",690,4,0,106,3,803
"Kingston upon Thames","17:00:00","2021-06-18",49,1,0,2,0,52
"Bromley","18:00:00","2021-06-18",351,3,0,47,0,401
"Kingston upon Thames","18:00:00","2021-06-18",41,0,0,2,0,43
"Newham","07:00:00","2021-06-21",284,15,74,56,17,446
"Bexley","08:00:00","2021-06-21",4580,67,20,1248,376,6291
"Newham","08:00:00","2021-06-21",730,9,80,65,21,905
"Bexley","09:00:00","2021-06-21",4059,33,23,1073,477,5665
"Newham","09:00:00","2021-06-21",452,10,74,66,12,614
"Bexley","10:00:00","2021-06-21",3801,24,22,1004,465,5316
"Newham","10:00:00","2021-06-21",363,8,71,68,14,524
"Bexley","11:00:00","2021-06-21",3899,21,12,990,458,5380
"Newham","11:00:00","2021-06-21",403,14,66,67,17,567
"Bexley","12:00:00","2021-06-21",4048,29,8,1047,423,5555
"Newham","12:00:00","2021-06-21",454,20,71,89,31,665
"Bexley","13:00:00","2021-06-21",4111,36,12,1126,476,5761
"Newham","13:00:00","2021-06-21",507,7,71,65,18,668
"Bexley","14:00:00","2021-06-21",4583,45,19,1213,447,6307
"Newham","14:00:00","2021-06-21",674,23,71,55,13,836
"Newham","15:00:00","2021-06-21",714,29,73,86,28,930
"Newham","16:00:00","2021-06-21",710,19,79,109,18,935
"Newham","17:00:00","2021-06-21",742,23,72,77,15,929
"Bexley","18:00:00","2021-06-21",5141,124,19,839,153,6276
"Havering","18:00:00","2021-06-21",4776,22,5,1094,1136,7033
"Newham","18:00:00","2021-06-21",670,29,67,51,12,829
"Greenwich","07:00:00","2021-06-22",17,0,0,6,0,23
"Kingston upon Thames","07:00:00","2021-06-22",10,0,0,5,0,15
"Redbridge","07:00:00","2021-06-22",1379,25,10,364,48,1826
"Richmond upon Thames","07:00:00","2021-06-22",2034,123,28,673,87,2945
"Southwark","07:00:00","2021-06-22",330,36,30,174,20,590
"Sutton","07:00:00","2021-06-22",994,13,20,240,34,1301
"Greenwich","08:00:00","2021-06-22",64,0,0,8,2,74
"Kingston upon Thames","08:00:00","2021-06-22",53,1,0,10,0,64
"Redbridge","08:00:00","2021-06-22",1435,16,2,263,50,1766
"Richmond upon Thames","08:00:00","2021-06-22",2300,87,30,529,91,3037
"Southwark","08:00:00","2021-06-22",417,39,31,129,18,634
"Sutton","08:00:00","2021-06-22",1083,12,20,158,25,1298
"Greenwich","09:00:00","2021-06-22",35,1,0,7,1,44
"Kingston upon Thames","09:00:00","2021-06-22",10,0,0,5,0,15
"Redbridge","09:00:00","2021-06-22",1657,28,9,377,77,2148
"Richmond upon Thames","09:00:00","2021-06-22",2109,55,26,533,107,2830
"Southwark","09:00:00","2021-06-22",374,24,36,147,17,598
"Sutton","09:00:00","2021-06-22",824,4,21,184,22,1055
"Greenwich","10:00:00","2021-06-22",22,0,0,6,1,29
"Kingston upon Thames","10:00:00","2021-06-22",16,0,0,2,1,19
"Redbridge","10:00:00","2021-06-22",1675,22,6,383,73,2159
"Richmond upon Thames","10:00:00","2021-06-22",2002,50,19,520,115,2706
"Southwark","10:00:00","2021-06-22",269,16,32,106,21,444
"Sutton","10:00:00","2021-06-22",726,14,18,161,28,947
"Greenwich","11:00:00","2021-06-22",41,1,0,9,2,53
"Kingston upon Thames","11:00:00","2021-06-22",12,0,0,4,2,18
"Redbridge","11:00:00","2021-06-22",1585,30,3,325,88,2031
"Richmond upon Thames","11:00:00","2021-06-22",1911,66,11,499,116,2603
"Southwark","11:00:00","2021-06-22",254,15,30,116,16,431
"Sutton","11:00:00","2021-06-22",751,10,19,142,43,965
"Greenwich","12:00:00","2021-06-22",35,0,0,3,1,39
"Kingston upon Thames","12:00:00","2021-06-22",20,0,0,2,2,24
"Redbridge","12:00:00","2021-06-22",1695,61,4,290,68,2118
"Richmond upon Thames","12:00:00","2021-06-22",1999,73,17,505,103,2697
"Southwark","12:00:00","2021-06-22",250,27,29,103,18,427
"Sutton","12:00:00","2021-06-22",738,17,17,153,39,964
"Greenwich","13:00:00","2021-06-22",27,1,0,11,1,40
"Kingston upon Thames","13:00:00","2021-06-22",10,0,0,3,0,13
"Redbridge","13:00:00","2021-06-22",1756,49,3,303,77,2188
"Richmond upon Thames","13:00:00","2021-06-22",1930,70,16,468,115,2599
"Southwark","13:00:00","2021-06-22",259,44,26,91,11,431
"Sutton","13:00:00","2021-06-22",780,19,20,168,34,1021
"Greenwich","14:00:00","2021-06-22",17,0,0,4,1,22
"Kingston upon Thames","14:00:00","2021-06-22",16,0,0,5,2,23
"Redbridge","14:00:00","2021-06-22",1809,67,5,288,44,2213
"Richmond upon Thames","14:00:00","2021-06-22",2221,65,25,520,95,2926
"Southwark","14:00:00","2021-06-22",313,32,35,104,20,504
"Sutton","14:00:00","2021-06-22",937,14,22,143,25,1141
"Greenwich","15:00:00","2021-06-22",69,1,0,11,0,81
"Kingston upon Thames","15:00:00","2021-06-22",33,1,0,3,2,39
"Redbridge","15:00:00","2021-06-22",1856,53,8,282,42,2241
"Richmond upon Thames","15:00:00","2021-06-22",2397,82,15,560,77,3131
"Southwark","15:00:00","2021-06-22",438,47,31,132,13,661
"Sutton","15:00:00","2021-06-22",976,16,22,147,24,1185
"Greenwich","16:00:00","2021-06-22",39,1,0,4,0,44
"Kingston upon Thames","16:00:00","2021-06-22",16,1,0,4,0,21
"Redbridge","16:00:00","2021-06-22",1900,63,15,252,26,2256
"Richmond upon Thames","16:00:00","2021-06-22",2644,82,27,558,43,3354
"Southwark","16:00:00","2021-06-22",487,63,33,181,5,769
"Sutton","16:00:00","2021-06-22",1028,36,19,184,22,1289
"Greenwich","17:00:00","2021-06-22",39,0,0,7,1,47
"Kingston upon Thames","17:00:00","2021-06-22",35,0,0,0,1,36
"Redbridge","17:00:00","2021-06-22",2096,62,3,290,27,2478
"Richmond upon Thames","17:00:00","2021-06-22",2813,123,22,390,36,3384
"Southwark","17:00:00","2021-06-22",509,50,30,108,6,703
"Sutton","17:00:00","2021-06-22",1042,40,21,174,10,1287
"Greenwich","18:00:00","2021-06-22",27,0,0,3,0,30
"Kingston upon Thames","18:00:00","2021-06-22",12,0,0,1,0,13
"Redbridge","18:00:00","2021-06-22",1936,65,4,257,26,2288
"Richmond upon Thames","18:00:00","2021-06-22",2731,125,22,263,47,3188
"Southwark","18:00:00","2021-06-22",462,65,32,78,7,644
"Sutton","18:00:00","2021-06-22",984,19,18,130,8,1159
"Barnet","07:00:00","2021-06-23",2382,59,13,986,259,3699
"Brent","07:00:00","2021-06-23",4542,181,32,1828,561,7144
"Enfield","07:00:00","2021-06-23",168,4,0,75,33,280
"Greenwich","07:00:00","2021-06-23",2823,193,37,1289,370,4712
"Kensington and Chelsea","07:00:00","2021-06-23",85,4,0,29,5,123
"Westminster","07:00:00","2021-06-23",1098,133,201,672,180,2284
"Barnet","08:00:00","2021-06-23",2203,40,33,606,234,3116
"Brent","08:00:00","2021-06-23",4287,115,23,1601,570,6596
"Enfield","08:00:00","2021-06-23",224,0,0,71,29,324
"Greenwich","08:00:00","2021-06-23",2937,137,26,1075,446,4621
"Kensington and Chelsea","08:00:00","2021-06-23",101,4,1,28,3,137
"Westminster","08:00:00","2021-06-23",1249,117,203,521,173,2263
"Barnet","09:00:00","2021-06-23",2497,24,32,763,310,3626
"Brent","09:00:00","2021-06-23",4083,101,30,1514,679,6407
"Enfield","09:00:00","2021-06-23",225,4,0,83,24,336
"Greenwich","09:00:00","2021-06-23",3119,108,24,1079,482,4812
"Kensington and Chelsea","09:00:00","2021-06-23",100,3,0,50,13,166
"Westminster","09:00:00","2021-06-23",1213,94,200,520,188,2215
"Barnet","10:00:00","2021-06-23",2228,29,16,730,301,3304
"Brent","10:00:00","2021-06-23",3904,91,17,1507,758,6277
"Enfield","10:00:00","2021-06-23",244,0,0,55,30,329
"Greenwich","10:00:00","2021-06-23",3268,87,31,1058,539,4983
"Kensington and Chelsea","10:00:00","2021-06-23",88,6,0,45,8,147
"Westminster","10:00:00","2021-06-23",1249,77,187,543,184,2240
"Barnet","11:00:00","2021-06-23",2109,20,3,681,307,3120
"Brent","11:00:00","2021-06-23",3997,71,17,1442,760,6287
"Enfield","11:00:00","2021-06-23",248,0,0,59,24,331
"Greenwich","11:00:00","2021-06-23",3467,87,27,1071,522,5174
"Kensington and Chelsea","11:00:00","2021-06-23",85,8,0,41,9,143
"Westminster","11:00:00","2021-06-23",1314,96,193,545,193,2341
"Barnet","12:00:00","2021-06-23",2287,29,10,714,295,3335
"Brent","12:00:00","2021-06-23",4200,113,19,1466,642,6440
"Enfield","12:00:00","2021-06-23",271,2,0,51,25,349
"Greenwich","12:00:00","2021-06-23",3553,79,22,1185,520,5359
"Kensington and Chelsea","12:00:00","2021-06-23",110,11,0,53,5,179
"Westminster","12:00:00","2021-06-23",1374,127,179,513,157,2350
"Barnet","13:00:00","2021-06-23",2422,35,5,883,379,3724
"Brent","13:00:00","2021-06-23",4415,116,18,1491,711,6751
"Enfield","13:00:00","2021-06-23",284,7,0,65,28,384
"Greenwich","13:00:00","2021-06-23",3763,107,26,1321,532,5749
"Kensington and Chelsea","13:00:00","2021-06-23",102,17,2,38,6,165
"Westminster","13:00:00","2021-06-23",1274,120,189,505,150,2238
"Barnet","14:00:00","2021-06-23",2491,40,36,868,339,3774
"Brent","14:00:00","2021-06-23",4638,119,19,1456,655,6887
"Enfield","14:00:00","2021-06-23",277,6,0,78,28,389
"Greenwich","14:00:00","2021-06-23",3736,113,25,1328,429,5631
"Kensington and Chelsea","14:00:00","2021-06-23",94,8,1,34,4,141
"Westminster","14:00:00","2021-06-23",1363,117,195,460,106,2241
"Barnet","15:00:00","2021-06-23",2763,50,32,964,258,4067
"Brent","15:00:00","2021-06-23",4759,177,26,1444,510,6916
"Enfield","15:00:00","2021-06-23",271,3,0,68,23,365
"Kensington and Chelsea","15:00:00","2021-06-23",111,7,2,34,3,157
"Westminster","15:00:00","2021-06-23",1388,148,189,506,93,2324
"Barnet","16:00:00","2021-06-23",3287,32,28,1037,179,4563
"Brent","16:00:00","2021-06-23",5137,183,17,1461,334,7132
"Enfield","16:00:00","2021-06-23",269,5,0,62,11,347
"Kensington and Chelsea","16:00:00","2021-06-23",109,16,2,32,1,160
"Westminster","16:00:00","2021-06-23",1499,141,193,506,68,2407
"Barnet","17:00:00","2021-06-23",3713,65,15,995,143,4931
"Brent","17:00:00","2021-06-23",5609,231,19,1287,271,7417
"Enfield","17:00:00","2021-06-23",224,5,0,40,7,276
"Kensington and Chelsea","17:00:00","2021-06-23",166,19,0,20,3,208
"Westminster","17:00:00","2021-06-23",1676,174,206,392,51,2499
"Barnet","18:00:00","2021-06-23",3582,58,9,665,86,4400
"Brent","18:00:00","2021-06-23",5617,142,21,954,220,6954
"Enfield","18:00:00","2021-06-23",170,3,0,15,4,192
"Kensington and Chelsea","18:00:00","2021-06-23",203,12,0,18,1,234
"Westminster","18:00:00","2021-06-23",1633,150,183,218,40,2224
"Bromley","07:00:00","2021-06-24",1589,19,22,520,58,2208
"Greenwich","07:00:00","2021-06-24",12,1,0,2,1,16
"Hackney","07:00:00","2021-06-24",383,81,37,245,56,802
"Newham","07:00:00","2021-06-24",4377,307,13,1771,498,6966
"Tower Hamlets","07:00:00","2021-06-24",635,93,37,325,52,1142
"Bromley","08:00:00","2021-06-24",1618,17,34,323,54,2046
"Greenwich","08:00:00","2021-06-24",38,0,0,3,1,42
"Hackney","08:00:00","2021-06-24",364,69,43,210,65,751
"Newham","08:00:00","2021-06-24",4511,176,7,1555,575,6824
"Tower Hamlets","08:00:00","2021-06-24",660,74,45,260,67,1106
"Bromley","09:00:00","2021-06-24",1567,16,26,370,78,2057
"Greenwich","09:00:00","2021-06-24",32,2,0,6,1,41
"Hackney","09:00:00","2021-06-24",337,64,39,169,61,670
"Newham","09:00:00","2021-06-24",3974,142,12,1585,622,6335
"Tower Hamlets","09:00:00","2021-06-24",626,65,45,260,76,1072
"Bromley","10:00:00","2021-06-24",1504,19,20,332,81,1956
"Greenwich","10:00:00","2021-06-24",17,2,0,10,0,29
"Hackney","10:00:00","2021-06-24",418,62,40,207,54,781
"Newham","10:00:00","2021-06-24",3692,119,11,1393,604,5819
"Tower Hamlets","10:00:00","2021-06-24",597,60,40,267,79,1043
"Bromley","11:00:00","2021-06-24",1481,24,17,321,82,1925
"Greenwich","11:00:00","2021-06-24",28,2,0,2,0,32
"Hackney","11:00:00","2021-06-24",437,87,38,244,70,876
"Newham","11:00:00","2021-06-24",3841,116,6,1247,586,5796
"Tower Hamlets","11:00:00","2021-06-24",620,81,33,345,80,1159
"Bromley","12:00:00","2021-06-24",1555,29,18,345,66,2013
"Greenwich","12:00:00","2021-06-24",27,3,0,4,3,37
"Hackney","12:00:00","2021-06-24",422,118,36,197,46,819
"Newham","12:00:00","2021-06-24",4188,144,5,1415,572,6324
"Tower Hamlets","12:00:00","2021-06-24",608,104,36,248,61,1057
"Bromley","13:00:00","2021-06-24",1459,15,18,363,52,1907
"Greenwich","13:00:00","2021-06-24",38,3,0,2,0,43
"Hackney","13:00:00","2021-06-24",444,115,36,222,52,869
"Newham","13:00:00","2021-06-24",4313,179,10,1505,566,6573
"Tower Hamlets","13:00:00","2021-06-24",645,94,38,282,61,1120
"Bromley","14:00:00","2021-06-24",1648,20,27,355,73,2123
"Greenwich","14:00:00","2021-06-24",41,6,0,5,0,52
"Hackney","14:00:00","2021-06-24",456,107,38,238,31,870
"Newham","14:00:00","2021-06-24",4572,157,10,1520,527,6786
"Tower Hamlets","14:00:00","2021-06-24",621,87,39,296,39,1082
"Bromley","15:00:00","2021-06-24",1632,29,25,388,42,2116
"Greenwich","15:00:00","2021-06-24",50,2,0,7,2,61
"Hackney","15:00:00","2021-06-24",474,115,38,206,31,864
"Newham","15:00:00","2021-06-24",4803,235,10,1601,381,7030
"Tower Hamlets","15:00:00","2021-06-24",686,97,39,243,43,1108
"Bromley","16:00:00","2021-06-24",1784,29,20,422,35,2290
"Greenwich","16:00:00","2021-06-24",47,3,0,9,0,59
"Hackney","16:00:00","2021-06-24",508,132,40,166,22,868
"Newham","16:00:00","2021-06-24",4916,274,14,1440,253,6897
"Tower Hamlets","16:00:00","2021-06-24",666,123,36,186,31,1042
"Bromley","17:00:00","2021-06-24",1870,21,22,308,37,2258
"Greenwich","17:00:00","2021-06-24",49,8,0,8,0,65
"Hackney","17:00:00","2021-06-24",513,158,35,130,28,864
"Newham","17:00:00","2021-06-24",5285,364,5,1183,158,6995
"Tower Hamlets","17:00:00","2021-06-24",702,121,35,121,24,1003
"Bromley","18:00:00","2021-06-24",1853,26,21,209,28,2137
"Greenwich","18:00:00","2021-06-24",51,5,0,5,0,61
"Hackney","18:00:00","2021-06-24",573,135,38,80,15,841
"Newham","18:00:00","2021-06-24",5224,306,4,889,145,6568
"Tower Hamlets","18:00:00","2021-06-24",783,142,41,96,21,1083
"Barking and Dagenham","07:00:00","2021-06-25",48,0,0,13,4,65
"Waltham Forest","07:00:00","2021-06-25",1078,36,22,403,63,1602
"Barking and Dagenham","08:00:00","2021-06-25",75,2,0,9,2,88
"Waltham Forest","08:00:00","2021-06-25",1271,19,13,323,82,1708
"Barking and Dagenham","09:00:00","2021-06-25",79,0,0,14,1,94
"Waltham Forest","09:00:00","2021-06-25",1159,13,15,306,88,1581
"Barking and Dagenham","10:00:00","2021-06-25",69,0,0,7,2,78
"Barnet","10:00:00","2021-06-25",6153,112,73,1926,647,8911
"Waltham Forest","10:00:00","2021-06-25",1118,14,16,312,92,1552
"Barking and Dagenham","11:00:00","2021-06-25",49,0,0,14,4,67
"Barnet","11:00:00","2021-06-25",6327,124,52,1896,616,9015
"Waltham Forest","11:00:00","2021-06-25",1109,24,18,250,72,1473
"Barking and Dagenham","12:00:00","2021-06-25",59,1,0,16,1,77
"Waltham Forest","12:00:00","2021-06-25",1269,18,13,275,73,1648
"Barking and Dagenham","13:00:00","2021-06-25",67,1,0,13,3,84
"Waltham Forest","13:00:00","2021-06-25",1268,26,17,265,56,1632
"Barking and Dagenham","14:00:00","2021-06-25",79,0,0,9,1,89
"Waltham Forest","14:00:00","2021-06-25",1287,23,10,299,58,1677
"Barking and Dagenham","15:00:00","2021-06-25",62,0,0,4,1,67
"Waltham Forest","15:00:00","2021-06-25",1307,44,14,294,56,1715
"Barking and Dagenham","16:00:00","2021-06-25",68,3,0,10,0,81
"Waltham Forest","16:00:00","2021-06-25",1494,44,9,292,46,1885
"Barking and Dagenham","17:00:00","2021-06-25",83,2,0,4,0,89
"Waltham Forest","17:00:00","2021-06-25",1500,54,8,238,22,1822
"Barking and Dagenham","18:00:00","2021-06-25",82,6,0,4,1,93
"Waltham Forest","18:00:00","2021-06-25",1459,39,13,213,24,1748
"Camden","07:00:00","2021-06-28",192,17,0,91,12,312
"Enfield","07:00:00","2021-06-28",964,6,21,313,28,1332
"Lewisham","07:00:00","2021-06-28",6,1,0,4,0,11
"Merton","07:00:00","2021-06-28",292,4,2,93,7,398
"Tower Hamlets","07:00:00","2021-06-28",2777,340,67,1289,404,4877
"Westminster","07:00:00","2021-06-28",507,72,72,210,66,927
"Camden","08:00:00","2021-06-28",201,10,3,66,17,297
"Enfield","08:00:00","2021-06-28",1213,11,21,219,29,1493
"Lewisham","08:00:00","2021-06-28",22,0,0,0,0,22
"Merton","08:00:00","2021-06-28",327,3,1,54,3,388
"Tower Hamlets","08:00:00","2021-06-28",2955,217,60,1209,423,4864
"Westminster","08:00:00","2021-06-28",632,52,73,210,75,1042
"Camden","09:00:00","2021-06-28",261,11,2,96,27,397
"Enfield","09:00:00","2021-06-28",870,8,28,243,34,1183
"Lewisham","09:00:00","2021-06-28",20,0,0,1,0,21
"Merton","09:00:00","2021-06-28",207,2,1,46,5,261
"Tower Hamlets","09:00:00","2021-06-28",2754,151,79,1139,439,4562
"Westminster","09:00:00","2021-06-28",434,54,79,193,74,834
"Camden","10:00:00","2021-06-28",199,8,0,86,26,319
"Enfield","10:00:00","2021-06-28",716,12,21,238,24,1011
"Lewisham","10:00:00","2021-06-28",7,0,0,4,1,12
"Merton","10:00:00","2021-06-28",148,4,0,20,7,179
"Tower Hamlets","10:00:00","2021-06-28",2704,111,59,1150,533,4557
"Westminster","10:00:00","2021-06-28",536,58,80,209,69,952
"Camden","11:00:00","2021-06-28",180,11,0,80,31,302
"Enfield","11:00:00","2021-06-28",725,22,18,193,27,985
"Lewisham","11:00:00","2021-06-28",10,0,0,1,1,12
"Merton","11:00:00","2021-06-28",130,4,0,48,2,184
"Tower Hamlets","11:00:00","2021-06-28",2770,137,50,1160,486,4603
"Westminster","11:00:00","2021-06-28",556,52,77,189,74,948
"Camden","12:00:00","2021-06-28",139,17,0,51,14,221
"Enfield","12:00:00","2021-06-28",733,17,21,184,29,984
"Lewisham","12:00:00","2021-06-28",10,1,0,2,0,13
"Merton","12:00:00","2021-06-28",148,1,0,32,0,181
"Tower Hamlets","12:00:00","2021-06-28",2941,134,55,1087,467,4684
"Westminster","12:00:00","2021-06-28",630,63,66,209,66,1034
"Camden","13:00:00","2021-06-28",190,21,0,76,15,302
"Enfield","13:00:00","2021-06-28",921,17,22,223,33,1216
"Lewisham","13:00:00","2021-06-28",10,0,0,4,1,15
"Merton","13:00:00","2021-06-28",155,8,0,22,1,186
"Tower Hamlets","13:00:00","2021-06-28",3110,138,58,1140,465,4911
"Westminster","13:00:00","2021-06-28",593,70,76,183,58,980
"Camden","14:00:00","2021-06-28",204,13,1,72,8,298
"Enfield","14:00:00","2021-06-28",1081,30,20,238,25,1394
"Lewisham","14:00:00","2021-06-28",8,1,0,1,1,11
"Merton","14:00:00","2021-06-28",212,5,0,30,2,249
"Tower Hamlets","14:00:00","2021-06-28",3058,158,55,1167,412,4850
"Westminster","14:00:00","2021-06-28",692,83,72,198,51,1096
"Camden","15:00:00","2021-06-28",220,18,2,72,16,328
"Enfield","15:00:00","2021-06-28",1229,19,23,192,20,1483
"Lewisham","15:00:00","2021-06-28",28,0,0,0,1,29
"Merton","15:00:00","2021-06-28",256,6,0,46,6,314
"Tower Hamlets","15:00:00","2021-06-28",3215,245,64,1241,322,5087
"Westminster","15:00:00","2021-06-28",676,77,75,209,37,1074
"Camden","16:00:00","2021-06-28",191,19,1,59,4,274
"Enfield","16:00:00","2021-06-28",1228,21,20,236,23,1528
"Lewisham","16:00:00","2021-06-28",10,2,0,5,1,18
"Merton","16:00:00","2021-06-28",265,10,1,54,3,333
"Tower Hamlets","16:00:00","2021-06-28",3357,329,59,1147,228,5120
"Westminster","16:00:00","2021-06-28",715,92,73,210,33,1123
"Camden","17:00:00","2021-06-28",163,22,0,30,6,221
"Enfield","17:00:00","2021-06-28",1281,28,22,215,10,1556
"Lewisham","17:00:00","2021-06-28",6,1,0,1,0,8
"Merton","17:00:00","2021-06-28",296,8,0,52,2,358
"Tower Hamlets","17:00:00","2021-06-28",3700,414,62,1009,188,5373
"Westminster","17:00:00","2021-06-28",726,104,81,168,34,1113
"Camden","18:00:00","2021-06-28",158,29,0,25,3,215
"Enfield","18:00:00","2021-06-28",1089,28,23,159,15,1314
"Lewisham","18:00:00","2021-06-28",11,0,0,0,0,11
"Merton","18:00:00","2021-06-28",196,19,0,27,2,244
"Tower Hamlets","18:00:00","2021-06-28",4024,327,59,710,132,5252
"Westminster","18:00:00","2021-06-28",755,113,75,105,25,1073
"Barnet","07:00:00","2021-06-29",663,30,58,178,24,953
"Croydon","07:00:00","2021-06-29",42,0,0,8,2,52
"Ealing","07:00:00","2021-06-29",415,27,14,96,27,579
"Hackney","07:00:00","2021-06-29",86,4,9,21,8,128
"Hounslow","07:00:00","2021-06-29",2558,43,18,879,360,3858
"Tower Hamlets","07:00:00","2021-06-29",757,223,12,709,261,1962
"Barnet","08:00:00","2021-06-29",855,27,47,142,36,1107
"Croydon","08:00:00","2021-06-29",73,0,0,11,0,84
"Ealing","08:00:00","2021-06-29",443,25,14,102,24,608
"Hackney","08:00:00","2021-06-29",175,6,11,38,8,238
"Hounslow","08:00:00","2021-06-29",2323,26,11,742,375,3477
"Tower Hamlets","08:00:00","2021-06-29",879,121,16,788,304,2108
"Barnet","09:00:00","2021-06-29",846,25,47,172,34,1124
"Croydon","09:00:00","2021-06-29",31,0,0,6,2,39
"Ealing","09:00:00","2021-06-29",399,29,15,94,41,578
"Hackney","09:00:00","2021-06-29",113,2,10,25,13,163
"Hounslow","09:00:00","2021-06-29",2264,30,11,663,421,3389
"Tower Hamlets","09:00:00","2021-06-29",945,92,14,813,355,2219
"Barnet","10:00:00","2021-06-29",655,29,47,151,20,902
"Croydon","10:00:00","2021-06-29",23,1,0,8,1,33
"Ealing","10:00:00","2021-06-29",401,34,14,169,42,660
"Hackney","10:00:00","2021-06-29",80,3,6,33,13,135
"Hounslow","10:00:00","2021-06-29",2197,17,10,740,420,3384
"Tower Hamlets","10:00:00","2021-06-29",1136,81,14,899,382,2512
"Barnet","11:00:00","2021-06-29",699,31,45,145,29,949
"Croydon","11:00:00","2021-06-29",25,1,0,8,0,34
"Ealing","11:00:00","2021-06-29",414,24,15,129,50,632
"Hackney","11:00:00","2021-06-29",92,6,8,39,10,155
"Hounslow","11:00:00","2021-06-29",2403,19,4,666,415,3507
"Tower Hamlets","11:00:00","2021-06-29",1246,98,12,930,364,2650
"Barnet","12:00:00","2021-06-29",742,42,51,133,24,992
"Croydon","12:00:00","2021-06-29",15,0,0,4,0,19
"Ealing","12:00:00","2021-06-29",434,51,17,138,46,686
"Hackney","12:00:00","2021-06-29",109,10,8,33,6,166
"Hounslow","12:00:00","2021-06-29",2517,21,5,704,338,3585
"Tower Hamlets","12:00:00","2021-06-29",1276,116,13,973,342,2720
"Barnet","13:00:00","2021-06-29",760,46,45,129,20,1000
"Croydon","13:00:00","2021-06-29",20,1,0,3,2,26
"Ealing","13:00:00","2021-06-29",347,53,13,147,35,595
"Hackney","13:00:00","2021-06-29",106,9,7,25,7,154
"Hounslow","13:00:00","2021-06-29",2650,32,15,743,428,3868
"Tower Hamlets","13:00:00","2021-06-29",1403,115,14,948,292,2772
"Barnet","14:00:00","2021-06-29",788,41,47,108,31,1015
"Croydon","14:00:00","2021-06-29",30,0,0,11,0,41
"Ealing","14:00:00","2021-06-29",390,47,13,104,30,584
"Hackney","14:00:00","2021-06-29",130,8,10,32,6,186
"Hounslow","14:00:00","2021-06-29",2787,23,11,677,355,3853
"Tower Hamlets","14:00:00","2021-06-29",1360,143,14,969,303,2789
"Barnet","15:00:00","2021-06-29",782,33,49,104,16,984
"Croydon","15:00:00","2021-06-29",52,0,0,12,2,66
"Ealing","15:00:00","2021-06-29",320,32,10,94,23,479
"Hackney","15:00:00","2021-06-29",250,9,8,29,3,299
"Hounslow","15:00:00","2021-06-29",2728,30,14,656,276,3704
"Tower Hamlets","15:00:00","2021-06-29",1305,177,16,778,171,2447
"Barnet","16:00:00","2021-06-29",740,42,52,71,10,915
"Croydon","16:00:00","2021-06-29",56,0,0,6,0,62
"Ealing","16:00:00","2021-06-29",338,41,15,108,19,521
"Hackney","16:00:00","2021-06-29",167,10,15,26,0,218
"Hounslow","16:00:00","2021-06-29",3032,47,11,611,207,3908
"Tower Hamlets","16:00:00","2021-06-29",1587,235,17,760,174,2773
"Barnet","17:00:00","2021-06-29",698,41,58,73,6,876
"Croydon","17:00:00","2021-06-29",36,0,0,6,0,42
"Ealing","17:00:00","2021-06-29",511,82,12,115,26,746
"Hackney","17:00:00","2021-06-29",118,14,6,17,1,156
"Hounslow","17:00:00","2021-06-29",3097,48,19,570,150,3884
"Tower Hamlets","17:00:00","2021-06-29",1762,284,23,622,94,2785
"Barnet","18:00:00","2021-06-29",663,53,51,74,8,849
"Croydon","18:00:00","2021-06-29",25,1,0,1,0,27
"Ealing","18:00:00","2021-06-29",509,62,16,95,23,705
"Hackney","18:00:00","2021-06-29",85,14,10,9,4,122
"Hounslow","18:00:00","2021-06-29",2788,38,10,479,107,3422
"Tower Hamlets","18:00:00","2021-06-29",1782,222,16,400,68,2488
"Barking and Dagenham","07:00:00","2021-06-30",3145,70,10,1198,705,5128
"Barnet","07:00:00","2021-06-30",2657,90,46,930,215,3938
"Croydon","07:00:00","2021-06-30",1107,27,25,355,45,1559
"Enfield","07:00:00","2021-06-30",1413,10,21,469,58,1971
"Havering","07:00:00","2021-06-30",2902,86,55,803,176,4022
"Merton","07:00:00","2021-06-30",910,38,32,277,54,1311
"Tower Hamlets","07:00:00","2021-06-30",2873,288,8,1336,387,4892
"Westminster","07:00:00","2021-06-30",799,90,122,432,92,1535
"Barking and Dagenham","08:00:00","2021-06-30",3037,30,2,957,752,4778
"Barnet","08:00:00","2021-06-30",2983,68,34,629,219,3933
"Croydon","08:00:00","2021-06-30",1208,13,19,243,49,1532
"Enfield","08:00:00","2021-06-30",1553,9,17,259,50,1888
"Havering","08:00:00","2021-06-30",2965,34,35,567,167,3768
"Merton","08:00:00","2021-06-30",745,27,34,194,40,1040
"Tower Hamlets","08:00:00","2021-06-30",3164,230,12,1323,461,5190
"Westminster","08:00:00","2021-06-30",801,77,110,333,84,1405
"Barking and Dagenham","09:00:00","2021-06-30",2707,24,5,1048,879,4663
"Barnet","09:00:00","2021-06-30",2701,54,29,649,269,3702
"Croydon","09:00:00","2021-06-30",1080,22,18,278,54,1452
"Enfield","09:00:00","2021-06-30",1282,8,17,287,69,1663
"Havering","09:00:00","2021-06-30",2452,31,40,646,218,3387
"Merton","09:00:00","2021-06-30",687,31,40,208,67,1033
"Tower Hamlets","09:00:00","2021-06-30",2862,184,11,1316,512,4885
"Westminster","09:00:00","2021-06-30",764,70,125,287,85,1331
"Barking and Dagenham","10:00:00","2021-06-30",2622,15,8,1076,965,4686
"Barnet","10:00:00","2021-06-30",2580,57,24,681,295,3637
"Croydon","10:00:00","2021-06-30",894,23,16,230,64,1227
"Enfield","10:00:00","2021-06-30",1218,13,16,252,72,1571
"Havering","10:00:00","2021-06-30",2290,31,36,593,214,3164
"Merton","10:00:00","2021-06-30",789,33,32,273,80,1207
"Tower Hamlets","10:00:00","2021-06-30",2663,164,12,1235,498,4572
"Westminster","10:00:00","2021-06-30",815,43,124,314,100,1396
"Barking and Dagenham","11:00:00","2021-06-30",2721,29,3,1114,997,4864
"Barnet","11:00:00","2021-06-30",2739,44,21,658,287,3749
"Croydon","11:00:00","2021-06-30",892,20,18,208,51,1189
"Enfield","11:00:00","2021-06-30",1239,9,13,255,75,1591
"Havering","11:00:00","2021-06-30",2428,24,35,558,201,3246
"Merton","11:00:00","2021-06-30",780,25,32,259,79,1175
"Tower Hamlets","11:00:00","2021-06-30",2828,215,1,1213,497,4754
"Westminster","11:00:00","2021-06-30",815,44,112,291,96,1358
"Barking and Dagenham","12:00:00","2021-06-30",3055,30,3,1051,1016,5155
"Barnet","12:00:00","2021-06-30",2841,46,17,657,271,3832
"Croydon","12:00:00","2021-06-30",906,21,15,238,53,1233
"Enfield","12:00:00","2021-06-30",1236,8,11,279,70,1604
"Havering","12:00:00","2021-06-30",2449,36,38,574,195,3292
"Merton","12:00:00","2021-06-30",826,43,35,222,90,1216
"Tower Hamlets","12:00:00","2021-06-30",3080,284,7,1128,475,4974
"Westminster","12:00:00","2021-06-30",928,71,115,291,76,1481
"Barking and Dagenham","13:00:00","2021-06-30",3382,28,11,1247,1049,5717
"Barnet","13:00:00","2021-06-30",2792,54,24,735,274,3879
"Croydon","13:00:00","2021-06-30",922,38,17,283,44,1304
"Enfield","13:00:00","2021-06-30",1291,13,16,270,57,1647
"Havering","13:00:00","2021-06-30",2598,34,36,635,184,3487
"Merton","13:00:00","2021-06-30",920,36,33,226,96,1311
"Tower Hamlets","13:00:00","2021-06-30",3263,321,12,1266,467,5329
"Westminster","13:00:00","2021-06-30",923,72,119,300,84,1498
"Barking and Dagenham","14:00:00","2021-06-30",3628,39,8,1350,1020,6045
"Barnet","14:00:00","2021-06-30",2918,51,25,749,244,3987
"Croydon","14:00:00","2021-06-30",1084,26,18,231,49,1408
"Enfield","14:00:00","2021-06-30",1303,14,14,277,57,1665
"Havering","14:00:00","2021-06-30",2751,40,43,567,158,3559
"Merton","14:00:00","2021-06-30",913,41,30,213,48,1245
"Tower Hamlets","14:00:00","2021-06-30",3302,279,11,1228,426,5246
"Westminster","14:00:00","2021-06-30",978,83,101,310,70,1542
"Barking and Dagenham","15:00:00","2021-06-30",3905,61,11,1410,885,6272
"Barnet","15:00:00","2021-06-30",3078,67,37,689,212,4083
"Croydon","15:00:00","2021-06-30",1217,28,20,230,31,1526
"Enfield","15:00:00","2021-06-30",1435,8,13,295,47,1798
"Havering","15:00:00","2021-06-30",2727,42,29,558,143,3499
"Merton","15:00:00","2021-06-30",977,44,35,210,48,1314
"Tower Hamlets","15:00:00","2021-06-30",3523,308,13,1384,331,5559
"Westminster","15:00:00","2021-06-30",1043,94,119,276,47,1579
"Barking and Dagenham","16:00:00","2021-06-30",4787,125,22,1452,608,6994
"Barnet","16:00:00","2021-06-30",3187,84,50,746,151,4218
"Croydon","16:00:00","2021-06-30",1281,49,18,267,25,1640
"Enfield","16:00:00","2021-06-30",1486,10,28,328,33,1885
"Havering","16:00:00","2021-06-30",3105,64,48,669,84,3970
"Merton","16:00:00","2021-06-30",1107,56,40,282,38,1523
"Tower Hamlets","16:00:00","2021-06-30",3400,386,13,1219,237,5255
"Westminster","16:00:00","2021-06-30",1084,117,113,285,23,1622
"Barking and Dagenham","17:00:00","2021-06-30",5521,176,12,1368,421,7498
"Barnet","17:00:00","2021-06-30",3360,105,29,644,120,4258
"Croydon","17:00:00","2021-06-30",1172,53,18,195,17,1455
"Enfield","17:00:00","2021-06-30",1525,15,12,261,18,1831
"Havering","17:00:00","2021-06-30",3338,70,33,544,58,4043
"Merton","17:00:00","2021-06-30",982,69,21,186,25,1283
"Tower Hamlets","17:00:00","2021-06-30",4282,466,13,1052,154,5967
"Westminster","17:00:00","2021-06-30",1077,105,120,248,30,1580
"Barking and Dagenham","18:00:00","2021-06-30",5476,132,10,1075,370,7063
"Barnet","18:00:00","2021-06-30",3598,103,26,441,58,4226
"Croydon","18:00:00","2021-06-30",1300,43,18,180,14,1555
"Enfield","18:00:00","2021-06-30",1616,16,13,184,19,1848
"Havering","18:00:00","2021-06-30",3286,84,34,455,73,3932
"Merton","18:00:00","2021-06-30",1035,66,41,152,20,1314
"Tower Hamlets","18:00:00","2021-06-30",4561,423,11,857,133,5985
"Westminster","18:00:00","2021-06-30",1287,96,112,162,19,1676
"Barking and Dagenham","07:00:00","2021-07-01",46,3,0,8,2,59
"Greenwich","07:00:00","2021-07-01",53,0,11,15,2,81
"Hackney","07:00:00","2021-07-01",1603,70,78,577,83,2411
"Haringey","07:00:00","2021-07-01",28,0,0,4,0,32
"Hounslow","07:00:00","2021-07-01",50,3,0,11,1,65
"Lewisham","07:00:00","2021-07-01",423,9,11,99,8,550
"Waltham Forest","07:00:00","2021-07-01",14,0,0,2,2,18
"Barking and Dagenham","08:00:00","2021-07-01",72,1,0,4,0,77
"Greenwich","08:00:00","2021-07-01",124,2,13,10,6,155
"Hackney","08:00:00","2021-07-01",1761,72,45,527,90,2495
"Haringey","08:00:00","2021-07-01",26,0,0,2,0,28
"Hounslow","08:00:00","2021-07-01",93,0,0,14,0,107
"Lewisham","08:00:00","2021-07-01",592,17,21,94,16,740
"Waltham Forest","08:00:00","2021-07-01",24,0,0,1,1,26
"Barking and Dagenham","09:00:00","2021-07-01",59,3,1,8,2,73
"Greenwich","09:00:00","2021-07-01",78,0,10,9,5,102
"Hackney","09:00:00","2021-07-01",1564,58,52,510,122,2306
"Haringey","09:00:00","2021-07-01",29,0,0,3,0,32
"Hounslow","09:00:00","2021-07-01",67,2,0,11,2,82
"Lewisham","09:00:00","2021-07-01",402,16,11,91,11,531
"Waltham Forest","09:00:00","2021-07-01",22,0,0,2,0,24
"Barking and Dagenham","10:00:00","2021-07-01",48,4,0,10,1,63
"Greenwich","10:00:00","2021-07-01",49,2,12,12,1,76
"Hackney","10:00:00","2021-07-01",1446,67,47,532,105,2197
"Haringey","10:00:00","2021-07-01",41,1,0,2,0,44
"Hounslow","10:00:00","2021-07-01",55,0,0,11,0,66
"Lewisham","10:00:00","2021-07-01",359,12,10,102,8,491
"Waltham Forest","10:00:00","2021-07-01",14,0,0,1,0,15
"Barking and Dagenham","11:00:00","2021-07-01",70,4,0,7,1,82
"Greenwich","11:00:00","2021-07-01",69,2,8,9,2,90
"Hackney","11:00:00","2021-07-01",1495,66,39,587,114,2301
"Haringey","11:00:00","2021-07-01",34,0,0,8,2,44
"Hounslow","11:00:00","2021-07-01",72,1,0,17,1,91
"Lewisham","11:00:00","2021-07-01",331,19,9,73,15,447
"Waltham Forest","11:00:00","2021-07-01",15,1,0,6,1,23
"Barking and Dagenham","12:00:00","2021-07-01",63,12,0,5,1,81
"Greenwich","12:00:00","2021-07-01",53,1,10,12,4,80
"Hackney","12:00:00","2021-07-01",1575,57,41,583,104,2360
"Haringey","12:00:00","2021-07-01",49,2,0,3,0,54
"Hounslow","12:00:00","2021-07-01",68,3,0,12,2,85
"Lewisham","12:00:00","2021-07-01",376,13,9,73,13,484
"Waltham Forest","12:00:00","2021-07-01",18,1,0,5,0,24
"Barking and Dagenham","13:00:00","2021-07-01",65,5,0,11,2,83
"Greenwich","13:00:00","2021-07-01",62,4,12,17,3,98
"Hackney","13:00:00","2021-07-01",1705,117,43,531,115,2511
"Haringey","13:00:00","2021-07-01",35,1,0,3,0,39
"Hounslow","13:00:00","2021-07-01",61,1,0,6,3,71
"Lewisham","13:00:00","2021-07-01",353,22,10,94,8,487
"Waltham Forest","13:00:00","2021-07-01",24,0,0,6,0,30
"Barking and Dagenham","14:00:00","2021-07-01",75,6,0,12,1,94
"Greenwich","14:00:00","2021-07-01",76,2,7,15,4,104
"Hackney","14:00:00","2021-07-01",1635,100,41,591,114,2481
"Haringey","14:00:00","2021-07-01",30,1,0,2,0,33
"Hounslow","14:00:00","2021-07-01",89,2,0,11,2,104
"Lewisham","14:00:00","2021-07-01",372,24,17,62,13,488
"Waltham Forest","14:00:00","2021-07-01",16,1,0,7,0,24
"Barking and Dagenham","15:00:00","2021-07-01",60,5,0,10,0,75
"Greenwich","15:00:00","2021-07-01",103,4,14,17,3,141
"Hackney","15:00:00","2021-07-01",1638,104,46,577,73,2438
"Haringey","15:00:00","2021-07-01",39,2,0,7,1,49
"Hounslow","15:00:00","2021-07-01",87,1,0,19,1,108
"Lewisham","15:00:00","2021-07-01",589,21,19,85,6,720
"Waltham Forest","15:00:00","2021-07-01",28,0,0,3,2,33
"Barking and Dagenham","16:00:00","2021-07-01",94,9,1,8,0,112
"Greenwich","16:00:00","2021-07-01",90,4,12,5,3,114
"Hackney","16:00:00","2021-07-01",1788,149,46,580,57,2620
"Haringey","16:00:00","2021-07-01",36,2,0,3,2,43
"Hounslow","16:00:00","2021-07-01",102,0,0,18,1,121
"Lewisham","16:00:00","2021-07-01",531,22,10,96,6,665
"Waltham Forest","16:00:00","2021-07-01",32,0,0,2,2,36
"Barking and Dagenham","17:00:00","2021-07-01",97,17,0,2,0,116
"Greenwich","17:00:00","2021-07-01",81,7,11,16,0,115
"Hackney","17:00:00","2021-07-01",1882,149,40,434,52,2557
"Haringey","17:00:00","2021-07-01",37,0,0,3,0,40
"Hounslow","17:00:00","2021-07-01",76,1,0,13,0,90
"Lewisham","17:00:00","2021-07-01",557,30,8,81,3,679
"Waltham Forest","17:00:00","2021-07-01",35,1,0,3,0,39
"Barking and Dagenham","18:00:00","2021-07-01",77,14,0,5,1,97
"Greenwich","18:00:00","2021-07-01",87,0,10,6,2,105
"Hackney","18:00:00","2021-07-01",1979,157,44,277,32,2489
"Haringey","18:00:00","2021-07-01",41,3,0,1,0,45
"Hounslow","18:00:00","2021-07-01",87,1,0,12,1,101
"Lewisham","18:00:00","2021-07-01",494,23,10,46,8,581
"Waltham Forest","18:00:00","2021-07-01",21,0,0,3,0,24
"Haringey","07:00:00","2021-07-02",464,23,45,174,37,743
"Kensington and Chelsea","07:00:00","2021-07-02",552,53,79,227,64,975
"Lambeth","07:00:00","2021-07-02",300,7,19,62,14,402
"Redbridge","07:00:00","2021-07-02",3006,101,63,695,136,4001
"Sutton","07:00:00","2021-07-02",64,1,0,8,0,73
"Wandsworth","07:00:00","2021-07-02",1220,81,71,370,115,1857
"Westminster","07:00:00","2021-07-02",1398,138,118,728,119,2501
"Haringey","08:00:00","2021-07-02",506,27,40,159,34,766
"Kensington and Chelsea","08:00:00","2021-07-02",683,66,82,183,62,1076
"Lambeth","08:00:00","2021-07-02",405,10,20,72,13,520
"Redbridge","08:00:00","2021-07-02",3390,70,56,496,128,4140
"Sutton","08:00:00","2021-07-02",112,1,0,7,1,121
"Wandsworth","08:00:00","2021-07-02",1309,71,63,329,100,1872
"Westminster","08:00:00","2021-07-02",1360,115,102,582,149,2308
"Bromley","09:00:00","2021-07-02",1765,11,5,399,144,2324
"Haringey","09:00:00","2021-07-02",546,38,42,152,39,817
"Kensington and Chelsea","09:00:00","2021-07-02",589,66,79,181,73,988
"Lambeth","09:00:00","2021-07-02",243,11,15,58,9,336
"Redbridge","09:00:00","2021-07-02",2745,42,60,563,139,3549
"Sutton","09:00:00","2021-07-02",59,0,0,3,0,62
"Wandsworth","09:00:00","2021-07-02",1290,96,82,377,135,1980
"Westminster","09:00:00","2021-07-02",1284,92,116,595,150,2237
"Bromley","10:00:00","2021-07-02",1812,10,4,335,124,2285
"Haringey","10:00:00","2021-07-02",398,30,45,113,50,636
"Kensington and Chelsea","10:00:00","2021-07-02",632,86,73,178,57,1026
"Lambeth","10:00:00","2021-07-02",209,8,22,63,21,323
"Redbridge","10:00:00","2021-07-02",2826,63,55,588,132,3664
"Sutton","10:00:00","2021-07-02",52,0,0,8,0,60
"Wandsworth","10:00:00","2021-07-02",1262,110,65,378,175,1990
"Westminster","10:00:00","2021-07-02",1302,74,107,578,147,2208
"Bromley","11:00:00","2021-07-02",1808,19,4,362,113,2306
"Haringey","11:00:00","2021-07-02",418,51,42,110,44,665
"Kensington and Chelsea","11:00:00","2021-07-02",666,101,76,174,44,1061
"Lambeth","11:00:00","2021-07-02",191,21,17,49,10,288
"Redbridge","11:00:00","2021-07-02",2947,62,58,547,144,3758
"Sutton","11:00:00","2021-07-02",60,0,0,10,1,71
"Wandsworth","11:00:00","2021-07-02",1374,111,53,383,127,2048
"Westminster","11:00:00","2021-07-02",1251,89,101,552,160,2153
"Haringey","12:00:00","2021-07-02",453,69,42,134,37,735
"Kensington and Chelsea","12:00:00","2021-07-02",684,156,77,217,39,1173
"Lambeth","12:00:00","2021-07-02",249,10,16,51,17,343
"Redbridge","12:00:00","2021-07-02",3083,81,50,572,132,3918
"Sutton","12:00:00","2021-07-02",48,4,0,7,1,60
"Wandsworth","12:00:00","2021-07-02",1372,149,66,386,99,2072
"Westminster","12:00:00","2021-07-02",1419,118,99,558,143,2337
"Haringey","13:00:00","2021-07-02",616,65,36,146,49,912
"Kensington and Chelsea","13:00:00","2021-07-02",670,175,78,183,51,1157
"Lambeth","13:00:00","2021-07-02",245,22,12,51,8,338
"Redbridge","13:00:00","2021-07-02",3228,103,64,558,109,4062
"Sutton","13:00:00","2021-07-02",47,0,0,9,0,56
"Wandsworth","13:00:00","2021-07-02",1344,171,62,385,101,2063
"Westminster","13:00:00","2021-07-02",1463,117,103,517,100,2300
"Haringey","14:00:00","2021-07-02",649,54,46,157,44,950
"Kensington and Chelsea","14:00:00","2021-07-02",800,154,71,170,44,1239
"Lambeth","14:00:00","2021-07-02",329,11,14,49,11,414
"Redbridge","14:00:00","2021-07-02",3435,90,53,533,100,4211
"Sutton","14:00:00","2021-07-02",61,2,0,8,0,71
"Wandsworth","14:00:00","2021-07-02",1455,154,54,440,100,2203
"Westminster","14:00:00","2021-07-02",1541,105,105,507,101,2359
"Haringey","15:00:00","2021-07-02",666,60,43,149,41,959
"Kensington and Chelsea","15:00:00","2021-07-02",875,147,74,170,34,1300
"Lambeth","15:00:00","2021-07-02",404,28,15,68,10,525
"Redbridge","15:00:00","2021-07-02",3759,118,51,527,73,4528
"Sutton","15:00:00","2021-07-02",104,1,0,1,0,106
"Wandsworth","15:00:00","2021-07-02",1336,156,54,406,73,2025
"Westminster","15:00:00","2021-07-02",1503,143,101,514,74,2335
"Haringey","16:00:00","2021-07-02",657,57,44,116,18,892
"Kensington and Chelsea","16:00:00","2021-07-02",907,144,78,147,21,1297
"Lambeth","16:00:00","2021-07-02",455,47,14,112,9,637
"Redbridge","16:00:00","2021-07-02",3775,103,65,481,67,4491
"Sutton","16:00:00","2021-07-02",136,4,0,13,0,153
"Wandsworth","16:00:00","2021-07-02",1541,179,74,346,79,2219
"Westminster","16:00:00","2021-07-02",1721,161,100,482,46,2510
"Haringey","17:00:00","2021-07-02",769,94,32,144,24,1063
"Kensington and Chelsea","17:00:00","2021-07-02",918,171,76,126,18,1309
"Lambeth","17:00:00","2021-07-02",449,31,15,92,10,597
"Redbridge","17:00:00","2021-07-02",3905,141,54,464,70,4634
"Sutton","17:00:00","2021-07-02",115,7,0,12,0,134
"Wandsworth","17:00:00","2021-07-02",1603,234,54,305,46,2242
"Westminster","17:00:00","2021-07-02",1766,175,102,386,48,2477
"Bromley","18:00:00","2021-07-02",1980,28,5,206,26,2245
"Haringey","18:00:00","2021-07-02",747,101,40,90,11,989
"Kensington and Chelsea","18:00:00","2021-07-02",922,212,77,68,17,1296
"Lambeth","18:00:00","2021-07-02",402,41,13,48,3,507
"Redbridge","18:00:00","2021-07-02",3894,141,51,362,47,4495
"Sutton","18:00:00","2021-07-02",99,1,0,1,2,103
"Wandsworth","18:00:00","2021-07-02",1601,242,57,166,43,2109
"Westminster","18:00:00","2021-07-02",1888,172,112,307,35,2514
"Barnet","07:00:00","2021-07-05",3096,124,31,1240,313,4804
"Haringey","07:00:00","2021-07-05",642,22,47,257,44,1012
"Harrow","07:00:00","2021-07-05",1176,13,49,230,48,1516
"Hillingdon","07:00:00","2021-07-05",89,0,0,14,0,103
"Hounslow","07:00:00","2021-07-05",2455,51,16,657,239,3418
"Kingston upon Thames","07:00:00","2021-07-05",278,7,1,42,3,331
"Waltham Forest","07:00:00","2021-07-05",1010,27,10,346,91,1484
"Barnet","08:00:00","2021-07-05",2891,85,37,915,313,4241
"Haringey","08:00:00","2021-07-05",687,33,38,190,51,999
"Harrow","08:00:00","2021-07-05",1617,12,33,216,47,1925
"Hillingdon","08:00:00","2021-07-05",242,2,0,12,3,259
"Hounslow","08:00:00","2021-07-05",2411,25,16,671,266,3389
"Kingston upon Thames","08:00:00","2021-07-05",537,6,0,56,7,606
"Waltham Forest","08:00:00","2021-07-05",1187,31,7,352,75,1652
"Barnet","09:00:00","2021-07-05",3020,55,42,1051,367,4535
"Haringey","09:00:00","2021-07-05",580,34,45,166,36,861
"Harrow","09:00:00","2021-07-05",1173,9,32,195,56,1465
"Hillingdon","09:00:00","2021-07-05",80,0,0,12,3,95
"Hounslow","09:00:00","2021-07-05",2013,23,12,624,319,2991
"Kingston upon Thames","09:00:00","2021-07-05",331,5,0,49,9,394
"Waltham Forest","09:00:00","2021-07-05",926,43,5,281,91,1346
"Barnet","10:00:00","2021-07-05",3216,69,32,1120,442,4879
"Haringey","10:00:00","2021-07-05",525,36,40,175,31,807
"Harrow","10:00:00","2021-07-05",1118,13,26,175,51,1383
"Hillingdon","10:00:00","2021-07-05",73,1,0,8,2,84
"Hounslow","10:00:00","2021-07-05",1884,16,10,578,327,2815
"Kingston upon Thames","10:00:00","2021-07-05",326,8,0,46,14,394
"Waltham Forest","10:00:00","2021-07-05",863,34,9,318,78,1302
"Barnet","11:00:00","2021-07-05",3489,67,23,1140,425,5144
"Haringey","11:00:00","2021-07-05",566,39,50,195,40,890
"Harrow","11:00:00","2021-07-05",1099,8,31,156,55,1349
"Hillingdon","11:00:00","2021-07-05",78,0,0,14,3,95
"Hounslow","11:00:00","2021-07-05",1868,18,6,614,316,2822
"Kingston upon Thames","11:00:00","2021-07-05",343,9,0,52,10,414
"Waltham Forest","11:00:00","2021-07-05",913,43,9,253,86,1304
"Barnet","12:00:00","2021-07-05",3535,66,27,1164,451,5243
"Haringey","12:00:00","2021-07-05",609,56,46,181,44,936
"Harrow","12:00:00","2021-07-05",1146,17,26,179,49,1417
"Hillingdon","12:00:00","2021-07-05",85,4,0,12,0,101
"Hounslow","12:00:00","2021-07-05",1969,22,7,655,314,2967
"Kingston upon Thames","12:00:00","2021-07-05",333,14,1,39,12,399
"Waltham Forest","12:00:00","2021-07-05",988,46,9,206,65,1314
"Barnet","13:00:00","2021-07-05",3498,102,33,1122,411,5166
"Haringey","13:00:00","2021-07-05",629,54,44,169,40,936
"Harrow","13:00:00","2021-07-05",1227,20,25,183,41,1496
"Hillingdon","13:00:00","2021-07-05",96,3,0,8,1,108
"Hounslow","13:00:00","2021-07-05",2095,17,12,598,300,3022
"Kingston upon Thames","13:00:00","2021-07-05",341,18,1,54,7,421
"Waltham Forest","13:00:00","2021-07-05",1028,55,8,248,64,1403
"Barnet","14:00:00","2021-07-05",3305,83,29,939,343,4699
"Haringey","14:00:00","2021-07-05",673,58,49,141,25,946
"Harrow","14:00:00","2021-07-05",1255,16,29,181,42,1523
"Hillingdon","14:00:00","2021-07-05",117,3,0,8,2,130
"Hounslow","14:00:00","2021-07-05",2337,29,13,678,296,3353
"Kingston upon Thames","14:00:00","2021-07-05",431,13,3,32,6,485
"Waltham Forest","14:00:00","2021-07-05",1065,38,9,263,75,1450
"Barnet","15:00:00","2021-07-05",3376,71,33,1031,280,4791
"Haringey","15:00:00","2021-07-05",711,65,48,142,32,998
"Harrow","15:00:00","2021-07-05",1506,14,33,175,27,1755
"Hillingdon","15:00:00","2021-07-05",194,4,2,12,0,212
"Hounslow","15:00:00","2021-07-05",2415,35,11,639,270,3370
"Kingston upon Thames","15:00:00","2021-07-05",488,12,0,44,1,545
"Waltham Forest","15:00:00","2021-07-05",1217,62,8,262,64,1613
"Barnet","16:00:00","2021-07-05",3690,115,31,1100,197,5133
"Haringey","16:00:00","2021-07-05",728,55,41,168,25,1017
"Harrow","16:00:00","2021-07-05",1460,24,51,199,24,1758
"Hillingdon","16:00:00","2021-07-05",145,2,0,15,0,162
"Hounslow","16:00:00","2021-07-05",2798,49,12,663,220,3742
"Kingston upon Thames","16:00:00","2021-07-05",423,17,1,42,4,487
"Waltham Forest","16:00:00","2021-07-05",1126,46,8,267,40,1487
"Barnet","17:00:00","2021-07-05",3991,127,31,975,166,5290
"Haringey","17:00:00","2021-07-05",798,75,49,141,20,1083
"Harrow","17:00:00","2021-07-05",1504,16,31,168,30,1749
"Hillingdon","17:00:00","2021-07-05",129,2,0,6,2,139
"Hounslow","17:00:00","2021-07-05",3084,50,12,609,153,3908
"Kingston upon Thames","17:00:00","2021-07-05",453,18,0,39,3,513
"Waltham Forest","17:00:00","2021-07-05",1191,66,6,224,30,1517
"Barnet","18:00:00","2021-07-05",4190,110,28,742,133,5203
"Haringey","18:00:00","2021-07-05",852,92,41,112,17,1114
"Harrow","18:00:00","2021-07-05",1486,26,27,114,14,1667
"Hillingdon","18:00:00","2021-07-05",97,2,0,4,1,104
"Hounslow","18:00:00","2021-07-05",2906,39,14,492,135,3586
"Kingston upon Thames","18:00:00","2021-07-05",408,16,0,23,1,448
"Waltham Forest","18:00:00","2021-07-05",1237,85,6,200,35,1563
"City of London","07:00:00","2021-07-06",609,204,4,628,251,1696
"Tower Hamlets","07:00:00","2021-07-06",3741,176,36,1618,341,5912
"City of London","08:00:00","2021-07-06",646,125,8,581,231,1591
"Tower Hamlets","08:00:00","2021-07-06",3665,118,35,1251,328,5397
"City of London","09:00:00","2021-07-06",693,87,11,604,290,1685
"Tower Hamlets","09:00:00","2021-07-06",3398,94,36,1304,391,5223
"City of London","10:00:00","2021-07-06",773,58,20,577,248,1676
"Tower Hamlets","10:00:00","2021-07-06",3167,79,24,1270,391,4931
"City of London","11:00:00","2021-07-06",662,66,14,446,236,1424
"Tower Hamlets","11:00:00","2021-07-06",3386,71,28,1288,385,5158
"City of London","12:00:00","2021-07-06",834,56,11,512,229,1642
"Tower Hamlets","12:00:00","2021-07-06",3319,92,22,1201,386,5020
"City of London","13:00:00","2021-07-06",695,55,13,423,209,1395
"Tower Hamlets","13:00:00","2021-07-06",3439,97,31,1317,339,5223
"City of London","14:00:00","2021-07-06",640,52,17,410,180,1299
"Tower Hamlets","14:00:00","2021-07-06",3619,111,27,1302,337,5396
"City of London","15:00:00","2021-07-06",661,93,15,390,138,1297
"Tower Hamlets","15:00:00","2021-07-06",3702,112,36,1191,234,5275
"City of London","16:00:00","2021-07-06",671,151,18,404,90,1334
"Tower Hamlets","16:00:00","2021-07-06",4135,185,24,1156,163,5663
"City of London","17:00:00","2021-07-06",954,168,18,340,63,1543
"Tower Hamlets","17:00:00","2021-07-06",4373,194,26,941,123,5657
"City of London","18:00:00","2021-07-06",1076,142,9,248,47,1522
"Tower Hamlets","18:00:00","2021-07-06",4196,146,35,637,105,5119
"Lambeth","07:00:00","2021-07-07",468,19,40,157,20,704
"Lewisham","07:00:00","2021-07-07",1075,78,17,423,140,1733
"Waltham Forest","07:00:00","2021-07-07",87,0,0,16,1,104
"Lambeth","08:00:00","2021-07-07",547,15,46,133,24,765
"Lewisham","08:00:00","2021-07-07",1180,58,20,335,105,1698
"Waltham Forest","08:00:00","2021-07-07",103,0,0,14,2,119
"Lambeth","09:00:00","2021-07-07",395,18,44,112,23,592
"Lewisham","09:00:00","2021-07-07",1084,37,28,309,159,1617
"Waltham Forest","09:00:00","2021-07-07",64,0,0,10,0,74
"Lambeth","10:00:00","2021-07-07",372,21,38,119,31,581
"Lewisham","10:00:00","2021-07-07",1317,42,18,493,214,2084
"Waltham Forest","10:00:00","2021-07-07",60,1,0,11,2,74
"Lambeth","11:00:00","2021-07-07",384,28,36,133,34,615
"Lewisham","11:00:00","2021-07-07",1621,38,10,591,222,2482
"Waltham Forest","11:00:00","2021-07-07",63,0,0,6,1,70
"Lambeth","12:00:00","2021-07-07",364,51,37,127,23,602
"Lewisham","12:00:00","2021-07-07",1713,51,9,587,220,2580
"Waltham Forest","12:00:00","2021-07-07",74,0,0,5,0,79
"Lambeth","13:00:00","2021-07-07",454,54,38,112,23,681
"Lewisham","13:00:00","2021-07-07",1721,66,13,569,184,2553
"Waltham Forest","13:00:00","2021-07-07",78,1,0,7,3,89
"Lambeth","14:00:00","2021-07-07",499,40,42,131,20,732
"Lewisham","14:00:00","2021-07-07",1839,63,18,611,157,2688
"Waltham Forest","14:00:00","2021-07-07",74,1,0,13,1,89
"Lambeth","15:00:00","2021-07-07",511,35,39,124,16,725
"Lewisham","15:00:00","2021-07-07",1888,62,15,587,126,2678
"Waltham Forest","15:00:00","2021-07-07",84,4,0,17,1,106
"Lambeth","16:00:00","2021-07-07",512,46,47,110,8,723
"Waltham Forest","16:00:00","2021-07-07",88,0,0,22,0,110
"Lambeth","17:00:00","2021-07-07",566,53,39,95,3,756
"Waltham Forest","17:00:00","2021-07-07",104,3,0,8,0,115
"Lambeth","18:00:00","2021-07-07",590,66,36,64,7,763
"Lewisham","18:00:00","2021-07-07",2035,112,10,333,68,2558
"Waltham Forest","18:00:00","2021-07-07",91,2,0,4,0,97
"Barnet","07:00:00","2021-07-08",52,0,5,9,2,68
"Croydon","07:00:00","2021-07-08",362,1,4,52,3,422
"Hillingdon","07:00:00","2021-07-08",12,0,0,2,0,14
"Merton","07:00:00","2021-07-08",1462,88,75,491,148,2264
"Wandsworth","07:00:00","2021-07-08",207,29,43,97,32,408
"Barnet","08:00:00","2021-07-08",106,0,5,8,3,122
"Croydon","08:00:00","2021-07-08",460,0,4,49,2,515
"Hillingdon","08:00:00","2021-07-08",31,0,0,5,2,38
"Merton","08:00:00","2021-07-08",1542,76,73,417,133,2241
"Wandsworth","08:00:00","2021-07-08",270,24,47,96,45,482
"Barnet","09:00:00","2021-07-08",45,0,5,6,2,58
"Croydon","09:00:00","2021-07-08",242,1,3,49,7,302
"Hillingdon","09:00:00","2021-07-08",17,0,0,3,0,20
"Merton","09:00:00","2021-07-08",1428,60,76,451,185,2200
"Wandsworth","09:00:00","2021-07-08",267,35,49,83,33,467
"Barnet","10:00:00","2021-07-08",38,1,5,3,2,49
"Croydon","10:00:00","2021-07-08",200,2,4,35,3,244
"Hillingdon","10:00:00","2021-07-08",9,0,0,5,1,15
"Merton","10:00:00","2021-07-08",1458,52,68,426,157,2161
"Wandsworth","10:00:00","2021-07-08",270,28,50,97,56,501
"Barnet","11:00:00","2021-07-08",45,0,5,4,4,58
"Croydon","11:00:00","2021-07-08",217,2,4,41,6,270
"Hillingdon","11:00:00","2021-07-08",19,0,0,1,0,20
"Merton","11:00:00","2021-07-08",1456,61,66,393,160,2136
"Wandsworth","11:00:00","2021-07-08",268,46,44,136,61,555
"Barnet","12:00:00","2021-07-08",43,0,5,11,2,61
"Croydon","12:00:00","2021-07-08",247,5,4,38,5,299
"Hillingdon","12:00:00","2021-07-08",16,1,0,4,1,22
"Merton","12:00:00","2021-07-08",1469,83,61,440,172,2225
"Wandsworth","12:00:00","2021-07-08",389,39,43,126,51,648
"Barnet","13:00:00","2021-07-08",50,1,4,8,1,64
"Croydon","13:00:00","2021-07-08",229,8,3,47,6,293
"Hillingdon","13:00:00","2021-07-08",12,1,0,4,0,17
"Merton","13:00:00","2021-07-08",1586,83,69,426,158,2322
"Wandsworth","13:00:00","2021-07-08",359,60,49,113,38,619
"Barnet","14:00:00","2021-07-08",34,0,5,14,0,53
"Croydon","14:00:00","2021-07-08",269,1,4,32,4,310
"Hillingdon","14:00:00","2021-07-08",26,0,1,2,1,30
"Merton","14:00:00","2021-07-08",1606,82,69,350,152,2259
"Wandsworth","14:00:00","2021-07-08",394,65,50,124,42,675
"Barnet","15:00:00","2021-07-08",89,2,6,6,2,105
"Croydon","15:00:00","2021-07-08",351,5,5,44,2,407
"Hillingdon","15:00:00","2021-07-08",28,0,0,3,0,31
"Merton","15:00:00","2021-07-08",1582,106,69,400,106,2263
"Wandsworth","15:00:00","2021-07-08",411,39,48,114,32,644
"Barnet","16:00:00","2021-07-08",61,2,5,12,0,80
"Croydon","16:00:00","2021-07-08",406,2,4,59,3,474
"Hillingdon","16:00:00","2021-07-08",19,0,0,2,0,21
"Merton","16:00:00","2021-07-08",1460,151,71,361,85,2128
"Wandsworth","16:00:00","2021-07-08",389,55,43,107,25,619
"Barnet","17:00:00","2021-07-08",79,1,5,4,2,91
"Croydon","17:00:00","2021-07-08",401,0,4,40,4,449
"Hillingdon","17:00:00","2021-07-08",19,0,0,3,1,23
"Merton","17:00:00","2021-07-08",1727,147,61,315,64,2314
"Wandsworth","17:00:00","2021-07-08",438,69,47,78,16,648
"Barnet","18:00:00","2021-07-08",56,5,5,3,0,69
"Croydon","18:00:00","2021-07-08",329,10,4,27,1,371
"Hillingdon","18:00:00","2021-07-08",21,1,0,0,1,23
"Merton","18:00:00","2021-07-08",1949,136,70,279,43,2477
"Wandsworth","18:00:00","2021-07-08",462,76,46,50,15,649
"City of London","07:00:00","2021-07-09",92,17,35,108,16,268
"Ealing","07:00:00","2021-07-09",55,1,0,10,1,67
"Enfield","07:00:00","2021-07-09",1941,99,9,892,295,3236
"Hillingdon","07:00:00","2021-07-09",24,0,2,17,2,45
"Lewisham","07:00:00","2021-07-09",755,32,141,236,51,1215
"City of London","08:00:00","2021-07-09",96,20,46,110,16,288
"Ealing","08:00:00","2021-07-09",103,1,0,20,4,128
"Enfield","08:00:00","2021-07-09",2025,54,10,781,302,3172
"Hillingdon","08:00:00","2021-07-09",41,0,1,8,0,50
"Lewisham","08:00:00","2021-07-09",826,40,153,168,47,1234
"City of London","09:00:00","2021-07-09",114,14,37,120,14,299
"Ealing","09:00:00","2021-07-09",53,1,0,6,8,68
"Enfield","09:00:00","2021-07-09",1930,32,9,783,338,3092
"Hillingdon","09:00:00","2021-07-09",26,0,1,16,1,44
"Lewisham","09:00:00","2021-07-09",608,45,118,134,50,955
"City of London","10:00:00","2021-07-09",127,25,40,109,16,317
"Ealing","10:00:00","2021-07-09",68,2,0,9,2,81
"Enfield","10:00:00","2021-07-09",2104,32,7,783,381,3307
"Hillingdon","10:00:00","2021-07-09",27,1,0,8,0,36
"Lewisham","10:00:00","2021-07-09",534,43,130,149,39,895
"City of London","11:00:00","2021-07-09",123,28,38,104,21,314
"Ealing","11:00:00","2021-07-09",65,4,0,12,4,85
"Enfield","11:00:00","2021-07-09",2237,34,2,719,351,3343
"Hillingdon","11:00:00","2021-07-09",23,0,0,5,0,28
"Lewisham","11:00:00","2021-07-09",792,77,129,184,50,1232
"City of London","12:00:00","2021-07-09",133,18,35,117,12,315
"Ealing","12:00:00","2021-07-09",80,1,0,13,0,94
"Enfield","12:00:00","2021-07-09",2200,39,2,792,335,3368
"Hillingdon","12:00:00","2021-07-09",31,0,0,6,2,39
"Lewisham","12:00:00","2021-07-09",824,84,128,169,62,1267
"City of London","13:00:00","2021-07-09",171,30,41,81,15,338
"Ealing","13:00:00","2021-07-09",58,4,0,11,2,75
"Enfield","13:00:00","2021-07-09",2154,48,8,735,283,3228
"Hillingdon","13:00:00","2021-07-09",22,0,1,5,1,29
"Lewisham","13:00:00","2021-07-09",865,124,135,163,41,1328
"City of London","14:00:00","2021-07-09",170,27,35,120,8,360
"Ealing","14:00:00","2021-07-09",76,0,0,10,0,86
"Enfield","14:00:00","2021-07-09",2252,61,3,695,272,3283
"Hillingdon","14:00:00","2021-07-09",32,1,0,8,2,43
"Lewisham","14:00:00","2021-07-09",821,109,135,162,37,1264
"City of London","15:00:00","2021-07-09",172,30,36,84,7,329
"Ealing","15:00:00","2021-07-09",78,0,1,10,0,89
"Enfield","15:00:00","2021-07-09",2313,77,14,643,202,3249
"Hillingdon","15:00:00","2021-07-09",32,0,2,12,0,46
"Lewisham","15:00:00","2021-07-09",883,101,137,136,37,1294
"City of London","16:00:00","2021-07-09",192,24,42,60,4,322
"Ealing","16:00:00","2021-07-09",89,8,0,9,0,106
"Enfield","16:00:00","2021-07-09",2333,103,9,597,133,3175
"Hillingdon","16:00:00","2021-07-09",55,0,3,18,0,76
"Lewisham","16:00:00","2021-07-09",960,124,155,148,35,1422
"City of London","17:00:00","2021-07-09",198,22,35,61,4,320
"Ealing","17:00:00","2021-07-09",108,13,0,13,0,134
"Enfield","17:00:00","2021-07-09",2560,111,5,572,99,3347
"Hillingdon","17:00:00","2021-07-09",42,0,0,5,0,47
"Lewisham","17:00:00","2021-07-09",1000,136,142,147,22,1447
"City of London","18:00:00","2021-07-09",250,18,40,49,2,359
"Ealing","18:00:00","2021-07-09",111,6,0,9,0,126
"Enfield","18:00:00","2021-07-09",2768,89,4,499,87,3447
"Hillingdon","18:00:00","2021-07-09",43,0,0,4,2,49
"Lewisham","18:00:00","2021-07-09",962,134,144,107,17,1364
"Bexley","07:00:00","2021-07-13",2228,24,80,534,130,2996
"Enfield","07:00:00","2021-07-13",3943,128,14,1559,386,6030
"Richmond upon Thames","07:00:00","2021-07-13",107,5,55,63,19,249
"Bexley","08:00:00","2021-07-13",2781,14,93,457,143,3488
"Enfield","08:00:00","2021-07-13",3515,71,15,1217,408,5226
"Richmond upon Thames","08:00:00","2021-07-13",136,15,45,35,13,244
"Bexley","09:00:00","2021-07-13",2082,24,81,480,127,2794
"Enfield","09:00:00","2021-07-13",3388,54,14,1222,469,5147
"Richmond upon Thames","09:00:00","2021-07-13",178,25,49,48,12,312
"Bexley","10:00:00","2021-07-13",1851,39,71,407,136,2504
"Enfield","10:00:00","2021-07-13",3547,40,15,1277,508,5387
"Richmond upon Thames","10:00:00","2021-07-13",182,11,50,48,13,304
"Bexley","11:00:00","2021-07-13",2058,24,68,413,117,2680
"Enfield","11:00:00","2021-07-13",3692,52,6,1332,476,5558
"Richmond upon Thames","11:00:00","2021-07-13",221,29,45,50,10,355
"Bexley","12:00:00","2021-07-13",2152,60,82,390,122,2806
"Enfield","12:00:00","2021-07-13",3854,69,6,1268,509,5706
"Richmond upon Thames","12:00:00","2021-07-13",246,38,48,40,9,381
"Bexley","13:00:00","2021-07-13",2112,50,81,388,120,2751
"Enfield","13:00:00","2021-07-13",4088,64,6,1357,459,5974
"Richmond upon Thames","13:00:00","2021-07-13",212,32,47,48,8,347
"Bexley","14:00:00","2021-07-13",2355,38,85,430,126,3034
"Enfield","14:00:00","2021-07-13",4213,68,24,1283,421,6009
"Richmond upon Thames","14:00:00","2021-07-13",232,24,50,26,5,337
"Bexley","15:00:00","2021-07-13",2648,39,83,449,95,3314
"Enfield","15:00:00","2021-07-13",4109,85,11,1360,304,5869
"Richmond upon Thames","15:00:00","2021-07-13",174,26,45,27,5,277
"Bexley","16:00:00","2021-07-13",2594,49,81,432,91,3247
"Enfield","16:00:00","2021-07-13",4638,127,16,1330,204,6315
"Richmond upon Thames","16:00:00","2021-07-13",215,25,44,20,4,308
"Bexley","17:00:00","2021-07-13",2793,58,75,322,51,3299
"Enfield","17:00:00","2021-07-13",4710,133,7,1148,156,6154
"Richmond upon Thames","17:00:00","2021-07-13",207,32,43,26,3,311
"Bexley","18:00:00","2021-07-13",2691,57,78,272,31,3129
"Enfield","18:00:00","2021-07-13",4966,115,3,992,133,6209
"Richmond upon Thames","18:00:00","2021-07-13",255,45,44,5,3,352
"Camden","07:00:00","2021-07-14",76,4,5,48,11,144
"Hillingdon","07:00:00","2021-07-14",5465,45,28,1593,551,7682
"Merton","07:00:00","2021-07-14",831,35,67,292,25,1250
"Richmond upon Thames","07:00:00","2021-07-14",906,84,3,330,98,1421
"Wandsworth","07:00:00","2021-07-14",2910,234,43,1051,202,4440
"Camden","08:00:00","2021-07-14",124,7,9,74,10,224
"Hillingdon","08:00:00","2021-07-14",5689,61,29,1313,629,7721
"Merton","08:00:00","2021-07-14",925,18,79,185,30,1237
"Richmond upon Thames","08:00:00","2021-07-14",969,46,3,284,98,1400
"Wandsworth","08:00:00","2021-07-14",2996,224,38,809,199,4266
"Camden","09:00:00","2021-07-14",124,9,6,59,12,210
"Hillingdon","09:00:00","2021-07-14",5477,37,39,1410,736,7699
"Merton","09:00:00","2021-07-14",761,18,72,175,34,1060
"Richmond upon Thames","09:00:00","2021-07-14",1019,55,2,278,102,1456
"Wandsworth","09:00:00","2021-07-14",3017,191,44,776,233,4261
"Camden","10:00:00","2021-07-14",138,8,7,52,16,221
"Hillingdon","10:00:00","2021-07-14",5149,28,27,1373,791,7368
"Merton","10:00:00","2021-07-14",592,25,63,144,37,861
"Richmond upon Thames","10:00:00","2021-07-14",1028,27,2,266,85,1408
"Wandsworth","10:00:00","2021-07-14",2940,138,37,777,358,4250
"Camden","11:00:00","2021-07-14",130,10,7,64,16,227
"Hillingdon","11:00:00","2021-07-14",5248,26,36,1296,756,7362
"Merton","11:00:00","2021-07-14",619,32,61,161,28,901
"Richmond upon Thames","11:00:00","2021-07-14",1006,36,0,274,111,1427
"Wandsworth","11:00:00","2021-07-14",2867,149,32,900,274,4222
"Camden","12:00:00","2021-07-14",138,19,5,60,11,233
"Hillingdon","12:00:00","2021-07-14",4943,30,33,1331,726,7063
"Merton","12:00:00","2021-07-14",725,32,63,155,29,1004
"Richmond upon Thames","12:00:00","2021-07-14",1060,42,1,280,101,1484
"Wandsworth","12:00:00","2021-07-14",2919,174,38,827,219,4177
"Camden","13:00:00","2021-07-14",167,24,6,52,9,258
"Hillingdon","13:00:00","2021-07-14",5382,29,32,1495,773,7711
"Merton","13:00:00","2021-07-14",735,25,59,158,32,1009
"Richmond upon Thames","13:00:00","2021-07-14",1100,44,1,270,75,1490
"Wandsworth","13:00:00","2021-07-14",2881,193,33,830,251,4188
"Camden","14:00:00","2021-07-14",146,22,6,53,6,233
"Hillingdon","14:00:00","2021-07-14",5723,36,22,1711,790,8282
"Merton","14:00:00","2021-07-14",735,32,66,167,28,1028
"Richmond upon Thames","14:00:00","2021-07-14",1065,37,4,249,112,1467
"Wandsworth","14:00:00","2021-07-14",3132,188,43,889,199,4451
"Camden","15:00:00","2021-07-14",143,19,7,50,10,229
"Hillingdon","15:00:00","2021-07-14",6104,44,30,1854,678,8710
"Merton","15:00:00","2021-07-14",772,28,70,155,30,1055
"Richmond upon Thames","15:00:00","2021-07-14",1091,62,4,257,59,1473
"Camden","16:00:00","2021-07-14",185,18,6,35,11,255
"Merton","16:00:00","2021-07-14",859,36,77,176,21,1169
"Richmond upon Thames","16:00:00","2021-07-14",1139,75,3,268,38,1523
"Camden","17:00:00","2021-07-14",165,32,7,40,5,249
"Merton","17:00:00","2021-07-14",952,50,60,170,24,1256
"Richmond upon Thames","17:00:00","2021-07-14",1179,69,0,211,41,1500
"Camden","18:00:00","2021-07-14",188,27,6,17,4,242
"Hillingdon","18:00:00","2021-07-14",7039,71,26,1087,254,8477
"Merton","18:00:00","2021-07-14",849,64,65,105,15,1098
"Richmond upon Thames","18:00:00","2021-07-14",1362,97,1,162,30,1652
"Barking and Dagenham","07:00:00","2021-07-15",4940,252,59,2039,806,8096
"Barnet","07:00:00","2021-07-15",3057,129,27,1412,378,5003
"Greenwich","07:00:00","2021-07-15",618,60,19,247,25,969
"Hounslow","07:00:00","2021-07-15",1908,44,74,499,85,2610
"Kingston upon Thames","07:00:00","2021-07-15",5714,145,7,2236,379,8481
"Barking and Dagenham","08:00:00","2021-07-15",4931,130,41,1740,993,7835
"Barnet","08:00:00","2021-07-15",3497,82,39,1169,393,5180
"Greenwich","08:00:00","2021-07-15",673,39,16,208,27,963
"Hounslow","08:00:00","2021-07-15",2081,32,76,347,72,2608
"Kingston upon Thames","08:00:00","2021-07-15",5345,104,15,1471,389,7324
"Barking and Dagenham","09:00:00","2021-07-15",4346,93,42,1640,1090,7211
"Barnet","09:00:00","2021-07-15",3262,68,32,1207,451,5020
"Greenwich","09:00:00","2021-07-15",812,23,16,177,30,1058
"Hounslow","09:00:00","2021-07-15",1892,45,74,346,93,2450
"Kingston upon Thames","09:00:00","2021-07-15",4995,76,25,1309,430,6835
"Barking and Dagenham","10:00:00","2021-07-15",4255,65,36,1570,1063,6989
"Barnet","10:00:00","2021-07-15",3166,55,31,1111,474,4837
"Greenwich","10:00:00","2021-07-15",900,26,17,235,41,1219
"Hounslow","10:00:00","2021-07-15",1719,37,66,376,109,2307
"Kingston upon Thames","10:00:00","2021-07-15",4646,65,6,1182,408,6307
"Barking and Dagenham","11:00:00","2021-07-15",4450,77,28,1585,1129,7269
"Barnet","11:00:00","2021-07-15",3259,37,28,1102,437,4863
"Greenwich","11:00:00","2021-07-15",949,25,18,259,52,1303
"Hounslow","11:00:00","2021-07-15",1787,70,69,343,98,2367
"Kingston upon Thames","11:00:00","2021-07-15",4731,71,4,1232,430,6468
"Barking and Dagenham","12:00:00","2021-07-15",4649,72,24,1601,1018,7364
"Barnet","12:00:00","2021-07-15",3275,47,24,1124,415,4885
"Greenwich","12:00:00","2021-07-15",1002,42,15,241,52,1352
"Hounslow","12:00:00","2021-07-15",1781,56,63,363,83,2346
"Kingston upon Thames","12:00:00","2021-07-15",4564,75,2,1258,384,6283
"Barking and Dagenham","13:00:00","2021-07-15",5047,112,40,1610,1041,7850
"Barnet","13:00:00","2021-07-15",3303,58,35,1029,419,4844
"Greenwich","13:00:00","2021-07-15",949,26,16,225,29,1245
"Hounslow","13:00:00","2021-07-15",1756,75,59,364,101,2355
"Kingston upon Thames","13:00:00","2021-07-15",4730,80,5,1288,381,6484
"Barking and Dagenham","14:00:00","2021-07-15",5011,102,42,1671,939,7765
"Barnet","14:00:00","2021-07-15",3504,80,38,1079,398,5099
"Greenwich","14:00:00","2021-07-15",1098,37,18,272,28,1453
"Hounslow","14:00:00","2021-07-15",1959,53,70,343,87,2512
"Kingston upon Thames","14:00:00","2021-07-15",4991,83,18,1366,347,6805
"Barking and Dagenham","15:00:00","2021-07-15",5404,158,34,1712,762,8070
"Barnet","15:00:00","2021-07-15",3429,94,30,1059,293,4905
"Greenwich","15:00:00","2021-07-15",1111,41,18,290,26,1486
"Hounslow","15:00:00","2021-07-15",2009,82,75,344,54,2564
"Kingston upon Thames","15:00:00","2021-07-15",5633,90,9,1639,310,7681
"Barking and Dagenham","16:00:00","2021-07-15",5939,253,37,1648,539,8416
"Barnet","16:00:00","2021-07-15",3699,120,29,1089,203,5140
"Greenwich","16:00:00","2021-07-15",1194,65,17,270,21,1567
"Hounslow","16:00:00","2021-07-15",2214,89,81,358,58,2800
"Kingston upon Thames","16:00:00","2021-07-15",6148,148,5,1700,203,8204
"Barking and Dagenham","17:00:00","2021-07-15",6504,301,27,1388,329,8549
"Barnet","17:00:00","2021-07-15",4092,159,26,905,142,5324
"Greenwich","17:00:00","2021-07-15",1319,77,18,259,13,1686
"Hounslow","17:00:00","2021-07-15",2288,73,64,283,31,2739
"Kingston upon Thames","17:00:00","2021-07-15",6824,164,7,1219,140,8354
"Barking and Dagenham","18:00:00","2021-07-15",6516,246,36,1092,281,8171
"Barnet","18:00:00","2021-07-15",4348,117,29,748,137,5379
"Greenwich","18:00:00","2021-07-15",1219,73,17,164,19,1492
"Hounslow","18:00:00","2021-07-15",2235,101,66,218,20,2640
"Kingston upon Thames","18:00:00","2021-07-15",6338,137,6,788,125,7394
"Barnet","07:00:00","2021-07-16",1435,25,4,549,122,2135
"Brent","07:00:00","2021-07-16",4810,204,42,1822,696,7574
"Hounslow","07:00:00","2021-07-16",2707,120,62,793,213,3895
"Islington","07:00:00","2021-07-16",342,63,83,160,47,695
"Tower Hamlets","07:00:00","2021-07-16",510,83,102,266,63,1024
"Barnet","08:00:00","2021-07-16",1168,10,0,327,113,1618
"Brent","08:00:00","2021-07-16",4446,136,27,1440,672,6721
"Hounslow","08:00:00","2021-07-16",3475,85,51,685,202,4498
"Islington","08:00:00","2021-07-16",342,40,86,156,67,691
"Tower Hamlets","08:00:00","2021-07-16",578,51,95,246,71,1041
"Barnet","09:00:00","2021-07-16",1029,10,0,252,117,1408
"Brent","09:00:00","2021-07-16",4461,137,33,1528,793,6952
"Hounslow","09:00:00","2021-07-16",3029,73,53,638,231,4024
"Islington","09:00:00","2021-07-16",295,48,87,121,64,615
"Tower Hamlets","09:00:00","2021-07-16",587,65,96,261,61,1070
"Barnet","10:00:00","2021-07-16",960,5,1,303,95,1364
"Brent","10:00:00","2021-07-16",4993,98,17,1556,812,7476
"Hounslow","10:00:00","2021-07-16",2681,72,50,607,257,3667
"Islington","10:00:00","2021-07-16",355,36,75,140,68,674
"Tower Hamlets","10:00:00","2021-07-16",602,74,92,238,75,1081
"Barnet","11:00:00","2021-07-16",991,7,1,274,105,1378
"Brent","11:00:00","2021-07-16",5230,124,22,1621,816,7813
"Hounslow","11:00:00","2021-07-16",2881,99,37,655,205,3877
"Islington","11:00:00","2021-07-16",380,47,76,132,46,681
"Tower Hamlets","11:00:00","2021-07-16",599,89,95,257,59,1099
"Barnet","12:00:00","2021-07-16",986,13,3,276,82,1360
"Brent","12:00:00","2021-07-16",5324,127,16,1555,719,7741
"Hounslow","12:00:00","2021-07-16",3075,117,36,671,234,4133
"Islington","12:00:00","2021-07-16",339,63,76,146,40,664
"Tower Hamlets","12:00:00","2021-07-16",646,103,93,221,53,1116
"Barnet","13:00:00","2021-07-16",1026,7,1,305,75,1414
"Brent","13:00:00","2021-07-16",5467,116,25,1481,721,7810
"Hounslow","13:00:00","2021-07-16",3446,151,36,691,202,4526
"Islington","13:00:00","2021-07-16",406,69,79,145,55,754
"Tower Hamlets","13:00:00","2021-07-16",636,107,96,195,51,1085
"Barnet","14:00:00","2021-07-16",1215,12,1,313,79,1620
"Brent","14:00:00","2021-07-16",5512,158,22,1365,646,7703
"Hounslow","14:00:00","2021-07-16",3696,117,42,676,185,4716
"Islington","14:00:00","2021-07-16",401,63,85,133,47,729
"Tower Hamlets","14:00:00","2021-07-16",680,111,96,207,52,1146
"Barnet","15:00:00","2021-07-16",1340,16,4,345,71,1776
"Brent","15:00:00","2021-07-16",5539,163,29,1508,534,7773
"Hounslow","15:00:00","2021-07-16",3759,146,44,658,159,4766
"Islington","15:00:00","2021-07-16",475,86,79,133,29,802
"Tower Hamlets","15:00:00","2021-07-16",732,121,94,230,33,1210
"Barnet","16:00:00","2021-07-16",1479,35,2,364,61,1941
"Brent","16:00:00","2021-07-16",6170,202,23,1367,415,8177
"Hounslow","16:00:00","2021-07-16",4038,148,55,583,101,4925
"Islington","16:00:00","2021-07-16",532,92,79,123,32,858
"Tower Hamlets","16:00:00","2021-07-16",771,117,94,177,30,1189
"Barnet","17:00:00","2021-07-16",1771,20,6,336,48,2181
"Brent","17:00:00","2021-07-16",6418,214,24,1199,274,8129
"Hounslow","17:00:00","2021-07-16",4205,187,52,490,73,5007
"Islington","17:00:00","2021-07-16",540,89,78,92,13,812
"Tower Hamlets","17:00:00","2021-07-16",812,167,91,157,16,1243
"Barnet","18:00:00","2021-07-16",1466,21,5,188,29,1709
"Brent","18:00:00","2021-07-16",6560,177,25,914,226,7902
"Hounslow","18:00:00","2021-07-16",3983,158,49,323,59,4572
"Islington","18:00:00","2021-07-16",515,94,90,71,10,780
"Tower Hamlets","18:00:00","2021-07-16",830,145,87,95,21,1178
"Waltham Forest","07:00:00","2021-07-19",620,36,17,246,65,984
"Waltham Forest","08:00:00","2021-07-19",720,22,22,251,57,1072
"Waltham Forest","09:00:00","2021-07-19",737,27,20,229,70,1083
"Waltham Forest","10:00:00","2021-07-19",796,34,23,252,72,1177
"Waltham Forest","11:00:00","2021-07-19",698,39,20,236,78,1071
"Waltham Forest","12:00:00","2021-07-19",814,51,19,268,75,1227
"Waltham Forest","13:00:00","2021-07-19",821,48,24,231,72,1196
"Waltham Forest","14:00:00","2021-07-19",861,52,19,210,63,1205
"Waltham Forest","15:00:00","2021-07-19",784,52,21,203,61,1121
"Waltham Forest","16:00:00","2021-07-19",893,66,22,176,42,1199
"Waltham Forest","17:00:00","2021-07-19",901,82,25,168,33,1209
"Waltham Forest","18:00:00","2021-07-19",942,65,20,102,17,1146
"Newham","07:00:00","2021-07-20",680,19,9,224,88,1020
"Newham","08:00:00","2021-07-20",642,5,4,166,100,917
"Newham","09:00:00","2021-07-20",578,13,10,149,127,877
"Newham","10:00:00","2021-07-20",667,14,5,167,136,989
"Newham","11:00:00","2021-07-20",687,18,1,154,130,990
"Newham","12:00:00","2021-07-20",774,22,4,154,117,1071
"Newham","13:00:00","2021-07-20",848,29,3,169,122,1171
"Newham","14:00:00","2021-07-20",785,34,9,163,102,1093
"Newham","15:00:00","2021-07-20",949,29,3,190,121,1292
"Newham","16:00:00","2021-07-20",1108,41,8,212,61,1430
"Newham","17:00:00","2021-07-20",1244,35,2,162,52,1495
"Newham","18:00:00","2021-07-20",1054,32,1,98,35,1220
"Ealing","07:00:00","2021-07-22",5307,182,17,1849,635,7990
"Wandsworth","07:00:00","2021-07-22",675,69,21,305,31,1101
"Ealing","08:00:00","2021-07-22",5112,118,19,1523,735,7507
"Wandsworth","08:00:00","2021-07-22",671,75,26,260,36,1068
"Ealing","09:00:00","2021-07-22",5012,100,19,1487,846,7464
"Wandsworth","09:00:00","2021-07-22",644,60,23,233,44,1004
"Ealing","10:00:00","2021-07-22",5048,73,20,1492,898,7531
"Wandsworth","10:00:00","2021-07-22",651,58,23,240,40,1012
"Ealing","11:00:00","2021-07-22",4981,100,19,1461,850,7411
"Wandsworth","11:00:00","2021-07-22",680,65,22,281,43,1091
"Ealing","12:00:00","2021-07-22",5310,116,22,1455,775,7678
"Wandsworth","12:00:00","2021-07-22",742,67,23,228,46,1106
"Ealing","13:00:00","2021-07-22",5488,104,22,1473,798,7885
"Wandsworth","13:00:00","2021-07-22",654,75,26,227,34,1016
"Ealing","14:00:00","2021-07-22",5566,112,21,1497,723,7919
"Wandsworth","14:00:00","2021-07-22",739,65,23,232,34,1093
"Ealing","15:00:00","2021-07-22",5480,117,23,1370,622,7612
"Wandsworth","15:00:00","2021-07-22",802,92,25,275,37,1231
"Ealing","16:00:00","2021-07-22",6530,196,17,1563,502,8808
"Wandsworth","16:00:00","2021-07-22",765,83,25,210,29,1112
"Wandsworth","17:00:00","2021-07-22",848,91,22,192,16,1169
"Ealing","18:00:00","2021-07-22",7386,180,13,965,216,8760
"Wandsworth","18:00:00","2021-07-22",933,116,22,133,8,1212
"Barnet","07:00:00","2021-09-01",349,14,39,188,37,627
"Harrow","07:00:00","2021-09-01",1081,15,20,323,41,1480
"Westminster","07:00:00","2021-09-01",718,62,35,346,86,1247
"Barnet","08:00:00","2021-09-01",415,16,32,147,38,648
"Harrow","08:00:00","2021-09-01",1169,18,20,243,40,1490
"Westminster","08:00:00","2021-09-01",951,72,40,305,85,1453
"Barnet","09:00:00","2021-09-01",392,22,34,145,43,636
"Harrow","09:00:00","2021-09-01",942,7,18,210,52,1229
"Westminster","09:00:00","2021-09-01",998,85,38,287,106,1514
"Barnet","10:00:00","2021-09-01",378,17,31,144,43,613
"Harrow","10:00:00","2021-09-01",1005,5,18,236,57,1321
"Westminster","10:00:00","2021-09-01",1011,77,31,308,91,1518
"Barnet","11:00:00","2021-09-01",415,22,33,120,35,625
"Harrow","11:00:00","2021-09-01",1029,10,16,226,53,1334
"Westminster","11:00:00","2021-09-01",1035,104,35,302,100,1576
"Barnet","12:00:00","2021-09-01",445,35,32,116,25,653
"Harrow","12:00:00","2021-09-01",1213,4,21,195,50,1483
"Westminster","12:00:00","2021-09-01",1067,143,34,287,77,1608
"Barnet","13:00:00","2021-09-01",452,30,33,113,23,651
"Harrow","13:00:00","2021-09-01",1076,9,21,226,49,1381
"Westminster","13:00:00","2021-09-01",1106,140,41,233,84,1604
"Barnet","14:00:00","2021-09-01",418,34,37,124,36,649
"Harrow","14:00:00","2021-09-01",1173,17,24,210,44,1468
"Westminster","14:00:00","2021-09-01",1157,167,35,262,72,1693
"Barnet","15:00:00","2021-09-01",483,35,34,115,32,699
"Harrow","15:00:00","2021-09-01",1227,21,16,229,52,1545
"Westminster","15:00:00","2021-09-01",1166,153,36,244,53,1652
"Barnet","16:00:00","2021-09-01",541,23,34,110,11,719
"Harrow","16:00:00","2021-09-01",1383,15,23,239,39,1699
"Westminster","16:00:00","2021-09-01",1263,136,35,247,41,1722
"Barnet","17:00:00","2021-09-01",548,34,29,98,14,723
"Harrow","17:00:00","2021-09-01",1499,18,16,188,17,1738
"Westminster","17:00:00","2021-09-01",1246,204,36,196,36,1718
"Barnet","18:00:00","2021-09-01",541,43,32,57,7,680
"Harrow","18:00:00","2021-09-01",1514,18,14,159,14,1719
"Westminster","18:00:00","2021-09-01",1365,161,33,131,15,1705
"Bexley","07:00:00","2021-09-02",129,0,0,17,0,146
"Croydon","07:00:00","2021-09-02",660,21,29,183,21,914
"Ealing","07:00:00","2021-09-02",1596,83,0,530,136,2345
"Greenwich","07:00:00","2021-09-02",735,22,36,151,10,954
"Bexley","08:00:00","2021-09-02",196,1,0,41,1,239
"Croydon","08:00:00","2021-09-02",735,18,33,155,28,969
"Ealing","08:00:00","2021-09-02",1536,75,0,457,170,2238
"Greenwich","08:00:00","2021-09-02",787,10,34,105,13,949
"Bexley","09:00:00","2021-09-02",124,2,0,23,9,158
"Croydon","09:00:00","2021-09-02",592,21,30,154,23,820
"Ealing","09:00:00","2021-09-02",1404,55,1,424,156,2040
"Greenwich","09:00:00","2021-09-02",632,5,44,101,16,798
"Bexley","10:00:00","2021-09-02",143,0,0,18,3,164
"Croydon","10:00:00","2021-09-02",611,19,31,159,32,852
"Ealing","10:00:00","2021-09-02",1487,45,2,454,171,2159
"Greenwich","10:00:00","2021-09-02",580,14,37,102,19,752
"Bexley","11:00:00","2021-09-02",186,0,0,15,2,203
"Croydon","11:00:00","2021-09-02",689,44,30,151,20,934
"Ealing","11:00:00","2021-09-02",1373,53,2,425,178,2031
"Greenwich","11:00:00","2021-09-02",657,12,35,127,22,853
"Bexley","12:00:00","2021-09-02",160,3,0,28,3,194
"Croydon","12:00:00","2021-09-02",687,47,31,147,20,932
"Ealing","12:00:00","2021-09-02",1466,68,0,411,162,2107
"Greenwich","12:00:00","2021-09-02",658,13,36,101,16,824
"Bexley","13:00:00","2021-09-02",160,2,0,27,4,193
"Croydon","13:00:00","2021-09-02",803,41,31,143,29,1047
"Ealing","13:00:00","2021-09-02",1460,56,2,373,141,2032
"Greenwich","13:00:00","2021-09-02",676,16,37,114,10,853
"Bexley","14:00:00","2021-09-02",127,1,0,19,1,148
"Croydon","14:00:00","2021-09-02",780,35,31,171,20,1037
"Ealing","14:00:00","2021-09-02",1460,45,1,367,134,2007
"Greenwich","14:00:00","2021-09-02",729,13,42,113,15,912
"Bexley","15:00:00","2021-09-02",207,1,0,39,1,248
"Croydon","15:00:00","2021-09-02",827,34,32,181,14,1088
"Ealing","15:00:00","2021-09-02",1474,86,0,317,100,1977
"Greenwich","15:00:00","2021-09-02",822,25,38,95,10,990
"Bexley","16:00:00","2021-09-02",179,0,0,35,3,217
"Croydon","16:00:00","2021-09-02",896,67,29,144,13,1149
"Ealing","16:00:00","2021-09-02",1513,77,0,318,77,1985
"Greenwich","16:00:00","2021-09-02",839,23,37,105,12,1016
"Bexley","17:00:00","2021-09-02",205,3,0,34,1,243
"Croydon","17:00:00","2021-09-02",993,60,30,146,7,1236
"Ealing","17:00:00","2021-09-02",1312,110,0,216,46,1684
"Greenwich","17:00:00","2021-09-02",902,25,37,104,11,1079
"Bexley","18:00:00","2021-09-02",240,6,0,12,1,259
"Croydon","18:00:00","2021-09-02",990,72,30,123,3,1218
"Ealing","18:00:00","2021-09-02",1763,73,2,187,49,2074
"Greenwich","18:00:00","2021-09-02",897,28,35,69,7,1036
"Brent","07:00:00","2021-09-03",659,23,85,348,80,1195
"Bromley","07:00:00","2021-09-03",22,0,0,3,1,26
"Ealing","07:00:00","2021-09-03",5026,206,40,1747,669,7688
"Islington","07:00:00","2021-09-03",528,36,13,230,30,837
"Brent","08:00:00","2021-09-03",748,26,69,343,93,1279
"Bromley","08:00:00","2021-09-03",29,0,0,2,2,33
"Ealing","08:00:00","2021-09-03",5052,156,28,1471,742,7449
"Islington","08:00:00","2021-09-03",559,34,15,202,39,849
"Brent","09:00:00","2021-09-03",825,21,75,282,103,1306
"Bromley","09:00:00","2021-09-03",14,0,0,3,3,20
"Ealing","09:00:00","2021-09-03",5003,107,30,1493,779,7412
"Islington","09:00:00","2021-09-03",568,35,17,222,56,898
"Brent","10:00:00","2021-09-03",1006,33,68,349,103,1559
"Bromley","10:00:00","2021-09-03",13,0,0,12,0,25
"Ealing","10:00:00","2021-09-03",5005,90,34,1349,822,7300
"Islington","10:00:00","2021-09-03",559,51,16,211,70,907
"Brent","11:00:00","2021-09-03",1124,38,67,309,89,1627
"Bromley","11:00:00","2021-09-03",22,0,0,7,0,29
"Ealing","11:00:00","2021-09-03",4888,105,29,1408,772,7202
"Islington","11:00:00","2021-09-03",571,68,15,259,55,968
"Brent","12:00:00","2021-09-03",1134,37,73,261,81,1586
"Bromley","12:00:00","2021-09-03",27,0,0,3,0,30
"Ealing","12:00:00","2021-09-03",5194,88,29,1406,656,7373
"Islington","12:00:00","2021-09-03",629,101,14,279,49,1072
"Brent","13:00:00","2021-09-03",1227,45,76,257,77,1682
"Bromley","13:00:00","2021-09-03",18,0,0,2,0,20
"Ealing","13:00:00","2021-09-03",5404,98,26,1419,655,7602
"Islington","13:00:00","2021-09-03",590,100,14,219,45,968
"Brent","14:00:00","2021-09-03",1224,33,75,232,84,1648
"Bromley","14:00:00","2021-09-03",20,0,0,8,0,28
"Ealing","14:00:00","2021-09-03",6067,120,30,1448,635,8300
"Islington","14:00:00","2021-09-03",728,71,14,210,26,1049
"Brent","15:00:00","2021-09-03",1141,30,67,251,47,1536
"Bromley","15:00:00","2021-09-03",38,2,0,6,0,46
"Ealing","15:00:00","2021-09-03",6089,137,28,1402,590,8246
"Islington","15:00:00","2021-09-03",749,82,16,198,34,1079
"Brent","16:00:00","2021-09-03",1262,46,71,238,30,1647
"Bromley","16:00:00","2021-09-03",16,2,0,5,0,23
"Ealing","16:00:00","2021-09-03",6700,211,23,1479,382,8795
"Islington","16:00:00","2021-09-03",754,64,14,182,25,1039
"Brent","17:00:00","2021-09-03",1339,46,64,211,30,1690
"Bromley","17:00:00","2021-09-03",30,0,0,2,2,34
"Ealing","17:00:00","2021-09-03",6997,275,24,1196,325,8817
"Islington","17:00:00","2021-09-03",860,101,15,169,24,1169
"Brent","18:00:00","2021-09-03",1384,49,73,147,21,1674
"Bromley","18:00:00","2021-09-03",43,0,0,1,0,44
"Islington","18:00:00","2021-09-03",924,101,16,92,26,1159
"Bexley","07:00:00","2021-09-06",342,2,5,69,5,423
"Harrow","07:00:00","2021-09-06",38,0,1,8,3,50
"Havering","07:00:00","2021-09-06",770,10,2,133,14,929
"Hillingdon","07:00:00","2021-09-06",956,22,15,281,70,1344
"Lambeth","07:00:00","2021-09-06",735,77,10,313,75,1210
"Richmond upon Thames","07:00:00","2021-09-06",605,19,15,122,18,779
"Bexley","08:00:00","2021-09-06",643,3,6,89,9,750
"Harrow","08:00:00","2021-09-06",110,1,0,5,0,116
"Havering","08:00:00","2021-09-06",788,4,4,128,10,934
"Hillingdon","08:00:00","2021-09-06",1131,10,18,242,62,1463
"Lambeth","08:00:00","2021-09-06",786,72,9,313,75,1255
"Richmond upon Thames","08:00:00","2021-09-06",681,22,17,111,16,847
"Bexley","09:00:00","2021-09-06",348,3,2,59,8,420
"Harrow","09:00:00","2021-09-06",49,5,0,10,0,64
"Havering","09:00:00","2021-09-06",597,3,5,86,10,701
"Hillingdon","09:00:00","2021-09-06",962,18,15,261,90,1346
"Lambeth","09:00:00","2021-09-06",747,64,13,322,96,1242
"Richmond upon Thames","09:00:00","2021-09-06",480,12,15,105,11,623
"Bexley","10:00:00","2021-09-06",301,6,1,72,6,386
"Harrow","10:00:00","2021-09-06",44,2,0,7,3,56
"Havering","10:00:00","2021-09-06",544,0,1,80,11,636
"Hillingdon","10:00:00","2021-09-06",899,13,16,209,100,1237
"Lambeth","10:00:00","2021-09-06",665,57,10,294,89,1115
"Richmond upon Thames","10:00:00","2021-09-06",466,11,15,80,23,595
"Bexley","11:00:00","2021-09-06",332,8,0,76,7,423
"Harrow","11:00:00","2021-09-06",48,0,0,5,0,53
"Havering","11:00:00","2021-09-06",541,0,1,93,6,641
"Hillingdon","11:00:00","2021-09-06",926,18,10,252,90,1296
"Lambeth","11:00:00","2021-09-06",686,75,12,274,92,1139
"Richmond upon Thames","11:00:00","2021-09-06",425,13,10,88,11,547
"Bexley","12:00:00","2021-09-06",377,3,1,73,6,460
"Harrow","12:00:00","2021-09-06",45,2,0,5,0,52
"Havering","12:00:00","2021-09-06",563,5,1,76,5,650
"Hillingdon","12:00:00","2021-09-06",1038,25,13,231,83,1390
"Lambeth","12:00:00","2021-09-06",661,101,10,298,83,1153
"Richmond upon Thames","12:00:00","2021-09-06",484,24,15,93,17,633
"Bexley","13:00:00","2021-09-06",360,3,1,58,7,429
"Harrow","13:00:00","2021-09-06",47,4,0,7,2,60
"Havering","13:00:00","2021-09-06",581,4,1,90,6,682
"Hillingdon","13:00:00","2021-09-06",1053,22,13,236,74,1398
"Lambeth","13:00:00","2021-09-06",664,100,11,291,91,1157
"Richmond upon Thames","13:00:00","2021-09-06",505,20,17,79,8,629
"Bexley","14:00:00","2021-09-06",434,2,2,62,4,504
"Harrow","14:00:00","2021-09-06",74,6,0,15,2,97
"Havering","14:00:00","2021-09-06",568,8,3,85,9,673
"Hillingdon","14:00:00","2021-09-06",1117,23,15,229,89,1473
"Lambeth","14:00:00","2021-09-06",686,87,9,276,86,1144
"Richmond upon Thames","14:00:00","2021-09-06",531,16,14,84,5,650
"Bexley","15:00:00","2021-09-06",491,5,3,68,9,576
"Harrow","15:00:00","2021-09-06",88,9,1,11,3,112
"Havering","15:00:00","2021-09-06",691,6,5,93,10,805
"Hillingdon","15:00:00","2021-09-06",1142,24,16,208,67,1457
"Lambeth","15:00:00","2021-09-06",843,91,11,274,58,1277
"Richmond upon Thames","15:00:00","2021-09-06",585,8,15,83,11,702
"Bexley","16:00:00","2021-09-06",461,8,7,93,5,574
"Harrow","16:00:00","2021-09-06",58,2,0,9,0,69
"Havering","16:00:00","2021-09-06",855,10,7,118,4,994
"Hillingdon","16:00:00","2021-09-06",1249,33,14,213,45,1554
"Lambeth","16:00:00","2021-09-06",902,126,11,258,42,1339
"Richmond upon Thames","16:00:00","2021-09-06",661,18,11,102,9,801
"Bexley","17:00:00","2021-09-06",529,14,1,69,4,617
"Harrow","17:00:00","2021-09-06",61,6,0,3,0,70
"Havering","17:00:00","2021-09-06",894,5,1,107,5,1012
"Hillingdon","17:00:00","2021-09-06",1275,35,19,212,35,1576
"Lambeth","17:00:00","2021-09-06",934,142,12,258,33,1379
"Richmond upon Thames","17:00:00","2021-09-06",756,28,8,65,10,867
"Bexley","18:00:00","2021-09-06",413,10,0,42,1,466
"Harrow","18:00:00","2021-09-06",73,11,0,7,0,91
"Havering","18:00:00","2021-09-06",645,3,0,59,5,712
"Hillingdon","18:00:00","2021-09-06",1366,41,16,246,26,1695
"Lambeth","18:00:00","2021-09-06",1044,139,11,164,32,1390
"Richmond upon Thames","18:00:00","2021-09-06",625,19,15,47,5,711
"Barnet","07:00:00","2021-09-07",2236,118,68,971,213,3606
"Brent","07:00:00","2021-09-07",849,33,40,155,33,1110
"Bromley","07:00:00","2021-09-07",637,15,5,137,6,800
"Haringey","07:00:00","2021-09-07",762,23,38,255,38,1116
"Hillingdon","07:00:00","2021-09-07",110,0,0,13,2,125
"Sutton","07:00:00","2021-09-07",77,1,1,21,1,101
"Wandsworth","07:00:00","2021-09-07",1888,245,33,799,132,3097
"Barnet","08:00:00","2021-09-07",2514,79,59,704,198,3554
"Brent","08:00:00","2021-09-07",806,29,32,91,46,1004
"Bromley","08:00:00","2021-09-07",730,6,5,96,15,852
"Haringey","08:00:00","2021-09-07",920,21,40,214,26,1221
"Hillingdon","08:00:00","2021-09-07",262,0,0,21,2,285
"Sutton","08:00:00","2021-09-07",130,2,4,17,5,158
"Wandsworth","08:00:00","2021-09-07",1902,202,32,586,141,2863
"Barnet","09:00:00","2021-09-07",2332,81,58,701,234,3406
"Brent","09:00:00","2021-09-07",734,22,33,137,45,971
"Bromley","09:00:00","2021-09-07",538,7,5,109,8,667
"Haringey","09:00:00","2021-09-07",869,20,35,200,56,1180
"Hillingdon","09:00:00","2021-09-07",116,0,0,13,4,133
"Sutton","09:00:00","2021-09-07",85,3,4,16,2,110
"Wandsworth","09:00:00","2021-09-07",1971,163,31,674,165,3004
"Barnet","10:00:00","2021-09-07",2347,70,58,613,248,3336
"Brent","10:00:00","2021-09-07",726,28,37,146,49,986
"Bromley","10:00:00","2021-09-07",405,6,5,79,13,508
"Haringey","10:00:00","2021-09-07",708,19,35,204,44,1010
"Hillingdon","10:00:00","2021-09-07",118,0,0,14,3,135
"Sutton","10:00:00","2021-09-07",68,6,0,14,1,89
"Wandsworth","10:00:00","2021-09-07",1916,177,32,746,216,3087
"Barnet","11:00:00","2021-09-07",2375,62,57,577,237,3308
"Brent","11:00:00","2021-09-07",721,35,28,149,54,987
"Bromley","11:00:00","2021-09-07",417,8,7,76,11,519
"Haringey","11:00:00","2021-09-07",731,37,31,183,52,1034
"Hillingdon","11:00:00","2021-09-07",101,0,0,19,2,122
"Sutton","11:00:00","2021-09-07",82,2,0,9,2,95
"Wandsworth","11:00:00","2021-09-07",2044,161,29,792,198,3224
"Barnet","12:00:00","2021-09-07",2645,72,50,617,189,3573
"Brent","12:00:00","2021-09-07",767,42,33,165,43,1050
"Bromley","12:00:00","2021-09-07",426,19,5,73,13,536
"Haringey","12:00:00","2021-09-07",703,51,32,227,41,1054
"Hillingdon","12:00:00","2021-09-07",121,0,0,17,4,142
"Sutton","12:00:00","2021-09-07",72,4,0,7,6,89
"Wandsworth","12:00:00","2021-09-07",1958,184,26,740,171,3079
"Barnet","13:00:00","2021-09-07",2725,95,52,644,198,3714
"Brent","13:00:00","2021-09-07",816,48,29,173,40,1106
"Bromley","13:00:00","2021-09-07",457,13,6,98,22,596
"Haringey","13:00:00","2021-09-07",722,53,37,182,31,1025
"Hillingdon","13:00:00","2021-09-07",113,2,0,15,3,133
"Sutton","13:00:00","2021-09-07",85,1,1,18,3,108
"Wandsworth","13:00:00","2021-09-07",2003,209,35,735,177,3159
"Barnet","14:00:00","2021-09-07",2683,96,62,619,157,3617
"Brent","14:00:00","2021-09-07",891,45,31,158,36,1161
"Bromley","14:00:00","2021-09-07",490,15,6,79,5,595
"Haringey","14:00:00","2021-09-07",841,47,36,189,39,1152
"Hillingdon","14:00:00","2021-09-07",150,4,0,6,1,161
"Sutton","14:00:00","2021-09-07",89,1,1,18,1,110
"Wandsworth","14:00:00","2021-09-07",2130,198,27,701,167,3223
"Barnet","15:00:00","2021-09-07",2759,110,65,716,157,3807
"Brent","15:00:00","2021-09-07",947,40,30,133,32,1182
"Bromley","15:00:00","2021-09-07",592,12,7,82,4,697
"Haringey","15:00:00","2021-09-07",902,21,36,172,34,1165
"Hillingdon","15:00:00","2021-09-07",213,3,0,12,0,228
"Sutton","15:00:00","2021-09-07",141,2,6,19,0,168
"Wandsworth","15:00:00","2021-09-07",2320,223,25,664,144,3376
"Barnet","16:00:00","2021-09-07",3023,113,68,720,110,4034
"Brent","16:00:00","2021-09-07",873,47,46,156,16,1138
"Bromley","16:00:00","2021-09-07",716,15,7,117,5,860
"Haringey","16:00:00","2021-09-07",946,63,39,203,26,1277
"Hillingdon","16:00:00","2021-09-07",140,2,0,14,1,157
"Sutton","16:00:00","2021-09-07",105,13,0,15,0,133
"Wandsworth","16:00:00","2021-09-07",2476,260,37,678,87,3538
"Barnet","17:00:00","2021-09-07",3223,133,55,633,107,4151
"Brent","17:00:00","2021-09-07",1039,59,31,119,22,1270
"Bromley","17:00:00","2021-09-07",821,18,6,88,5,938
"Haringey","17:00:00","2021-09-07",1153,66,31,135,14,1399
"Hillingdon","17:00:00","2021-09-07",142,3,0,7,0,152
"Sutton","17:00:00","2021-09-07",119,12,0,14,3,148
"Wandsworth","17:00:00","2021-09-07",2570,347,40,539,57,3553
"Barnet","18:00:00","2021-09-07",3531,129,54,390,67,4171
"Brent","18:00:00","2021-09-07",945,56,32,103,11,1147
"Bromley","18:00:00","2021-09-07",703,20,6,68,4,801
"Haringey","18:00:00","2021-09-07",1115,73,38,110,15,1351
"Hillingdon","18:00:00","2021-09-07",142,3,0,14,0,159
"Sutton","18:00:00","2021-09-07",102,7,0,13,2,124
"Wandsworth","18:00:00","2021-09-07",2733,355,28,349,57,3522
"Barnet","07:00:00","2021-09-08",2578,77,16,856,187,3714
"Enfield","07:00:00","2021-09-08",1306,21,16,409,59,1811
"Waltham Forest","07:00:00","2021-09-08",661,6,20,147,17,851
"Barnet","08:00:00","2021-09-08",2729,51,14,652,181,3627
"Enfield","08:00:00","2021-09-08",1565,13,8,217,40,1843
"Waltham Forest","08:00:00","2021-09-08",1029,14,21,148,15,1227
"Barnet","09:00:00","2021-09-08",2275,35,8,553,174,3045
"Enfield","09:00:00","2021-09-08",1225,18,9,229,51,1532
"Waltham Forest","09:00:00","2021-09-08",758,17,28,136,24,963
"Barnet","10:00:00","2021-09-08",1907,24,3,561,196,2691
"Enfield","10:00:00","2021-09-08",1070,27,11,215,53,1376
"Waltham Forest","10:00:00","2021-09-08",656,13,22,101,25,817
"Barnet","11:00:00","2021-09-08",1928,27,2,482,167,2606
"Enfield","11:00:00","2021-09-08",1123,23,6,196,62,1410
"Waltham Forest","11:00:00","2021-09-08",645,13,25,87,17,787
"Barnet","12:00:00","2021-09-08",1983,17,2,475,173,2650
"Enfield","12:00:00","2021-09-08",1122,33,10,189,50,1404
"Waltham Forest","12:00:00","2021-09-08",613,20,27,128,16,804
"Barnet","13:00:00","2021-09-08",1982,34,3,509,168,2696
"Enfield","13:00:00","2021-09-08",1127,37,12,191,48,1415
"Waltham Forest","13:00:00","2021-09-08",666,20,23,96,13,818
"Barnet","14:00:00","2021-09-08",2126,39,9,542,177,2893
"Enfield","14:00:00","2021-09-08",1309,33,8,233,42,1625
"Waltham Forest","14:00:00","2021-09-08",727,22,23,131,16,919
"Barnet","15:00:00","2021-09-08",2297,47,17,587,131,3079
"Enfield","15:00:00","2021-09-08",1398,24,10,218,31,1681
"Waltham Forest","15:00:00","2021-09-08",830,23,24,121,12,1010
"Barnet","16:00:00","2021-09-08",2616,55,14,642,95,3422
"Enfield","16:00:00","2021-09-08",1329,31,14,204,18,1596
"Waltham Forest","16:00:00","2021-09-08",939,29,22,129,13,1132
"Barnet","17:00:00","2021-09-08",3152,97,5,655,75,3984
"Enfield","17:00:00","2021-09-08",1540,45,10,197,13,1805
"Waltham Forest","17:00:00","2021-09-08",1047,24,26,102,17,1216
"Barnet","18:00:00","2021-09-08",3495,76,7,448,66,4092
"Enfield","18:00:00","2021-09-08",1459,42,11,124,9,1645
"Waltham Forest","18:00:00","2021-09-08",864,23,25,79,7,998
"Brent","07:00:00","2021-09-09",3478,160,11,1351,453,5453
"Camden","07:00:00","2021-09-09",884,116,54,382,84,1520
"Croydon","07:00:00","2021-09-09",4,0,0,2,0,6
"Brent","08:00:00","2021-09-09",3202,105,13,1130,429,4879
"Camden","08:00:00","2021-09-09",961,122,53,325,95,1556
"Croydon","08:00:00","2021-09-09",9,0,0,2,0,11
"Brent","09:00:00","2021-09-09",3329,75,14,1334,502,5254
"Camden","09:00:00","2021-09-09",890,99,60,379,110,1538
"Croydon","09:00:00","2021-09-09",6,0,0,1,0,7
"Brent","10:00:00","2021-09-09",3256,72,4,1318,580,5230
"Camden","10:00:00","2021-09-09",889,75,51,340,75,1430
"Croydon","10:00:00","2021-09-09",4,0,0,3,0,7
"Brent","11:00:00","2021-09-09",3273,65,4,1391,588,5321
"Camden","11:00:00","2021-09-09",872,109,49,351,86,1467
"Croydon","11:00:00","2021-09-09",1,0,0,3,0,4
"Brent","12:00:00","2021-09-09",3334,68,0,1245,567,5214
"Camden","12:00:00","2021-09-09",900,122,44,357,93,1516
"Croydon","12:00:00","2021-09-09",2,0,0,2,0,4
"Brent","13:00:00","2021-09-09",3517,72,3,1151,532,5275
"Camden","13:00:00","2021-09-09",958,125,44,352,85,1564
"Croydon","13:00:00","2021-09-09",1,0,0,1,0,2
"Brent","14:00:00","2021-09-09",3531,86,10,1160,485,5272
"Camden","14:00:00","2021-09-09",947,125,48,342,69,1531
"Croydon","14:00:00","2021-09-09",9,0,0,1,0,10
"Brent","15:00:00","2021-09-09",3432,96,3,1061,366,4958
"Camden","15:00:00","2021-09-09",997,158,50,312,56,1573
"Croydon","15:00:00","2021-09-09",9,0,0,2,0,11
"Brent","16:00:00","2021-09-09",3966,136,5,1204,266,5577
"Camden","16:00:00","2021-09-09",1121,188,59,316,48,1732
"Croydon","16:00:00","2021-09-09",9,0,0,0,0,9
"Brent","17:00:00","2021-09-09",4401,179,12,1030,199,5821
"Camden","17:00:00","2021-09-09",1235,197,57,294,30,1813
"Croydon","17:00:00","2021-09-09",8,1,0,2,0,11
"Brent","18:00:00","2021-09-09",4560,145,14,766,194,5679
"Camden","18:00:00","2021-09-09",1426,216,56,182,26,1906
"Croydon","18:00:00","2021-09-09",4,0,0,0,0,4
"Kingston upon Thames","07:00:00","2021-09-10",6267,154,51,1921,356,8749
"Merton","07:00:00","2021-09-10",720,57,53,263,52,1145
"Redbridge","07:00:00","2021-09-10",369,6,13,61,12,461
"Waltham Forest","07:00:00","2021-09-10",55,0,0,4,0,59
"Wandsworth","07:00:00","2021-09-10",258,26,0,138,5,427
"Kingston upon Thames","08:00:00","2021-09-10",6142,128,32,1391,348,8041
"Merton","08:00:00","2021-09-10",767,58,36,223,58,1142
"Redbridge","08:00:00","2021-09-10",474,5,15,67,13,574
"Waltham Forest","08:00:00","2021-09-10",149,0,0,4,0,153
"Wandsworth","08:00:00","2021-09-10",300,38,0,90,6,434
"Kingston upon Thames","09:00:00","2021-09-10",5078,87,22,1335,383,6905
"Merton","09:00:00","2021-09-10",808,66,49,231,52,1206
"Redbridge","09:00:00","2021-09-10",394,5,14,74,20,507
"Waltham Forest","09:00:00","2021-09-10",76,2,0,13,2,93
"Wandsworth","09:00:00","2021-09-10",289,34,0,114,8,445
"Kingston upon Thames","10:00:00","2021-09-10",4953,72,19,1105,378,6527
"Merton","10:00:00","2021-09-10",844,48,39,204,59,1194
"Redbridge","10:00:00","2021-09-10",311,8,9,57,16,401
"Waltham Forest","10:00:00","2021-09-10",50,3,0,9,0,62
"Wandsworth","10:00:00","2021-09-10",303,30,0,85,12,430
"Kingston upon Thames","11:00:00","2021-09-10",4972,52,19,1195,360,6598
"Merton","11:00:00","2021-09-10",834,73,42,210,66,1225
"Redbridge","11:00:00","2021-09-10",321,8,14,73,7,423
"Waltham Forest","11:00:00","2021-09-10",68,0,0,3,2,73
"Wandsworth","11:00:00","2021-09-10",335,28,0,99,16,478
"Kingston upon Thames","12:00:00","2021-09-10",5126,80,27,1146,318,6697
"Merton","12:00:00","2021-09-10",900,88,46,207,60,1301
"Redbridge","12:00:00","2021-09-10",386,9,10,53,6,464
"Waltham Forest","12:00:00","2021-09-10",56,2,0,11,0,69
"Wandsworth","12:00:00","2021-09-10",340,34,0,100,13,487
"Kingston upon Thames","13:00:00","2021-09-10",5318,96,26,1276,307,7023
"Merton","13:00:00","2021-09-10",925,95,39,202,55,1316
"Redbridge","13:00:00","2021-09-10",392,14,12,64,9,491
"Waltham Forest","13:00:00","2021-09-10",96,0,0,13,0,109
"Wandsworth","13:00:00","2021-09-10",330,28,0,117,14,489
"Kingston upon Thames","14:00:00","2021-09-10",5803,84,25,1318,293,7523
"Merton","14:00:00","2021-09-10",887,78,43,183,37,1228
"Redbridge","14:00:00","2021-09-10",411,14,11,57,5,498
"Waltham Forest","14:00:00","2021-09-10",77,1,0,7,2,87
"Wandsworth","14:00:00","2021-09-10",337,18,0,72,13,440
"Kingston upon Thames","15:00:00","2021-09-10",6390,89,29,1278,204,7990
"Merton","15:00:00","2021-09-10",858,79,42,179,46,1204
"Redbridge","15:00:00","2021-09-10",444,12,11,51,6,524
"Waltham Forest","15:00:00","2021-09-10",123,2,0,2,0,127
"Wandsworth","15:00:00","2021-09-10",356,33,0,92,11,492
"Kingston upon Thames","16:00:00","2021-09-10",7042,131,43,1349,129,8694
"Merton","16:00:00","2021-09-10",892,80,38,168,30,1208
"Redbridge","16:00:00","2021-09-10",418,12,12,50,4,496
"Waltham Forest","16:00:00","2021-09-10",62,0,0,4,0,66
"Wandsworth","16:00:00","2021-09-10",347,30,1,66,9,453
"Kingston upon Thames","17:00:00","2021-09-10",7256,173,35,1043,112,8619
"Merton","17:00:00","2021-09-10",918,93,41,125,22,1199
"Redbridge","17:00:00","2021-09-10",422,13,12,54,3,504
"Waltham Forest","17:00:00","2021-09-10",56,8,0,8,0,72
"Wandsworth","17:00:00","2021-09-10",387,39,0,57,3,486
"Kingston upon Thames","18:00:00","2021-09-10",7089,162,32,702,100,8085
"Merton","18:00:00","2021-09-10",887,115,40,101,14,1157
"Redbridge","18:00:00","2021-09-10",411,13,12,36,4,476
"Waltham Forest","18:00:00","2021-09-10",43,1,0,3,0,47
"Wandsworth","18:00:00","2021-09-10",383,62,0,41,4,490
"Haringey","07:00:00","2021-09-13",23,0,0,4,0,27
"Hillingdon","07:00:00","2021-09-13",84,0,0,5,0,89
"Lewisham","07:00:00","2021-09-13",1178,40,59,347,58,1682
"Haringey","08:00:00","2021-09-13",36,5,1,10,0,52
"Hillingdon","08:00:00","2021-09-13",256,3,0,16,0,275
"Lewisham","08:00:00","2021-09-13",1403,38,64,281,54,1840
"Haringey","09:00:00","2021-09-13",31,4,0,10,1,46
"Hillingdon","09:00:00","2021-09-13",56,1,0,8,0,65
"Lewisham","09:00:00","2021-09-13",1070,33,79,338,65,1585
"Haringey","10:00:00","2021-09-13",34,4,1,9,2,50
"Hillingdon","10:00:00","2021-09-13",46,1,0,11,6,64
"Lewisham","10:00:00","2021-09-13",1052,35,57,290,94,1528
"Haringey","11:00:00","2021-09-13",40,0,0,13,1,54
"Hillingdon","11:00:00","2021-09-13",36,2,0,15,1,54
"Lewisham","11:00:00","2021-09-13",1072,35,61,291,70,1529
"Haringey","12:00:00","2021-09-13",20,4,0,10,1,35
"Hillingdon","12:00:00","2021-09-13",56,0,0,7,2,65
"Lewisham","12:00:00","2021-09-13",1100,40,61,285,64,1550
"Haringey","13:00:00","2021-09-13",28,5,0,9,3,45
"Hillingdon","13:00:00","2021-09-13",59,1,0,9,1,70
"Lewisham","13:00:00","2021-09-13",1121,54,65,360,52,1652
"Haringey","14:00:00","2021-09-13",26,4,0,17,0,47
"Hillingdon","14:00:00","2021-09-13",135,2,0,7,0,144
"Lewisham","14:00:00","2021-09-13",1229,37,67,321,51,1705
"Haringey","15:00:00","2021-09-13",29,5,0,9,2,45
"Hillingdon","15:00:00","2021-09-13",122,3,0,7,3,135
"Lewisham","15:00:00","2021-09-13",1399,44,66,275,44,1828
"Haringey","16:00:00","2021-09-13",44,5,0,4,1,54
"Hillingdon","16:00:00","2021-09-13",80,1,0,14,0,95
"Lewisham","16:00:00","2021-09-13",1400,58,63,333,25,1879
"Haringey","17:00:00","2021-09-13",37,8,0,5,1,51
"Hillingdon","17:00:00","2021-09-13",82,2,0,6,0,90
"Lewisham","17:00:00","2021-09-13",1523,45,63,237,22,1890
"Haringey","18:00:00","2021-09-13",30,8,0,6,0,44
"Hillingdon","18:00:00","2021-09-13",65,4,0,11,1,81
"Lewisham","18:00:00","2021-09-13",1487,67,64,160,18,1796
"Bromley","07:00:00","2021-09-14",43,0,2,15,2,62
"Hillingdon","07:00:00","2021-09-14",539,6,20,105,27,697
"Westminster","07:00:00","2021-09-14",1259,170,152,546,157,2284
"Bromley","08:00:00","2021-09-14",76,0,2,20,2,100
"Hillingdon","08:00:00","2021-09-14",731,8,21,118,24,902
"Westminster","08:00:00","2021-09-14",1534,176,140,514,169,2533
"Bromley","09:00:00","2021-09-14",61,0,0,12,3,76
"Hillingdon","09:00:00","2021-09-14",385,4,18,91,19,517
"Westminster","09:00:00","2021-09-14",1623,132,165,494,160,2574
"Bromley","10:00:00","2021-09-14",33,0,3,14,1,51
"Hillingdon","10:00:00","2021-09-14",308,0,16,67,16,407
"Westminster","10:00:00","2021-09-14",1571,128,160,509,136,2504
"Bromley","11:00:00","2021-09-14",28,1,2,12,1,44
"Hillingdon","11:00:00","2021-09-14",343,1,15,67,16,442
"Westminster","11:00:00","2021-09-14",1577,105,151,422,126,2381
"Bromley","12:00:00","2021-09-14",41,0,2,5,4,52
"Hillingdon","12:00:00","2021-09-14",378,1,16,83,15,493
"Westminster","12:00:00","2021-09-14",1584,107,143,436,111,2381
"Bromley","13:00:00","2021-09-14",28,1,2,8,2,41
"Hillingdon","13:00:00","2021-09-14",428,6,17,108,14,573
"Westminster","13:00:00","2021-09-14",1614,114,151,409,107,2395
"Bromley","14:00:00","2021-09-14",49,0,2,11,3,65
"Hillingdon","14:00:00","2021-09-14",513,8,17,84,19,641
"Westminster","14:00:00","2021-09-14",1674,134,150,419,94,2471
"Bromley","15:00:00","2021-09-14",62,0,2,10,1,75
"Hillingdon","15:00:00","2021-09-14",574,8,18,77,17,694
"Westminster","15:00:00","2021-09-14",1651,155,142,369,70,2387
"Bromley","16:00:00","2021-09-14",83,0,2,25,3,113
"Hillingdon","16:00:00","2021-09-14",559,5,21,86,17,688
"Westminster","16:00:00","2021-09-14",1765,172,153,302,61,2453
"Bromley","17:00:00","2021-09-14",92,0,2,21,1,116
"Hillingdon","17:00:00","2021-09-14",699,13,16,88,11,827
"Westminster","17:00:00","2021-09-14",1976,191,143,210,50,2570
"Bromley","18:00:00","2021-09-14",122,0,2,21,2,147
"Hillingdon","18:00:00","2021-09-14",621,15,16,87,6,745
"Westminster","18:00:00","2021-09-14",2223,215,156,157,35,2786
"Ealing","07:00:00","2021-09-15",5,0,0,2,0,7
"Havering","07:00:00","2021-09-15",601,8,41,135,19,804
"Hillingdon","07:00:00","2021-09-15",215,2,1,17,2,237
"Hounslow","07:00:00","2021-09-15",1449,130,43,489,63,2174
"Kingston upon Thames","07:00:00","2021-09-15",44,0,0,8,2,54
"Ealing","08:00:00","2021-09-15",2,0,0,0,2,4
"Havering","08:00:00","2021-09-15",948,5,34,117,8,1112
"Hillingdon","08:00:00","2021-09-15",444,0,2,17,3,466
"Hounslow","08:00:00","2021-09-15",1514,115,40,363,63,2095
"Kingston upon Thames","08:00:00","2021-09-15",141,3,0,4,3,151
"Ealing","09:00:00","2021-09-15",3,0,0,3,0,6
"Havering","09:00:00","2021-09-15",694,6,38,121,19,878
"Hillingdon","09:00:00","2021-09-15",161,3,0,16,7,187
"Hounslow","09:00:00","2021-09-15",1448,70,43,360,84,2005
"Kingston upon Thames","09:00:00","2021-09-15",51,2,0,5,2,60
"Ealing","10:00:00","2021-09-15",4,0,0,1,4,9
"Havering","10:00:00","2021-09-15",675,14,34,115,16,854
"Hillingdon","10:00:00","2021-09-15",107,5,0,17,7,136
"Hounslow","10:00:00","2021-09-15",1344,57,39,366,97,1903
"Kingston upon Thames","10:00:00","2021-09-15",32,0,0,8,6,46
"Ealing","11:00:00","2021-09-15",4,0,0,1,0,5
"Havering","11:00:00","2021-09-15",674,1,33,117,35,860
"Hillingdon","11:00:00","2021-09-15",117,3,0,26,4,150
"Hounslow","11:00:00","2021-09-15",1229,51,41,373,90,1784
"Kingston upon Thames","11:00:00","2021-09-15",37,1,0,5,1,44
"Ealing","12:00:00","2021-09-15",4,0,0,4,2,10
"Havering","12:00:00","2021-09-15",712,11,27,125,29,904
"Hillingdon","12:00:00","2021-09-15",117,0,1,12,2,132
"Hounslow","12:00:00","2021-09-15",1317,57,34,344,90,1842
"Kingston upon Thames","12:00:00","2021-09-15",37,3,0,11,0,51
"Ealing","13:00:00","2021-09-15",8,0,0,1,0,9
"Havering","13:00:00","2021-09-15",699,12,31,113,23,878
"Hillingdon","13:00:00","2021-09-15",111,1,0,9,3,124
"Hounslow","13:00:00","2021-09-15",1314,80,51,328,80,1853
"Kingston upon Thames","13:00:00","2021-09-15",29,1,0,8,2,40
"Ealing","14:00:00","2021-09-15",7,0,0,1,0,8
"Havering","14:00:00","2021-09-15",720,10,36,121,18,905
"Hillingdon","14:00:00","2021-09-15",181,0,0,17,7,205
"Hounslow","14:00:00","2021-09-15",1459,67,40,350,78,1994
"Kingston upon Thames","14:00:00","2021-09-15",44,0,0,6,0,50
"Ealing","15:00:00","2021-09-15",7,1,0,2,0,10
"Havering","15:00:00","2021-09-15",831,7,31,115,9,993
"Hillingdon","15:00:00","2021-09-15",350,1,0,31,5,387
"Hounslow","15:00:00","2021-09-15",1562,59,40,373,51,2085
"Kingston upon Thames","15:00:00","2021-09-15",110,3,0,9,1,123
"Ealing","16:00:00","2021-09-15",13,0,0,3,1,17
"Havering","16:00:00","2021-09-15",849,8,39,156,9,1061
"Hillingdon","16:00:00","2021-09-15",268,3,0,18,2,291
"Hounslow","16:00:00","2021-09-15",1617,102,40,369,40,2168
"Kingston upon Thames","16:00:00","2021-09-15",49,1,0,8,0,58
"Ealing","17:00:00","2021-09-15",19,2,0,2,0,23
"Havering","17:00:00","2021-09-15",897,11,36,109,4,1057
"Hillingdon","17:00:00","2021-09-15",239,3,0,24,2,268
"Hounslow","17:00:00","2021-09-15",1808,131,41,268,22,2270
"Kingston upon Thames","17:00:00","2021-09-15",55,5,0,7,2,69
"Ealing","18:00:00","2021-09-15",7,0,0,0,0,7
"Havering","18:00:00","2021-09-15",937,8,33,78,4,1060
"Hillingdon","18:00:00","2021-09-15",208,1,0,15,1,225
"Hounslow","18:00:00","2021-09-15",1785,153,39,206,31,2214
"Kingston upon Thames","18:00:00","2021-09-15",50,2,0,4,1,57
"Croydon","07:00:00","2021-09-16",484,9,21,164,12,690
"Hackney","07:00:00","2021-09-16",314,38,11,132,28,523
"Havering","07:00:00","2021-09-16",628,9,19,141,17,814
"Kensington and Chelsea","07:00:00","2021-09-16",1852,160,28,670,172,2882
"Sutton","07:00:00","2021-09-16",480,6,6,103,6,601
"Croydon","08:00:00","2021-09-16",652,4,27,124,16,823
"Hackney","08:00:00","2021-09-16",398,25,17,110,22,572
"Havering","08:00:00","2021-09-16",950,4,15,102,28,1099
"Kensington and Chelsea","08:00:00","2021-09-16",2215,174,32,575,173,3169
"Sutton","08:00:00","2021-09-16",469,5,9,44,15,542
"Croydon","09:00:00","2021-09-16",299,7,25,72,16,419
"Hackney","09:00:00","2021-09-16",350,38,12,119,19,538
"Havering","09:00:00","2021-09-16",599,8,24,107,24,762
"Kensington and Chelsea","09:00:00","2021-09-16",2205,119,29,577,174,3104
"Sutton","09:00:00","2021-09-16",327,4,7,57,13,408
"Croydon","10:00:00","2021-09-16",241,3,28,88,23,383
"Hackney","10:00:00","2021-09-16",356,43,12,139,22,572
"Havering","10:00:00","2021-09-16",511,2,19,87,22,641
"Kensington and Chelsea","10:00:00","2021-09-16",2042,102,32,498,170,2844
"Sutton","10:00:00","2021-09-16",221,2,7,53,11,294
"Croydon","11:00:00","2021-09-16",310,6,25,90,25,456
"Hackney","11:00:00","2021-09-16",344,46,11,103,34,538
"Havering","11:00:00","2021-09-16",529,3,16,99,12,659
"Kensington and Chelsea","11:00:00","2021-09-16",1909,86,22,538,165,2720
"Sutton","11:00:00","2021-09-16",239,1,8,64,19,331
"Croydon","12:00:00","2021-09-16",323,3,25,89,18,458
"Hackney","12:00:00","2021-09-16",366,50,13,126,17,572
"Havering","12:00:00","2021-09-16",572,7,18,107,14,718
"Kensington and Chelsea","12:00:00","2021-09-16",2165,154,26,591,125,3061
"Sutton","12:00:00","2021-09-16",271,8,7,48,21,355
"Croydon","13:00:00","2021-09-16",294,6,24,122,17,463
"Hackney","13:00:00","2021-09-16",359,58,12,125,20,574
"Havering","13:00:00","2021-09-16",557,9,18,118,22,724
"Kensington and Chelsea","13:00:00","2021-09-16",2014,113,19,560,130,2836
"Sutton","13:00:00","2021-09-16",205,4,8,45,15,277
"Croydon","14:00:00","2021-09-16",463,7,28,119,17,634
"Hackney","14:00:00","2021-09-16",388,49,15,142,23,617
"Havering","14:00:00","2021-09-16",672,8,21,99,24,824
"Kensington and Chelsea","14:00:00","2021-09-16",1912,131,32,547,122,2744
"Sutton","14:00:00","2021-09-16",342,5,6,65,16,434
"Croydon","15:00:00","2021-09-16",489,10,21,103,25,648
"Hackney","15:00:00","2021-09-16",490,53,14,107,16,680
"Havering","15:00:00","2021-09-16",786,11,14,130,15,956
"Kensington and Chelsea","15:00:00","2021-09-16",2190,147,22,507,101,2967
"Sutton","15:00:00","2021-09-16",373,5,7,65,7,457
"Croydon","16:00:00","2021-09-16",508,5,25,148,23,709
"Hackney","16:00:00","2021-09-16",457,64,15,107,11,654
"Havering","16:00:00","2021-09-16",817,21,17,129,14,998
"Kensington and Chelsea","16:00:00","2021-09-16",2077,155,26,394,51,2703
"Sutton","16:00:00","2021-09-16",414,6,9,83,9,521
"Croydon","17:00:00","2021-09-16",616,8,22,119,12,777
"Hackney","17:00:00","2021-09-16",527,74,15,80,8,704
"Havering","17:00:00","2021-09-16",837,22,19,112,10,1000
"Kensington and Chelsea","17:00:00","2021-09-16",1974,196,21,293,43,2527
"Sutton","17:00:00","2021-09-16",455,8,8,58,5,534
"Croydon","18:00:00","2021-09-16",483,7,24,75,3,592
"Hackney","18:00:00","2021-09-16",533,74,11,51,12,681
"Havering","18:00:00","2021-09-16",722,9,21,75,5,832
"Kensington and Chelsea","18:00:00","2021-09-16",2346,215,33,266,42,2902
"Sutton","18:00:00","2021-09-16",382,6,10,38,2,438
"Hounslow","07:00:00","2021-09-17",140,1,10,25,0,176
"Newham","07:00:00","2021-09-17",796,30,48,173,30,1077
"Southwark","07:00:00","2021-09-17",423,28,22,123,10,606
"Hounslow","08:00:00","2021-09-17",211,5,10,28,0,254
"Lambeth","08:00:00","2021-09-17",1435,184,83,561,157,2420
"Newham","08:00:00","2021-09-17",791,19,54,123,40,1027
"Southwark","08:00:00","2021-09-17",347,15,20,79,9,470
"Hounslow","09:00:00","2021-09-17",189,3,10,17,1,220
"Lambeth","09:00:00","2021-09-17",1274,153,91,571,178,2267
"Newham","09:00:00","2021-09-17",706,23,46,126,51,952
"Southwark","09:00:00","2021-09-17",277,16,21,89,12,415
"Hounslow","10:00:00","2021-09-17",117,0,10,19,4,150
"Lambeth","10:00:00","2021-09-17",1273,129,72,458,208,2140
"Newham","10:00:00","2021-09-17",656,27,55,150,53,941
"Southwark","10:00:00","2021-09-17",394,21,23,106,16,560
"Hounslow","11:00:00","2021-09-17",145,2,9,30,3,189
"Lambeth","11:00:00","2021-09-17",1274,122,76,453,196,2121
"Newham","11:00:00","2021-09-17",772,32,47,116,51,1018
"Southwark","11:00:00","2021-09-17",373,38,19,102,23,555
"Hounslow","12:00:00","2021-09-17",139,8,10,18,0,175
"Lambeth","12:00:00","2021-09-17",1319,142,63,433,167,2124
"Newham","12:00:00","2021-09-17",765,42,52,105,46,1010
"Southwark","12:00:00","2021-09-17",389,40,20,95,11,555
"Hounslow","13:00:00","2021-09-17",167,8,10,14,2,201
"Lambeth","13:00:00","2021-09-17",1289,137,66,445,154,2091
"Newham","13:00:00","2021-09-17",696,39,53,100,37,925
"Southwark","13:00:00","2021-09-17",391,27,22,110,26,576
"Hounslow","14:00:00","2021-09-17",169,5,10,29,2,215
"Lambeth","14:00:00","2021-09-17",1400,134,78,390,144,2146
"Newham","14:00:00","2021-09-17",847,51,50,104,24,1076
"Southwark","14:00:00","2021-09-17",473,24,16,108,6,627
"Hounslow","15:00:00","2021-09-17",199,1,10,24,2,236
"Lambeth","15:00:00","2021-09-17",1404,161,65,344,96,2070
"Newham","15:00:00","2021-09-17",797,53,49,86,19,1004
"Southwark","15:00:00","2021-09-17",402,29,19,98,6,554
"Hounslow","16:00:00","2021-09-17",196,7,10,16,1,230
"Lambeth","16:00:00","2021-09-17",1443,181,78,334,67,2103
"Newham","16:00:00","2021-09-17",808,52,49,79,16,1004
"Southwark","16:00:00","2021-09-17",387,23,21,99,6,536
"Hounslow","17:00:00","2021-09-17",227,10,10,25,2,274
"Lambeth","17:00:00","2021-09-17",1576,194,79,250,62,2161
"Newham","17:00:00","2021-09-17",735,57,52,76,13,933
"Southwark","17:00:00","2021-09-17",444,36,25,77,1,583
"Hounslow","18:00:00","2021-09-17",195,10,10,18,0,233
"Lambeth","18:00:00","2021-09-17",1666,203,84,179,55,2187
"Newham","18:00:00","2021-09-17",854,56,53,71,9,1043
"Southwark","18:00:00","2021-09-17",620,49,18,42,5,734
"Bexley","07:00:00","2021-09-20",294,6,0,50,1,351
"Croydon","07:00:00","2021-09-20",339,4,0,38,3,384
"Westminster","07:00:00","2021-09-20",1884,280,73,852,246,3335
"Bexley","08:00:00","2021-09-20",414,6,0,28,3,451
"Croydon","08:00:00","2021-09-20",412,3,0,38,5,458
"Westminster","08:00:00","2021-09-20",1984,232,60,749,245,3270
"Bexley","09:00:00","2021-09-20",221,10,0,43,1,275
"Croydon","09:00:00","2021-09-20",228,1,0,22,6,257
"Westminster","09:00:00","2021-09-20",2044,166,65,759,241,3275
"Bexley","10:00:00","2021-09-20",181,10,0,44,0,235
"Croydon","10:00:00","2021-09-20",198,2,0,24,6,230
"Waltham Forest","10:00:00","2021-09-20",4973,48,12,1779,723,7535
"Westminster","10:00:00","2021-09-20",2010,151,68,701,307,3237
"Bexley","11:00:00","2021-09-20",190,16,0,33,3,242
"Croydon","11:00:00","2021-09-20",177,3,0,20,9,209
"Waltham Forest","11:00:00","2021-09-20",5088,50,10,1688,655,7491
"Westminster","11:00:00","2021-09-20",2122,144,60,681,266,3273
"Bexley","12:00:00","2021-09-20",210,15,0,40,1,266
"Croydon","12:00:00","2021-09-20",196,2,0,24,7,229
"Waltham Forest","12:00:00","2021-09-20",5198,59,9,1619,614,7499
"Westminster","12:00:00","2021-09-20",2054,171,63,728,252,3268
"Bexley","13:00:00","2021-09-20",203,6,0,36,1,246
"Croydon","13:00:00","2021-09-20",182,3,0,19,3,207
"Westminster","13:00:00","2021-09-20",2095,184,70,774,230,3353
"Bexley","14:00:00","2021-09-20",233,8,0,26,1,268
"Croydon","14:00:00","2021-09-20",204,4,0,32,1,241
"Westminster","14:00:00","2021-09-20",2226,223,59,758,194,3460
"Bexley","15:00:00","2021-09-20",360,7,0,27,1,395
"Croydon","15:00:00","2021-09-20",302,2,0,41,3,348
"Westminster","15:00:00","2021-09-20",2139,234,53,713,195,3334
"Bexley","16:00:00","2021-09-20",301,4,0,46,0,351
"Croydon","16:00:00","2021-09-20",283,4,0,41,2,330
"Westminster","16:00:00","2021-09-20",2225,273,63,663,138,3362
"Bexley","17:00:00","2021-09-20",310,3,0,35,0,348
"Croydon","17:00:00","2021-09-20",322,3,0,20,0,345
"Westminster","17:00:00","2021-09-20",2504,372,70,556,89,3591
"Bexley","18:00:00","2021-09-20",256,8,0,21,0,285
"Croydon","18:00:00","2021-09-20",229,7,0,17,0,253
"Westminster","18:00:00","2021-09-20",2748,314,64,350,64,3540
"Barnet","07:00:00","2021-09-21",3445,155,41,1379,295,5315
"Havering","07:00:00","2021-09-21",203,9,10,120,98,440
"Kensington and Chelsea","07:00:00","2021-09-21",377,61,30,134,27,629
"Kingston upon Thames","07:00:00","2021-09-21",822,14,5,139,23,1003
"Richmond upon Thames","07:00:00","2021-09-21",447,9,42,97,20,615
"Southwark","07:00:00","2021-09-21",11,1,0,3,0,15
"Barnet","08:00:00","2021-09-21",3214,103,31,1130,340,4818
"Havering","08:00:00","2021-09-21",259,5,8,123,110,505
"Kensington and Chelsea","08:00:00","2021-09-21",498,65,24,122,33,742
"Kingston upon Thames","08:00:00","2021-09-21",861,11,3,122,16,1013
"Richmond upon Thames","08:00:00","2021-09-21",563,15,47,72,17,714
"Southwark","08:00:00","2021-09-21",33,7,0,2,0,42
"Barnet","09:00:00","2021-09-21",3253,88,59,1176,388,4964
"Havering","09:00:00","2021-09-21",156,2,10,149,116,433
"Kensington and Chelsea","09:00:00","2021-09-21",424,76,25,162,29,716
"Kingston upon Thames","09:00:00","2021-09-21",757,9,5,129,29,929
"Richmond upon Thames","09:00:00","2021-09-21",390,19,48,77,21,555
"Southwark","09:00:00","2021-09-21",26,1,0,3,3,33
"Barnet","10:00:00","2021-09-21",3295,85,34,1276,457,5147
"Havering","10:00:00","2021-09-21",122,2,10,157,128,419
"Kensington and Chelsea","10:00:00","2021-09-21",398,62,26,160,30,676
"Kingston upon Thames","10:00:00","2021-09-21",559,5,1,110,24,699
"Richmond upon Thames","10:00:00","2021-09-21",331,12,43,63,24,473
"Southwark","10:00:00","2021-09-21",17,1,0,10,0,28
"Barnet","11:00:00","2021-09-21",3478,77,27,1315,478,5375
"Havering","11:00:00","2021-09-21",109,1,14,163,129,416
"Kensington and Chelsea","11:00:00","2021-09-21",363,61,25,158,33,640
"Kingston upon Thames","11:00:00","2021-09-21",549,9,0,111,12,681
"Richmond upon Thames","11:00:00","2021-09-21",298,7,42,72,16,435
"Southwark","11:00:00","2021-09-21",19,3,0,5,3,30
"Barnet","12:00:00","2021-09-21",3505,93,30,1230,446,5304
"Havering","12:00:00","2021-09-21",139,2,12,154,123,430
"Kensington and Chelsea","12:00:00","2021-09-21",407,117,26,159,27,736
"Kingston upon Thames","12:00:00","2021-09-21",514,10,0,138,15,677
"Richmond upon Thames","12:00:00","2021-09-21",296,12,45,81,10,444
"Southwark","12:00:00","2021-09-21",11,5,0,3,0,19
"Barnet","13:00:00","2021-09-21",3632,85,36,1177,396,5326
"Havering","13:00:00","2021-09-21",189,3,11,159,118,480
"Kensington and Chelsea","13:00:00","2021-09-21",405,129,25,171,28,758
"Kingston upon Thames","13:00:00","2021-09-21",537,7,1,112,20,677
"Richmond upon Thames","13:00:00","2021-09-21",338,14,41,68,17,478
"Southwark","13:00:00","2021-09-21",12,2,0,3,0,17
"Barnet","14:00:00","2021-09-21",3685,84,44,1176,324,5313
"Havering","14:00:00","2021-09-21",163,2,11,156,111,443
"Kensington and Chelsea","14:00:00","2021-09-21",446,111,23,139,27,746
"Kingston upon Thames","14:00:00","2021-09-21",610,7,2,114,11,744
"Richmond upon Thames","14:00:00","2021-09-21",347,13,42,50,15,467
"Southwark","14:00:00","2021-09-21",19,4,0,7,0,30
"Barnet","15:00:00","2021-09-21",3797,110,45,1122,327,5401
"Havering","15:00:00","2021-09-21",178,2,8,129,118,435
"Kensington and Chelsea","15:00:00","2021-09-21",590,108,28,166,24,916
"Kingston upon Thames","15:00:00","2021-09-21",678,8,0,111,12,809
"Richmond upon Thames","15:00:00","2021-09-21",424,19,47,69,13,572
"Southwark","15:00:00","2021-09-21",31,1,0,4,0,36
"Barnet","16:00:00","2021-09-21",4072,157,37,1192,223,5681
"Havering","16:00:00","2021-09-21",232,11,10,103,86,442
"Kensington and Chelsea","16:00:00","2021-09-21",619,94,23,162,15,913
"Kingston upon Thames","16:00:00","2021-09-21",761,12,4,127,13,917
"Richmond upon Thames","16:00:00","2021-09-21",453,14,48,74,10,599
"Southwark","16:00:00","2021-09-21",30,6,0,3,0,39
"Barnet","17:00:00","2021-09-21",4394,185,34,1017,138,5768
"Havering","17:00:00","2021-09-21",296,10,9,76,45,436
"Kensington and Chelsea","17:00:00","2021-09-21",696,127,23,135,13,994
"Kingston upon Thames","17:00:00","2021-09-21",887,26,4,101,3,1021
"Richmond upon Thames","17:00:00","2021-09-21",485,15,46,36,10,592
"Southwark","17:00:00","2021-09-21",12,4,0,3,0,19
"Barnet","18:00:00","2021-09-21",4441,142,36,767,112,5498
"Havering","18:00:00","2021-09-21",110,3,10,34,26,183
"Kensington and Chelsea","18:00:00","2021-09-21",767,143,25,87,11,1033
"Kingston upon Thames","18:00:00","2021-09-21",964,17,5,70,6,1062
"Richmond upon Thames","18:00:00","2021-09-21",408,25,41,41,7,522
"Southwark","18:00:00","2021-09-21",18,9,0,1,1,29
"Barking and Dagenham","07:00:00","2021-09-22",44,0,0,4,2,50
"Barnet","07:00:00","2021-09-22",2744,110,45,987,200,4086
"Bexley","07:00:00","2021-09-22",333,4,21,71,22,451
"Hounslow","07:00:00","2021-09-22",1955,50,69,436,148,2658
"Kingston upon Thames","07:00:00","2021-09-22",1545,52,39,344,40,2020
"Barking and Dagenham","08:00:00","2021-09-22",89,0,0,11,0,100
"Barnet","08:00:00","2021-09-22",3008,81,42,547,168,3846
"Bexley","08:00:00","2021-09-22",728,3,18,80,26,855
"Hounslow","08:00:00","2021-09-22",2131,36,72,359,124,2722
"Kingston upon Thames","08:00:00","2021-09-22",1785,60,39,279,43,2206
"Barking and Dagenham","09:00:00","2021-09-22",58,0,0,4,0,62
"Barnet","09:00:00","2021-09-22",2582,70,52,637,232,3573
"Bexley","09:00:00","2021-09-22",378,2,19,72,31,502
"Hounslow","09:00:00","2021-09-22",1738,47,71,342,148,2346
"Kingston upon Thames","09:00:00","2021-09-22",1485,52,35,260,48,1880
"Barking and Dagenham","10:00:00","2021-09-22",41,0,0,5,0,46
"Barnet","10:00:00","2021-09-22",2581,56,39,606,231,3513
"Bexley","10:00:00","2021-09-22",292,8,20,65,50,435
"Hounslow","10:00:00","2021-09-22",1532,32,70,371,155,2160
"Kingston upon Thames","10:00:00","2021-09-22",1306,49,30,258,80,1723
"Barking and Dagenham","11:00:00","2021-09-22",51,1,0,9,1,62
"Barnet","11:00:00","2021-09-22",2598,69,34,604,243,3548
"Bexley","11:00:00","2021-09-22",306,3,24,80,33,446
"Hounslow","11:00:00","2021-09-22",1535,45,61,368,154,2163
"Kingston upon Thames","11:00:00","2021-09-22",1331,69,30,266,61,1757
"Barking and Dagenham","12:00:00","2021-09-22",37,1,0,6,2,46
"Barnet","12:00:00","2021-09-22",2926,99,35,603,208,3871
"Bexley","12:00:00","2021-09-22",344,13,17,71,45,490
"Hounslow","12:00:00","2021-09-22",1703,48,66,338,163,2318
"Kingston upon Thames","12:00:00","2021-09-22",1325,91,29,236,81,1762
"Barking and Dagenham","13:00:00","2021-09-22",52,2,0,8,2,64
"Barnet","13:00:00","2021-09-22",3012,116,41,713,231,4113
"Bexley","13:00:00","2021-09-22",399,5,23,60,46,533
"Hounslow","13:00:00","2021-09-22",1791,71,64,351,128,2405
"Kingston upon Thames","13:00:00","2021-09-22",1339,91,39,257,55,1781
"Barking and Dagenham","14:00:00","2021-09-22",54,0,0,7,0,61
"Barnet","14:00:00","2021-09-22",3095,106,47,715,228,4191
"Bexley","14:00:00","2021-09-22",462,2,21,103,53,641
"Hounslow","14:00:00","2021-09-22",1945,60,68,375,145,2593
"Kingston upon Thames","14:00:00","2021-09-22",1443,79,29,220,63,1834
"Barking and Dagenham","15:00:00","2021-09-22",59,4,0,9,0,72
"Barnet","15:00:00","2021-09-22",3163,101,47,767,201,4279
"Bexley","15:00:00","2021-09-22",600,9,27,79,29,744
"Hounslow","15:00:00","2021-09-22",2046,54,66,381,100,2647
"Kingston upon Thames","15:00:00","2021-09-22",1670,44,40,269,33,2056
"Barking and Dagenham","16:00:00","2021-09-22",50,1,0,5,0,56
"Barnet","16:00:00","2021-09-22",3434,118,44,785,128,4509
"Bexley","16:00:00","2021-09-22",535,11,22,81,31,680
"Hounslow","16:00:00","2021-09-22",2255,67,69,377,127,2895
"Kingston upon Thames","16:00:00","2021-09-22",1796,92,42,289,28,2247
"Barking and Dagenham","17:00:00","2021-09-22",37,0,0,9,0,46
"Barnet","17:00:00","2021-09-22",3806,150,43,710,92,4801
"Bexley","17:00:00","2021-09-22",559,5,21,45,15,645
"Hounslow","17:00:00","2021-09-22",2353,76,67,308,90,2894
"Kingston upon Thames","17:00:00","2021-09-22",1939,116,30,185,14,2284
"Barking and Dagenham","18:00:00","2021-09-22",50,1,0,4,1,56
"Barnet","18:00:00","2021-09-22",4040,148,39,540,86,4853
"Bexley","18:00:00","2021-09-22",457,8,20,32,13,530
"Hounslow","18:00:00","2021-09-22",2227,78,66,235,57,2663
"Kingston upon Thames","18:00:00","2021-09-22",1711,93,38,112,16,1970
"Havering","07:00:00","2021-09-23",94,0,5,24,4,127
"Hillingdon","07:00:00","2021-09-23",33,0,0,3,0,36
"Lewisham","07:00:00","2021-09-23",16,0,0,6,0,22
"Havering","08:00:00","2021-09-23",126,0,6,19,3,154
"Hillingdon","08:00:00","2021-09-23",46,0,0,1,1,48
"Lewisham","08:00:00","2021-09-23",21,0,0,8,2,31
"Havering","09:00:00","2021-09-23",96,1,6,15,2,120
"Hillingdon","09:00:00","2021-09-23",11,0,0,3,2,16
"Lewisham","09:00:00","2021-09-23",16,0,0,9,0,25
"Havering","10:00:00","2021-09-23",72,2,6,26,1,107
"Hillingdon","10:00:00","2021-09-23",24,0,0,4,3,31
"Lewisham","10:00:00","2021-09-23",16,1,0,4,1,22
"Havering","11:00:00","2021-09-23",65,1,6,13,2,87
"Hillingdon","11:00:00","2021-09-23",23,1,0,2,1,27
"Lewisham","11:00:00","2021-09-23",16,0,0,5,3,24
"Havering","12:00:00","2021-09-23",82,2,6,15,1,106
"Hillingdon","12:00:00","2021-09-23",11,0,0,6,0,17
"Lewisham","12:00:00","2021-09-23",11,5,0,11,3,30
"Havering","13:00:00","2021-09-23",69,0,7,8,1,85
"Hillingdon","13:00:00","2021-09-23",15,0,0,2,0,17
"Lewisham","13:00:00","2021-09-23",15,2,0,12,1,30
"Havering","14:00:00","2021-09-23",91,1,6,20,1,119
"Hillingdon","14:00:00","2021-09-23",32,0,0,3,0,35
"Lewisham","14:00:00","2021-09-23",17,1,0,8,0,26
"Havering","15:00:00","2021-09-23",104,2,6,19,0,131
"Hillingdon","15:00:00","2021-09-23",30,0,0,5,0,35
"Lewisham","15:00:00","2021-09-23",26,0,0,5,0,31
"Havering","16:00:00","2021-09-23",119,3,6,30,1,159
"Hillingdon","16:00:00","2021-09-23",31,0,0,0,0,31
"Lewisham","16:00:00","2021-09-23",20,1,0,11,0,32
"Havering","17:00:00","2021-09-23",126,5,7,22,0,160
"Hillingdon","17:00:00","2021-09-23",29,0,0,4,1,34
"Lewisham","17:00:00","2021-09-23",33,3,0,4,2,42
"Havering","18:00:00","2021-09-23",111,1,6,10,1,129
"Hillingdon","18:00:00","2021-09-23",20,2,0,5,1,28
"Lewisham","18:00:00","2021-09-23",27,3,0,1,0,31
"Barnet","07:00:00","2021-09-24",685,22,10,116,25,858
"Haringey","07:00:00","2021-09-24",89,3,0,29,2,123
"Lewisham","07:00:00","2021-09-24",130,4,0,36,1,171
"Redbridge","07:00:00","2021-09-24",1614,33,28,292,53,2020
"Sutton","07:00:00","2021-09-24",225,2,6,39,0,272
"Barnet","08:00:00","2021-09-24",961,21,23,104,54,1163
"Haringey","08:00:00","2021-09-24",89,4,0,26,5,124
"Lewisham","08:00:00","2021-09-24",185,1,0,42,3,231
"Redbridge","08:00:00","2021-09-24",1974,16,29,222,58,2299
"Sutton","08:00:00","2021-09-24",383,5,4,32,5,429
"Barnet","09:00:00","2021-09-24",791,9,4,87,66,957
"Haringey","09:00:00","2021-09-24",49,2,0,20,3,74
"Lewisham","09:00:00","2021-09-24",122,3,0,30,14,169
"Redbridge","09:00:00","2021-09-24",1511,18,31,293,78,1931
"Sutton","09:00:00","2021-09-24",209,1,5,29,2,246
"Barnet","10:00:00","2021-09-24",811,7,3,116,64,1001
"Haringey","10:00:00","2021-09-24",58,2,0,20,5,85
"Lewisham","10:00:00","2021-09-24",108,3,1,27,6,145
"Redbridge","10:00:00","2021-09-24",1503,20,23,283,72,1901
"Sutton","10:00:00","2021-09-24",205,4,4,23,0,236
"Barnet","11:00:00","2021-09-24",915,9,1,147,60,1132
"Haringey","11:00:00","2021-09-24",63,2,0,28,2,95
"Lewisham","11:00:00","2021-09-24",105,3,0,30,5,143
"Redbridge","11:00:00","2021-09-24",1482,38,20,286,67,1893
"Sutton","11:00:00","2021-09-24",210,3,4,28,2,247
"Barnet","12:00:00","2021-09-24",952,22,5,128,68,1175
"Haringey","12:00:00","2021-09-24",61,11,0,16,6,94
"Lewisham","12:00:00","2021-09-24",124,8,0,29,5,166
"Redbridge","12:00:00","2021-09-24",1372,29,20,239,64,1724
"Sutton","12:00:00","2021-09-24",214,2,5,34,3,258
"Barnet","13:00:00","2021-09-24",950,11,0,125,59,1145
"Haringey","13:00:00","2021-09-24",79,10,0,18,0,107
"Lewisham","13:00:00","2021-09-24",127,4,0,28,4,163
"Redbridge","13:00:00","2021-09-24",1401,22,23,214,59,1719
"Sutton","13:00:00","2021-09-24",245,5,4,30,3,287
"Barnet","14:00:00","2021-09-24",903,13,5,107,59,1087
"Haringey","14:00:00","2021-09-24",86,7,0,22,2,117
"Lewisham","14:00:00","2021-09-24",172,8,0,22,4,206
"Redbridge","14:00:00","2021-09-24",1666,31,24,232,58,2011
"Sutton","14:00:00","2021-09-24",288,5,3,31,2,329
"Barnet","15:00:00","2021-09-24",1030,29,15,103,55,1232
"Haringey","15:00:00","2021-09-24",82,4,0,11,4,101
"Lewisham","15:00:00","2021-09-24",207,8,0,36,1,252
"Redbridge","15:00:00","2021-09-24",1875,35,24,211,34,2179
"Sutton","15:00:00","2021-09-24",318,11,4,40,2,375
"Barnet","16:00:00","2021-09-24",1104,20,20,116,21,1281
"Haringey","16:00:00","2021-09-24",69,7,0,15,3,94
"Lewisham","16:00:00","2021-09-24",180,6,0,25,0,211
"Redbridge","16:00:00","2021-09-24",1734,43,24,176,21,1998
"Sutton","16:00:00","2021-09-24",371,6,4,61,0,442
"Barnet","17:00:00","2021-09-24",959,28,8,90,7,1092
"Haringey","17:00:00","2021-09-24",82,6,0,13,0,101
"Lewisham","17:00:00","2021-09-24",184,13,0,29,0,226
"Redbridge","17:00:00","2021-09-24",1819,51,16,215,24,2125
"Sutton","17:00:00","2021-09-24",379,9,4,36,3,431
"Barnet","18:00:00","2021-09-24",860,23,4,64,7,958
"Haringey","18:00:00","2021-09-24",84,8,0,14,0,106
"Lewisham","18:00:00","2021-09-24",164,8,0,28,2,202
"Redbridge","18:00:00","2021-09-24",1634,57,21,164,18,1894
"Sutton","18:00:00","2021-09-24",306,8,4,29,0,347
"Barnet","07:00:00","2021-09-27",302,2,6,44,5,359
"Camden","07:00:00","2021-09-27",44,1,0,16,4,65
"Enfield","07:00:00","2021-09-27",918,9,39,254,21,1241
"Kingston upon Thames","07:00:00","2021-09-27",142,0,0,24,4,170
"Barnet","08:00:00","2021-09-27",440,2,4,39,5,490
"Camden","08:00:00","2021-09-27",80,3,3,23,6,115
"Enfield","08:00:00","2021-09-27",1192,14,28,191,36,1461
"Kingston upon Thames","08:00:00","2021-09-27",385,2,0,41,2,430
"Barnet","09:00:00","2021-09-27",234,5,7,32,11,289
"Camden","09:00:00","2021-09-27",56,2,0,25,5,88
"Enfield","09:00:00","2021-09-27",912,15,45,202,24,1198
"Kingston upon Thames","09:00:00","2021-09-27",146,2,0,28,9,185
"Barnet","10:00:00","2021-09-27",201,7,6,30,3,247
"Camden","10:00:00","2021-09-27",53,7,0,24,3,87
"Enfield","10:00:00","2021-09-27",695,29,42,212,37,1015
"Kingston upon Thames","10:00:00","2021-09-27",119,0,0,28,12,159
"Barnet","11:00:00","2021-09-27",201,9,6,46,6,268
"Camden","11:00:00","2021-09-27",46,8,0,32,11,97
"Enfield","11:00:00","2021-09-27",789,20,35,204,26,1074
"Kingston upon Thames","11:00:00","2021-09-27",119,4,0,34,7,164
"Barnet","12:00:00","2021-09-27",281,13,5,43,5,347
"Camden","12:00:00","2021-09-27",76,6,0,36,3,121
"Enfield","12:00:00","2021-09-27",821,26,49,175,26,1097
"Kingston upon Thames","12:00:00","2021-09-27",152,6,0,22,4,184
"Barnet","13:00:00","2021-09-27",302,17,4,53,6,382
"Camden","13:00:00","2021-09-27",61,11,0,26,3,101
"Enfield","13:00:00","2021-09-27",776,33,48,196,34,1087
"Kingston upon Thames","13:00:00","2021-09-27",113,3,0,26,7,149
"Barnet","14:00:00","2021-09-27",303,11,6,44,6,370
"Camden","14:00:00","2021-09-27",62,12,0,24,7,105
"Enfield","14:00:00","2021-09-27",877,37,44,180,19,1157
"Kingston upon Thames","14:00:00","2021-09-27",178,10,0,22,4,214
"Barnet","15:00:00","2021-09-27",395,15,5,57,3,475
"Camden","15:00:00","2021-09-27",62,12,1,25,3,103
"Enfield","15:00:00","2021-09-27",913,39,37,178,19,1186
"Kingston upon Thames","15:00:00","2021-09-27",272,3,0,20,10,305
"Barnet","16:00:00","2021-09-27",361,10,7,73,5,456
"Camden","16:00:00","2021-09-27",77,15,0,27,4,123
"Enfield","16:00:00","2021-09-27",975,39,43,173,11,1241
"Kingston upon Thames","16:00:00","2021-09-27",229,3,0,31,3,266
"Barnet","17:00:00","2021-09-27",446,23,5,40,2,516
"Camden","17:00:00","2021-09-27",72,13,0,19,0,104
"Enfield","17:00:00","2021-09-27",1039,54,40,189,10,1332
"Kingston upon Thames","17:00:00","2021-09-27",292,8,0,28,8,336
"Barnet","18:00:00","2021-09-27",326,21,6,25,0,378
"Camden","18:00:00","2021-09-27",73,22,0,7,2,104
"Enfield","18:00:00","2021-09-27",1045,39,38,106,8,1236
"Kingston upon Thames","18:00:00","2021-09-27",202,8,0,19,2,231
"Haringey","07:00:00","2021-09-28",336,10,9,83,9,447
"Harrow","07:00:00","2021-09-28",614,8,3,91,10,726
"Hounslow","07:00:00","2021-09-28",15,0,0,2,1,18
"Lewisham","07:00:00","2021-09-28",571,92,38,207,53,961
"Newham","07:00:00","2021-09-28",31,1,15,7,2,56
"Haringey","08:00:00","2021-09-28",379,7,14,75,12,487
"Harrow","08:00:00","2021-09-28",902,6,0,59,7,974
"Hounslow","08:00:00","2021-09-28",9,0,0,2,1,12
"Lewisham","08:00:00","2021-09-28",664,47,44,236,64,1055
"Newham","08:00:00","2021-09-28",102,0,14,15,0,131
"Haringey","09:00:00","2021-09-28",239,9,9,82,11,350
"Harrow","09:00:00","2021-09-28",492,3,5,71,12,583
"Hounslow","09:00:00","2021-09-28",8,3,0,4,0,15
"Lewisham","09:00:00","2021-09-28",548,35,32,196,77,888
"Newham","09:00:00","2021-09-28",39,2,15,16,2,74
"Haringey","10:00:00","2021-09-28",200,10,11,76,13,310
"Harrow","10:00:00","2021-09-28",400,9,1,61,15,486
"Hounslow","10:00:00","2021-09-28",5,0,0,3,0,8
"Lewisham","10:00:00","2021-09-28",508,46,39,161,70,824
"Newham","10:00:00","2021-09-28",33,3,12,17,3,68
"Haringey","11:00:00","2021-09-28",194,13,9,82,10,308
"Harrow","11:00:00","2021-09-28",378,11,0,48,11,448
"Hounslow","11:00:00","2021-09-28",6,2,0,8,1,17
"Lewisham","11:00:00","2021-09-28",512,45,41,156,38,792
"Newham","11:00:00","2021-09-28",35,0,13,18,2,68
"Haringey","12:00:00","2021-09-28",247,17,10,88,10,372
"Harrow","12:00:00","2021-09-28",443,23,1,65,10,542
"Hounslow","12:00:00","2021-09-28",3,1,0,4,1,9
"Lewisham","12:00:00","2021-09-28",622,44,38,174,48,926
"Newham","12:00:00","2021-09-28",41,3,13,15,2,74
"Haringey","13:00:00","2021-09-28",249,23,10,77,12,371
"Harrow","13:00:00","2021-09-28",460,15,0,73,16,564
"Hounslow","13:00:00","2021-09-28",7,0,0,3,0,10
"Lewisham","13:00:00","2021-09-28",555,50,50,172,62,889
"Newham","13:00:00","2021-09-28",36,1,12,21,1,71
"Haringey","14:00:00","2021-09-28",284,9,12,88,14,407
"Harrow","14:00:00","2021-09-28",539,15,2,58,11,625
"Hounslow","14:00:00","2021-09-28",7,0,0,5,0,12
"Lewisham","14:00:00","2021-09-28",648,53,48,198,49,996
"Newham","14:00:00","2021-09-28",46,4,14,12,3,79
"Haringey","15:00:00","2021-09-28",278,13,11,75,3,380
"Harrow","15:00:00","2021-09-28",701,28,2,71,10,812
"Hounslow","15:00:00","2021-09-28",20,0,0,0,0,20
"Lewisham","15:00:00","2021-09-28",740,68,48,241,56,1153
"Newham","15:00:00","2021-09-28",94,3,14,22,0,133
"Haringey","16:00:00","2021-09-28",347,15,11,62,7,442
"Harrow","16:00:00","2021-09-28",675,20,2,79,2,778
"Hounslow","16:00:00","2021-09-28",7,2,0,1,1,11
"Lewisham","16:00:00","2021-09-28",726,98,40,225,32,1121
"Newham","16:00:00","2021-09-28",104,2,14,12,2,134
"Haringey","17:00:00","2021-09-28",370,11,11,42,2,436
"Harrow","17:00:00","2021-09-28",693,16,0,58,1,768
"Hounslow","17:00:00","2021-09-28",12,0,0,1,1,14
"Lewisham","17:00:00","2021-09-28",773,120,36,189,25,1143
"Newham","17:00:00","2021-09-28",61,5,13,7,0,86
"Haringey","18:00:00","2021-09-28",321,30,12,21,8,392
"Harrow","18:00:00","2021-09-28",618,20,2,49,1,690
"Hounslow","18:00:00","2021-09-28",12,1,0,6,1,20
"Lewisham","18:00:00","2021-09-28",770,97,43,101,26,1037
"Newham","18:00:00","2021-09-28",46,3,13,2,1,65
"Hammersmith and Fulham","07:00:00","2021-09-29",3691,223,50,1203,314,5481
"Harrow","07:00:00","2021-09-29",255,1,16,64,5,341
"Lambeth","07:00:00","2021-09-29",96,0,0,30,3,129
"Lewisham","07:00:00","2021-09-29",800,25,20,248,35,1128
"Waltham Forest","07:00:00","2021-09-29",1853,26,24,602,121,2626
"Hammersmith and Fulham","08:00:00","2021-09-29",3914,188,56,1069,300,5527
"Harrow","08:00:00","2021-09-29",333,1,10,38,8,390
"Lambeth","08:00:00","2021-09-29",125,6,1,32,10,174
"Lewisham","08:00:00","2021-09-29",1014,12,20,211,35,1292
"Waltham Forest","08:00:00","2021-09-29",1648,21,19,373,108,2169
"Hammersmith and Fulham","09:00:00","2021-09-29",3610,123,60,979,385,5157
"Harrow","09:00:00","2021-09-29",241,2,23,45,5,316
"Lambeth","09:00:00","2021-09-29",104,10,1,42,7,164
"Lewisham","09:00:00","2021-09-29",869,24,12,191,45,1141
"Waltham Forest","09:00:00","2021-09-29",1539,22,26,460,129,2176
"Hammersmith and Fulham","10:00:00","2021-09-29",3681,108,61,1019,365,5234
"Harrow","10:00:00","2021-09-29",191,3,15,49,11,269
"Lambeth","10:00:00","2021-09-29",110,1,0,40,4,155
"Lewisham","10:00:00","2021-09-29",799,19,17,218,42,1095
"Waltham Forest","10:00:00","2021-09-29",1419,34,24,411,138,2026
"Hammersmith and Fulham","11:00:00","2021-09-29",3850,100,42,1029,390,5411
"Harrow","11:00:00","2021-09-29",189,8,12,33,8,250
"Lambeth","11:00:00","2021-09-29",99,15,0,50,6,170
"Lewisham","11:00:00","2021-09-29",730,23,16,229,43,1041
"Waltham Forest","11:00:00","2021-09-29",1249,25,20,358,111,1763
"Hammersmith and Fulham","12:00:00","2021-09-29",3927,109,57,1056,357,5506
"Harrow","12:00:00","2021-09-29",252,4,17,48,5,326
"Lambeth","12:00:00","2021-09-29",89,13,0,48,6,156
"Lewisham","12:00:00","2021-09-29",774,30,17,201,33,1055
"Waltham Forest","12:00:00","2021-09-29",1289,43,21,327,116,1796
"Hammersmith and Fulham","13:00:00","2021-09-29",3923,118,56,1002,373,5472
"Harrow","13:00:00","2021-09-29",225,4,12,31,4,276
"Lambeth","13:00:00","2021-09-29",103,13,0,33,10,159
"Lewisham","13:00:00","2021-09-29",758,34,20,231,39,1082
"Waltham Forest","13:00:00","2021-09-29",1346,45,22,364,103,1880
"Hammersmith and Fulham","14:00:00","2021-09-29",4077,107,58,986,351,5579
"Harrow","14:00:00","2021-09-29",248,4,24,34,4,314
"Lambeth","14:00:00","2021-09-29",115,14,0,45,5,179
"Lewisham","14:00:00","2021-09-29",904,39,13,279,30,1265
"Waltham Forest","14:00:00","2021-09-29",1532,31,21,399,92,2075
"Hammersmith and Fulham","15:00:00","2021-09-29",3973,156,54,1081,277,5541
"Harrow","15:00:00","2021-09-29",252,6,20,34,1,313
"Lambeth","15:00:00","2021-09-29",112,8,3,37,4,164
"Lewisham","15:00:00","2021-09-29",965,46,24,244,27,1306
"Waltham Forest","15:00:00","2021-09-29",1788,45,26,406,89,2354
"Hammersmith and Fulham","16:00:00","2021-09-29",4528,180,61,982,186,5937
"Harrow","16:00:00","2021-09-29",229,5,7,38,4,283
"Lambeth","16:00:00","2021-09-29",131,19,0,43,5,198
"Lewisham","16:00:00","2021-09-29",1068,40,17,292,17,1434
"Waltham Forest","16:00:00","2021-09-29",2038,29,26,375,62,2530
"Hammersmith and Fulham","17:00:00","2021-09-29",4894,240,69,806,157,6166
"Harrow","17:00:00","2021-09-29",320,9,7,82,3,421
"Lambeth","17:00:00","2021-09-29",136,20,0,33,3,192
"Lewisham","17:00:00","2021-09-29",1113,55,20,232,17,1437
"Waltham Forest","17:00:00","2021-09-29",2237,70,24,389,50,2770
"Hammersmith and Fulham","18:00:00","2021-09-29",5176,274,47,610,134,6241
"Harrow","18:00:00","2021-09-29",385,10,13,71,4,483
"Lambeth","18:00:00","2021-09-29",146,30,0,21,4,201
"Lewisham","18:00:00","2021-09-29",1098,46,16,157,12,1329
"Waltham Forest","18:00:00","2021-09-29",2295,51,20,293,47,2706
"Bromley","07:00:00","2021-09-30",504,7,7,149,5,672
"Croydon","07:00:00","2021-09-30",58,1,0,7,2,68
"Hillingdon","07:00:00","2021-09-30",6264,57,41,1699,706,8767
"Lambeth","07:00:00","2021-09-30",276,119,108,176,45,724
"Bromley","08:00:00","2021-09-30",508,4,8,90,10,620
"Croydon","08:00:00","2021-09-30",149,1,0,10,0,160
"Hillingdon","08:00:00","2021-09-30",5229,40,38,1138,566,7011
"Lambeth","08:00:00","2021-09-30",276,75,119,145,53,668
"Bromley","09:00:00","2021-09-30",401,3,6,85,12,507
"Croydon","09:00:00","2021-09-30",93,1,0,16,1,111
"Hillingdon","09:00:00","2021-09-30",4856,23,55,1214,688,6836
"Lambeth","09:00:00","2021-09-30",352,40,118,156,45,711
"Bromley","10:00:00","2021-09-30",376,2,4,111,13,506
"Croydon","10:00:00","2021-09-30",58,5,0,13,1,77
"Hillingdon","10:00:00","2021-09-30",4596,22,43,1173,704,6538
"Lambeth","10:00:00","2021-09-30",329,50,116,157,62,714
"Bromley","11:00:00","2021-09-30",355,3,2,87,8,455
"Croydon","11:00:00","2021-09-30",98,5,0,13,3,119
"Hillingdon","11:00:00","2021-09-30",4460,20,37,1159,657,6333
"Lambeth","11:00:00","2021-09-30",344,54,100,179,68,745
"Bromley","12:00:00","2021-09-30",439,3,5,90,12,549
"Croydon","12:00:00","2021-09-30",130,4,0,25,5,164
"Hillingdon","12:00:00","2021-09-30",4807,16,35,1258,618,6734
"Lambeth","12:00:00","2021-09-30",381,69,100,154,58,762
"Bromley","13:00:00","2021-09-30",413,9,4,100,15,541
"Croydon","13:00:00","2021-09-30",119,6,0,42,2,169
"Hillingdon","13:00:00","2021-09-30",4888,25,36,1270,649,6868
"Lambeth","13:00:00","2021-09-30",363,62,103,168,52,748
"Bromley","14:00:00","2021-09-30",523,9,7,99,10,648
"Croydon","14:00:00","2021-09-30",102,7,0,19,2,130
"Hillingdon","14:00:00","2021-09-30",5210,23,57,1503,663,7456
"Lambeth","14:00:00","2021-09-30",386,71,105,162,44,768
"Bromley","15:00:00","2021-09-30",601,13,7,117,12,750
"Croydon","15:00:00","2021-09-30",150,7,0,28,3,188
"Hillingdon","15:00:00","2021-09-30",5366,19,43,1532,558,7518
"Lambeth","15:00:00","2021-09-30",356,80,102,152,28,718
"Bromley","16:00:00","2021-09-30",605,17,6,131,6,765
"Croydon","16:00:00","2021-09-30",152,3,0,24,4,183
"Hillingdon","16:00:00","2021-09-30",6331,53,58,1480,414,8336
"Lambeth","16:00:00","2021-09-30",362,96,106,152,16,732
"Bromley","17:00:00","2021-09-30",662,10,6,103,5,786
"Croydon","17:00:00","2021-09-30",131,3,0,22,0,156
"Hillingdon","17:00:00","2021-09-30",6899,65,55,1346,312,8677
"Lambeth","17:00:00","2021-09-30",419,103,110,116,24,772
"Bromley","18:00:00","2021-09-30",537,16,6,55,3,617
"Croydon","18:00:00","2021-09-30",137,6,0,8,2,153
"Hillingdon","18:00:00","2021-09-30",6547,52,37,984,226,7846
"Lambeth","18:00:00","2021-09-30",442,102,121,80,8,753
"Barnet","07:00:00","2021-10-01",1034,17,62,243,32,1388
"Ealing","07:00:00","2021-10-01",468,9,6,135,17,635
"Enfield","07:00:00","2021-10-01",2417,39,25,695,132,3308
"Westminster","07:00:00","2021-10-01",1657,152,36,726,260,2831
"Barnet","08:00:00","2021-10-01",1437,20,54,191,41,1743
"Ealing","08:00:00","2021-10-01",516,7,5,107,24,659
"Enfield","08:00:00","2021-10-01",2858,31,33,517,160,3599
"Westminster","08:00:00","2021-10-01",2022,127,38,706,275,3168
"Barnet","09:00:00","2021-10-01",1153,18,53,168,55,1447
"Ealing","09:00:00","2021-10-01",416,12,1,125,22,576
"Enfield","09:00:00","2021-10-01",2365,34,42,548,154,3143
"Westminster","09:00:00","2021-10-01",1744,108,43,704,300,2899
"Barnet","10:00:00","2021-10-01",916,17,63,165,45,1206
"Ealing","10:00:00","2021-10-01",366,15,2,101,37,521
"Enfield","10:00:00","2021-10-01",2273,41,31,568,196,3109
"Westminster","10:00:00","2021-10-01",2000,125,40,658,292,3115
"Barnet","11:00:00","2021-10-01",1069,25,54,160,46,1354
"Ealing","11:00:00","2021-10-01",382,14,2,123,28,549
"Enfield","11:00:00","2021-10-01",2343,38,28,539,134,3082
"Westminster","11:00:00","2021-10-01",2076,105,37,746,290,3254
"Barnet","12:00:00","2021-10-01",1141,33,49,150,42,1415
"Ealing","12:00:00","2021-10-01",452,22,2,102,28,606
"Enfield","12:00:00","2021-10-01",2505,47,26,532,148,3258
"Westminster","12:00:00","2021-10-01",2196,163,31,776,275,3441
"Barnet","13:00:00","2021-10-01",1099,45,51,175,43,1413
"Ealing","13:00:00","2021-10-01",431,23,0,103,29,586
"Enfield","13:00:00","2021-10-01",2516,70,29,496,174,3285
"Westminster","13:00:00","2021-10-01",2144,188,37,793,281,3443
"Barnet","14:00:00","2021-10-01",1185,42,52,160,37,1476
"Ealing","14:00:00","2021-10-01",502,14,1,98,19,634
"Enfield","14:00:00","2021-10-01",2832,62,40,541,185,3660
"Westminster","14:00:00","2021-10-01",2287,163,38,740,221,3449
"Barnet","15:00:00","2021-10-01",1290,40,52,179,31,1592
"Ealing","15:00:00","2021-10-01",459,17,1,89,19,585
"Enfield","15:00:00","2021-10-01",2912,62,27,496,106,3603
"Westminster","15:00:00","2021-10-01",2373,177,45,656,198,3449
"Barnet","16:00:00","2021-10-01",1347,35,65,188,23,1658
"Ealing","16:00:00","2021-10-01",516,25,2,88,23,654
"Enfield","16:00:00","2021-10-01",2939,77,26,448,108,3598
"Westminster","16:00:00","2021-10-01",2395,189,47,656,126,3413
"Barnet","17:00:00","2021-10-01",1442,43,57,123,17,1682
"Ealing","17:00:00","2021-10-01",570,18,5,79,14,686
"Enfield","17:00:00","2021-10-01",3388,85,28,444,65,4010
"Westminster","17:00:00","2021-10-01",2452,248,47,446,89,3282
"Barnet","18:00:00","2021-10-01",1437,55,56,93,17,1658
"Ealing","18:00:00","2021-10-01",430,22,2,59,8,521
"Enfield","18:00:00","2021-10-01",3080,105,24,369,57,3635
"Westminster","18:00:00","2021-10-01",2713,264,40,369,91,3477
"Bexley","07:00:00","2021-10-04",202,0,0,42,5,249
"Bexley","08:00:00","2021-10-04",329,0,0,40,2,371
"Bexley","09:00:00","2021-10-04",167,0,0,31,5,203
"Bexley","10:00:00","2021-10-04",150,0,0,34,4,188
"Bexley","11:00:00","2021-10-04",160,2,0,25,0,187
"Bexley","12:00:00","2021-10-04",166,2,0,32,2,202
"Bexley","13:00:00","2021-10-04",157,2,0,20,1,180
"Bexley","14:00:00","2021-10-04",205,3,0,35,3,246
"Bexley","15:00:00","2021-10-04",262,1,0,47,0,310
"Bexley","16:00:00","2021-10-04",226,4,0,49,2,281
"Bexley","17:00:00","2021-10-04",249,2,0,44,3,298
"Bexley","18:00:00","2021-10-04",186,0,0,23,1,210
"Ealing","07:00:00","2021-10-05",536,27,52,120,41,776
"Lewisham","07:00:00","2021-10-05",16,0,0,3,1,20
"Newham","07:00:00","2021-10-05",424,4,16,78,4,526
"Ealing","08:00:00","2021-10-05",721,26,55,125,34,961
"Lewisham","08:00:00","2021-10-05",7,1,0,3,1,12
"Newham","08:00:00","2021-10-05",600,2,15,90,14,721
"Ealing","09:00:00","2021-10-05",568,22,58,146,54,848
"Lewisham","09:00:00","2021-10-05",3,0,0,4,0,7
"Newham","09:00:00","2021-10-05",381,5,14,65,8,473
"Ealing","10:00:00","2021-10-05",565,41,48,159,54,867
"Lewisham","10:00:00","2021-10-05",6,0,0,3,0,9
"Newham","10:00:00","2021-10-05",346,6,13,81,15,461
"Ealing","11:00:00","2021-10-05",600,45,49,133,38,865
"Lewisham","11:00:00","2021-10-05",2,1,0,0,1,4
"Newham","11:00:00","2021-10-05",399,14,17,85,22,537
"Ealing","12:00:00","2021-10-05",591,57,47,155,44,894
"Lewisham","12:00:00","2021-10-05",8,0,0,5,0,13
"Newham","12:00:00","2021-10-05",381,9,11,58,13,472
"Ealing","13:00:00","2021-10-05",637,72,46,130,53,938
"Lewisham","13:00:00","2021-10-05",4,1,0,4,0,9
"Newham","13:00:00","2021-10-05",425,15,13,80,15,548
"Ealing","14:00:00","2021-10-05",661,61,54,106,40,922
"Lewisham","14:00:00","2021-10-05",6,0,0,4,1,11
"Newham","14:00:00","2021-10-05",432,10,9,74,12,537
"Ealing","15:00:00","2021-10-05",747,53,48,128,31,1007
"Lewisham","15:00:00","2021-10-05",12,0,0,1,0,13
"Newham","15:00:00","2021-10-05",549,10,13,92,15,679
"Ealing","16:00:00","2021-10-05",723,87,49,104,21,984
"Lewisham","16:00:00","2021-10-05",11,2,0,4,0,17
"Newham","16:00:00","2021-10-05",646,12,14,95,8,775
"Ealing","17:00:00","2021-10-05",755,107,51,81,15,1009
"Lewisham","17:00:00","2021-10-05",10,2,0,2,2,16
"Newham","17:00:00","2021-10-05",687,14,15,97,8,821
"Ealing","18:00:00","2021-10-05",718,104,50,63,15,950
"Lewisham","18:00:00","2021-10-05",10,5,0,2,0,17
"Newham","18:00:00","2021-10-05",580,8,13,68,4,673
"Bromley","07:00:00","2021-10-06",224,1,11,45,6,287
"Southwark","07:00:00","2021-10-06",13,0,0,0,1,14
"Bromley","08:00:00","2021-10-06",377,4,8,78,8,475
"Southwark","08:00:00","2021-10-06",10,0,0,5,0,15
"Bromley","09:00:00","2021-10-06",179,0,11,33,7,230
"Southwark","09:00:00","2021-10-06",15,0,0,3,0,18
"Bromley","10:00:00","2021-10-06",170,0,10,32,10,222
"Southwark","10:00:00","2021-10-06",6,3,0,6,0,15
"Bromley","11:00:00","2021-10-06",181,1,11,29,8,230
"Southwark","11:00:00","2021-10-06",8,1,0,8,3,20
"Bromley","12:00:00","2021-10-06",195,3,11,38,7,254
"Southwark","12:00:00","2021-10-06",9,3,0,5,0,17
"Bromley","13:00:00","2021-10-06",189,6,9,29,3,236
"Southwark","13:00:00","2021-10-06",6,1,0,11,1,19
"Bromley","14:00:00","2021-10-06",162,2,10,28,6,208
"Southwark","14:00:00","2021-10-06",5,4,0,10,2,21
"Bromley","15:00:00","2021-10-06",181,4,11,39,3,238
"Southwark","15:00:00","2021-10-06",15,0,0,5,0,20
"Bromley","16:00:00","2021-10-06",224,2,14,34,3,277
"Southwark","16:00:00","2021-10-06",11,3,0,3,0,17
"Bromley","17:00:00","2021-10-06",280,0,12,27,2,321
"Southwark","17:00:00","2021-10-06",8,1,0,5,0,14
"Bromley","18:00:00","2021-10-06",181,3,11,15,0,210
"Southwark","18:00:00","2021-10-06",16,1,0,3,3,23
"Barnet","07:00:00","2021-10-07",465,12,3,91,8,579
"Bexley","07:00:00","2021-10-07",1117,15,15,246,30,1423
"Ealing","07:00:00","2021-10-07",407,7,5,124,16,559
"Enfield","07:00:00","2021-10-07",496,2,24,107,23,652
"Kingston upon Thames","07:00:00","2021-10-07",169,3,0,46,0,218
"Richmond upon Thames","07:00:00","2021-10-07",204,4,11,26,3,248
"Wandsworth","07:00:00","2021-10-07",134,2,0,9,2,147
"Barnet","08:00:00","2021-10-07",854,3,6,68,10,941
"Bexley","08:00:00","2021-10-07",1266,13,22,217,36,1554
"Ealing","08:00:00","2021-10-07",428,4,0,79,18,529
"Enfield","08:00:00","2021-10-07",925,6,25,116,21,1093
"Kingston upon Thames","08:00:00","2021-10-07",265,6,0,37,3,311
"Richmond upon Thames","08:00:00","2021-10-07",344,7,14,37,7,409
"Wandsworth","08:00:00","2021-10-07",198,1,0,26,3,228
"Barnet","09:00:00","2021-10-07",528,6,3,69,16,622
"Bexley","09:00:00","2021-10-07",947,7,12,225,34,1225
"Ealing","09:00:00","2021-10-07",358,5,0,106,16,485
"Enfield","09:00:00","2021-10-07",533,18,27,132,29,739
"Kingston upon Thames","09:00:00","2021-10-07",120,4,0,23,2,149
"Richmond upon Thames","09:00:00","2021-10-07",154,2,15,30,6,207
"Wandsworth","09:00:00","2021-10-07",94,1,0,31,3,129
"Barnet","10:00:00","2021-10-07",487,6,2,93,12,600
"Bexley","10:00:00","2021-10-07",828,14,14,184,57,1097
"Ealing","10:00:00","2021-10-07",282,5,1,68,22,378
"Enfield","10:00:00","2021-10-07",415,7,25,135,19,601
"Kingston upon Thames","10:00:00","2021-10-07",78,5,0,15,2,100
"Richmond upon Thames","10:00:00","2021-10-07",166,5,13,20,15,219
"Wandsworth","10:00:00","2021-10-07",72,0,0,16,2,90
"Barnet","11:00:00","2021-10-07",499,9,1,83,16,608
"Bexley","11:00:00","2021-10-07",858,16,12,200,30,1116
"Ealing","11:00:00","2021-10-07",295,8,0,85,25,413
"Enfield","11:00:00","2021-10-07",396,12,25,103,30,566
"Kingston upon Thames","11:00:00","2021-10-07",71,7,0,24,2,104
"Richmond upon Thames","11:00:00","2021-10-07",166,7,12,30,10,225
"Wandsworth","11:00:00","2021-10-07",56,3,0,21,1,81
"Barnet","12:00:00","2021-10-07",484,9,1,65,16,575
"Bexley","12:00:00","2021-10-07",924,8,10,162,35,1139
"Ealing","12:00:00","2021-10-07",336,16,1,98,15,466
"Enfield","12:00:00","2021-10-07",465,16,25,103,21,630
"Kingston upon Thames","12:00:00","2021-10-07",84,2,0,20,2,108
"Richmond upon Thames","12:00:00","2021-10-07",181,6,14,38,11,250
"Wandsworth","12:00:00","2021-10-07",56,6,0,16,0,78
"Barnet","13:00:00","2021-10-07",527,11,3,61,15,617
"Bexley","13:00:00","2021-10-07",894,9,11,196,39,1149
"Ealing","13:00:00","2021-10-07",355,9,0,91,15,470
"Enfield","13:00:00","2021-10-07",487,26,22,110,34,679
"Kingston upon Thames","13:00:00","2021-10-07",96,5,0,14,2,117
"Richmond upon Thames","13:00:00","2021-10-07",196,5,13,30,7,251
"Wandsworth","13:00:00","2021-10-07",61,7,0,21,1,90
"Barnet","14:00:00","2021-10-07",554,14,4,85,11,668
"Bexley","14:00:00","2021-10-07",1032,13,14,196,50,1305
"Ealing","14:00:00","2021-10-07",394,11,3,66,14,488
"Enfield","14:00:00","2021-10-07",626,27,25,133,16,827
"Kingston upon Thames","14:00:00","2021-10-07",97,8,0,21,0,126
"Richmond upon Thames","14:00:00","2021-10-07",196,7,12,43,4,262
"Wandsworth","14:00:00","2021-10-07",50,6,0,22,3,81
"Barnet","15:00:00","2021-10-07",796,6,7,67,7,883
"Bexley","15:00:00","2021-10-07",1094,15,17,189,38,1353
"Ealing","15:00:00","2021-10-07",387,12,9,84,15,507
"Enfield","15:00:00","2021-10-07",762,26,28,109,18,943
"Kingston upon Thames","15:00:00","2021-10-07",127,6,0,34,0,167
"Richmond upon Thames","15:00:00","2021-10-07",304,7,17,43,8,379
"Wandsworth","15:00:00","2021-10-07",91,3,0,15,3,112
"Barnet","16:00:00","2021-10-07",800,17,9,83,8,917
"Bexley","16:00:00","2021-10-07",1177,22,14,196,25,1434
"Ealing","16:00:00","2021-10-07",513,13,2,90,15,633
"Enfield","16:00:00","2021-10-07",743,26,27,111,25,932
"Kingston upon Thames","16:00:00","2021-10-07",159,4,0,36,1,200
"Richmond upon Thames","16:00:00","2021-10-07",263,8,10,27,2,310
"Wandsworth","16:00:00","2021-10-07",92,4,0,10,2,108
"Barnet","17:00:00","2021-10-07",860,16,2,88,10,976
"Bexley","17:00:00","2021-10-07",1295,20,10,141,12,1478
"Ealing","17:00:00","2021-10-07",577,20,5,76,5,683
"Enfield","17:00:00","2021-10-07",793,31,22,105,18,969
"Kingston upon Thames","17:00:00","2021-10-07",171,7,0,24,0,202
"Richmond upon Thames","17:00:00","2021-10-07",217,14,12,21,6,270
"Wandsworth","17:00:00","2021-10-07",101,11,0,5,2,119
"Barnet","18:00:00","2021-10-07",794,22,0,42,3,861
"Bexley","18:00:00","2021-10-07",1140,13,13,76,10,1252
"Ealing","18:00:00","2021-10-07",551,11,2,49,4,617
"Enfield","18:00:00","2021-10-07",609,24,28,61,10,732
"Kingston upon Thames","18:00:00","2021-10-07",153,8,0,17,0,178
"Richmond upon Thames","18:00:00","2021-10-07",206,10,12,12,3,243
"Wandsworth","18:00:00","2021-10-07",76,10,0,4,0,90
"Barking and Dagenham","07:00:00","2021-10-08",29,0,0,2,0,31
"Bromley","07:00:00","2021-10-08",3,0,0,0,2,5
"Croydon","07:00:00","2021-10-08",563,9,11,116,6,705
"Ealing","07:00:00","2021-10-08",195,5,0,33,6,239
"Hillingdon","07:00:00","2021-10-08",234,3,2,18,2,259
"Southwark","07:00:00","2021-10-08",469,12,24,144,27,676
"Barking and Dagenham","08:00:00","2021-10-08",48,0,0,6,0,54
"Bromley","08:00:00","2021-10-08",10,0,0,1,2,13
"Croydon","08:00:00","2021-10-08",688,12,9,110,18,837
"Ealing","08:00:00","2021-10-08",433,11,0,64,9,517
"Hillingdon","08:00:00","2021-10-08",470,2,3,43,2,520
"Southwark","08:00:00","2021-10-08",485,14,19,140,17,675
"Barking and Dagenham","09:00:00","2021-10-08",29,0,0,2,0,31
"Bromley","09:00:00","2021-10-08",9,0,0,4,0,13
"Croydon","09:00:00","2021-10-08",516,24,11,110,17,678
"Ealing","09:00:00","2021-10-08",191,4,0,44,10,249
"Hillingdon","09:00:00","2021-10-08",278,3,2,43,8,334
"Southwark","09:00:00","2021-10-08",455,22,21,151,31,680
"Barking and Dagenham","10:00:00","2021-10-08",27,0,0,1,0,28
"Bromley","10:00:00","2021-10-08",9,0,0,3,0,12
"Croydon","10:00:00","2021-10-08",439,18,11,102,20,590
"Ealing","10:00:00","2021-10-08",103,5,0,24,10,142
"Hillingdon","10:00:00","2021-10-08",159,2,2,24,6,193
"Southwark","10:00:00","2021-10-08",431,26,25,141,23,646
"Barking and Dagenham","11:00:00","2021-10-08",24,2,0,5,0,31
"Bromley","11:00:00","2021-10-08",5,0,0,4,0,9
"Croydon","11:00:00","2021-10-08",478,18,9,103,17,625
"Ealing","11:00:00","2021-10-08",116,7,0,23,3,149
"Hillingdon","11:00:00","2021-10-08",151,1,2,27,7,188
"Southwark","11:00:00","2021-10-08",479,43,21,141,30,714
"Barking and Dagenham","12:00:00","2021-10-08",18,0,0,6,2,26
"Bromley","12:00:00","2021-10-08",4,0,0,0,0,4
"Croydon","12:00:00","2021-10-08",476,42,12,111,17,658
"Ealing","12:00:00","2021-10-08",143,19,0,41,4,207
"Hillingdon","12:00:00","2021-10-08",181,3,2,21,3,210
"Southwark","12:00:00","2021-10-08",477,44,24,136,34,715
"Barking and Dagenham","13:00:00","2021-10-08",26,2,0,5,0,33
"Bromley","13:00:00","2021-10-08",10,0,0,0,0,10
"Croydon","13:00:00","2021-10-08",574,36,10,104,15,739
"Ealing","13:00:00","2021-10-08",137,12,0,19,7,175
"Hillingdon","13:00:00","2021-10-08",186,4,2,21,3,216
"Southwark","13:00:00","2021-10-08",487,42,20,132,22,703
"Barking and Dagenham","14:00:00","2021-10-08",32,3,0,3,1,39
"Bromley","14:00:00","2021-10-08",11,0,0,0,0,11
"Croydon","14:00:00","2021-10-08",660,26,12,109,14,821
"Ealing","14:00:00","2021-10-08",217,9,0,44,10,280
"Hillingdon","14:00:00","2021-10-08",223,1,2,26,4,256
"Southwark","14:00:00","2021-10-08",540,32,24,156,20,772
"Barking and Dagenham","15:00:00","2021-10-08",49,0,0,2,0,51
"Bromley","15:00:00","2021-10-08",15,0,0,2,0,17
"Croydon","15:00:00","2021-10-08",715,33,9,92,8,857
"Ealing","15:00:00","2021-10-08",273,17,0,39,4,333
"Hillingdon","15:00:00","2021-10-08",396,1,1,31,2,431
"Southwark","15:00:00","2021-10-08",564,30,22,140,18,774
"Barking and Dagenham","16:00:00","2021-10-08",47,0,0,5,0,52
"Bromley","16:00:00","2021-10-08",4,0,0,0,0,4
"Croydon","16:00:00","2021-10-08",699,31,13,114,3,860
"Ealing","16:00:00","2021-10-08",311,14,0,62,7,394
"Hillingdon","16:00:00","2021-10-08",342,4,3,39,1,389
"Southwark","16:00:00","2021-10-08",592,34,22,104,10,762
"Barking and Dagenham","17:00:00","2021-10-08",44,0,0,1,0,45
"Bromley","17:00:00","2021-10-08",9,2,0,1,0,12
"Croydon","17:00:00","2021-10-08",722,66,10,92,4,894
"Ealing","17:00:00","2021-10-08",399,12,0,69,4,484
"Hillingdon","17:00:00","2021-10-08",310,1,2,32,1,346
"Southwark","17:00:00","2021-10-08",606,58,23,113,5,805
"Barking and Dagenham","18:00:00","2021-10-08",43,0,0,3,0,46
"Bromley","18:00:00","2021-10-08",7,2,0,1,0,10
"Croydon","18:00:00","2021-10-08",749,58,10,79,7,903
"Ealing","18:00:00","2021-10-08",351,18,0,52,6,427
"Hillingdon","18:00:00","2021-10-08",304,4,2,17,3,330
"Southwark","18:00:00","2021-10-08",640,75,22,44,9,790
"Hillingdon","07:00:00","2021-10-11",5770,110,33,1654,523,8090
"Hillingdon","08:00:00","2021-10-11",5632,98,35,1355,610,7730
"Hillingdon","09:00:00","2021-10-11",4700,64,47,1184,721,6716
"Hillingdon","10:00:00","2021-10-11",4003,67,32,1225,741,6068
"Hillingdon","11:00:00","2021-10-11",4248,65,31,1250,793,6387
"Hillingdon","12:00:00","2021-10-11",4341,58,34,1222,727,6382
"Hillingdon","13:00:00","2021-10-11",4463,75,29,1376,759,6702
"Hillingdon","14:00:00","2021-10-11",4964,81,41,1367,693,7146
"Hillingdon","15:00:00","2021-10-11",5532,89,34,1622,598,7875
"Hillingdon","16:00:00","2021-10-11",6369,102,30,1675,480,8656
"Hillingdon","17:00:00","2021-10-11",6614,138,30,1276,316,8374
"Hillingdon","18:00:00","2021-10-11",6171,98,37,804,219,7329
"Barking and Dagenham","07:00:00","2021-10-13",1118,26,81,251,45,1521
"Barnet","07:00:00","2021-10-13",646,37,64,310,47,1104
"Barking and Dagenham","08:00:00","2021-10-13",1241,24,72,180,33,1550
"Barnet","08:00:00","2021-10-13",774,53,49,252,41,1169
"Barking and Dagenham","09:00:00","2021-10-13",1038,20,84,208,69,1419
"Barnet","09:00:00","2021-10-13",689,53,64,223,49,1078
"Barking and Dagenham","10:00:00","2021-10-13",1042,43,66,211,68,1430
"Barnet","10:00:00","2021-10-13",630,46,53,195,45,969
"Barking and Dagenham","11:00:00","2021-10-13",1003,25,60,207,65,1360
"Barnet","11:00:00","2021-10-13",636,60,51,220,46,1013
"Barking and Dagenham","12:00:00","2021-10-13",1078,33,56,191,61,1419
"Barnet","12:00:00","2021-10-13",716,74,50,205,36,1081
"Barking and Dagenham","13:00:00","2021-10-13",1120,29,61,168,72,1450
"Barnet","13:00:00","2021-10-13",723,77,57,206,46,1109
"Barking and Dagenham","14:00:00","2021-10-13",1144,29,79,205,54,1511
"Barnet","14:00:00","2021-10-13",767,72,61,225,41,1166
"Barking and Dagenham","15:00:00","2021-10-13",1119,35,68,148,37,1407
"Barnet","15:00:00","2021-10-13",725,93,55,175,24,1072
"Barking and Dagenham","16:00:00","2021-10-13",1275,34,69,151,20,1549
"Barnet","16:00:00","2021-10-13",746,87,54,179,22,1088
"Barking and Dagenham","17:00:00","2021-10-13",1314,51,64,139,21,1589
"Barnet","17:00:00","2021-10-13",819,118,56,191,8,1192
"Barking and Dagenham","18:00:00","2021-10-13",1237,43,62,122,24,1488
"Barnet","18:00:00","2021-10-13",835,108,53,122,5,1123
"Islington","07:00:00","2021-10-14",881,83,65,350,77,1456
"Islington","08:00:00","2021-10-14",895,87,56,286,80,1404
"Islington","09:00:00","2021-10-14",793,68,61,284,90,1296
"Islington","10:00:00","2021-10-14",753,85,55,342,111,1346
"Islington","11:00:00","2021-10-14",827,84,53,307,114,1385
"Islington","12:00:00","2021-10-14",817,91,55,306,103,1372
"Islington","13:00:00","2021-10-14",850,97,58,308,96,1409
"Islington","14:00:00","2021-10-14",835,97,58,290,68,1348
"Islington","15:00:00","2021-10-14",911,85,59,301,62,1418
"Islington","16:00:00","2021-10-14",924,108,67,252,40,1391
"Islington","17:00:00","2021-10-14",951,137,56,245,33,1422
"Islington","18:00:00","2021-10-14",1061,172,55,152,29,1469
"Brent","07:00:00","2021-10-18",1094,27,42,230,39,1432
"Enfield","07:00:00","2021-10-18",6255,20,12,585,1704,8576
"Brent","08:00:00","2021-10-18",1079,24,29,167,42,1341
"Enfield","08:00:00","2021-10-18",5954,16,16,594,1923,8503
"Brent","09:00:00","2021-10-18",1065,31,40,242,63,1441
"Enfield","09:00:00","2021-10-18",5680,12,26,600,2015,8333
"Brent","10:00:00","2021-10-18",956,42,33,203,68,1302
"Enfield","10:00:00","2021-10-18",5548,24,31,600,1909,8112
"Brent","11:00:00","2021-10-18",965,49,33,252,68,1367
"Enfield","11:00:00","2021-10-18",5739,25,22,603,2003,8392
"Brent","12:00:00","2021-10-18",1007,45,32,230,53,1367
"Enfield","12:00:00","2021-10-18",5682,14,10,584,2071,8361
"Brent","13:00:00","2021-10-18",1134,59,32,220,68,1513
"Enfield","13:00:00","2021-10-18",5324,12,9,593,1988,7926
"Brent","14:00:00","2021-10-18",1162,53,38,182,46,1481
"Enfield","14:00:00","2021-10-18",5020,19,9,581,1747,7376
"Brent","15:00:00","2021-10-18",1065,50,29,167,42,1353
"Enfield","15:00:00","2021-10-18",5786,14,21,575,1876,8272
"Brent","16:00:00","2021-10-18",1253,48,46,220,35,1602
"Enfield","16:00:00","2021-10-18",6694,23,19,620,1571,8927
"Brent","17:00:00","2021-10-18",1398,74,29,191,30,1722
"Enfield","17:00:00","2021-10-18",7145,18,17,600,1303,9083
"Brent","18:00:00","2021-10-18",1344,56,32,115,24,1571
"Enfield","18:00:00","2021-10-18",6406,15,3,541,1108,8073
"Merton","09:00:00","2021-10-19",3866,79,5,1000,297,5247
"Merton","10:00:00","2021-10-19",3406,51,6,877,293,4633
"Merton","11:00:00","2021-10-19",3170,41,2,954,300,4467
"Merton","12:00:00","2021-10-19",3333,58,4,908,288,4591
"Merton","13:00:00","2021-10-19",3367,73,4,891,283,4618
"Merton","14:00:00","2021-10-19",3570,60,8,1003,273,4914
"Wandsworth","07:00:00","2021-10-20",1442,159,47,579,144,2371
"Wandsworth","08:00:00","2021-10-20",1504,157,38,486,118,2303
"Wandsworth","09:00:00","2021-10-20",1313,98,46,490,136,2083
"Wandsworth","10:00:00","2021-10-20",1342,76,50,493,175,2136
"Wandsworth","11:00:00","2021-10-20",1212,84,46,510,149,2001
"Wandsworth","12:00:00","2021-10-20",1252,91,44,477,137,2001
"Wandsworth","13:00:00","2021-10-20",1289,123,49,462,125,2048
"Wandsworth","14:00:00","2021-10-20",1436,109,50,460,153,2208
"Wandsworth","15:00:00","2021-10-20",1643,112,43,515,93,2406
"Wandsworth","16:00:00","2021-10-20",1643,176,48,436,61,2364
"Wandsworth","17:00:00","2021-10-20",1859,201,40,366,54,2520
"Wandsworth","18:00:00","2021-10-20",1931,214,42,223,49,2459
"Enfield","07:00:00","2021-10-22",602,13,24,247,199,1085
"Enfield","08:00:00","2021-10-22",685,12,15,295,196,1203
"Enfield","09:00:00","2021-10-22",567,5,15,277,247,1111
"Enfield","10:00:00","2021-10-22",653,14,16,339,231,1253
"Enfield","11:00:00","2021-10-22",759,9,18,359,275,1420
"Enfield","12:00:00","2021-10-22",813,19,17,356,238,1443
"Enfield","13:00:00","2021-10-22",868,16,15,264,210,1373
"Enfield","14:00:00","2021-10-22",865,17,17,289,183,1371
"Enfield","15:00:00","2021-10-22",895,19,14,348,181,1457
"Enfield","16:00:00","2021-10-22",897,30,14,222,126,1289
"Enfield","17:00:00","2021-10-22",1045,43,13,220,87,1408
"Enfield","18:00:00","2021-10-22",1119,16,15,179,58,1387
"Kingston upon Thames","07:00:00","2021-11-01",2388,58,27,653,96,3222
"Kingston upon Thames","08:00:00","2021-11-01",2020,55,27,452,143,2697
"Kingston upon Thames","09:00:00","2021-11-01",1997,41,39,452,149,2678
"Kingston upon Thames","10:00:00","2021-11-01",1854,40,36,457,156,2543
"Kingston upon Thames","11:00:00","2021-11-01",1937,34,37,427,166,2601
"Kingston upon Thames","12:00:00","2021-11-01",2136,38,34,492,158,2858
"Kingston upon Thames","13:00:00","2021-11-01",2124,36,35,476,149,2820
"Kingston upon Thames","14:00:00","2021-11-01",2210,60,32,486,134,2922
"Kingston upon Thames","15:00:00","2021-11-01",2302,41,28,533,82,2986
"Kingston upon Thames","16:00:00","2021-11-01",2728,54,38,523,77,3420
"Kingston upon Thames","17:00:00","2021-11-01",2890,63,34,325,32,3344
"Kingston upon Thames","18:00:00","2021-11-01",2697,50,43,235,32,3057
"Hammersmith and Fulham","07:00:00","2021-11-02",1376,71,54,328,88,1917
"Hammersmith and Fulham","08:00:00","2021-11-02",1415,85,44,293,79,1916
"Hammersmith and Fulham","09:00:00","2021-11-02",1315,46,39,279,117,1796
"Hammersmith and Fulham","10:00:00","2021-11-02",1180,55,35,270,113,1653
"Hammersmith and Fulham","11:00:00","2021-11-02",1218,39,32,304,111,1704
"Hammersmith and Fulham","12:00:00","2021-11-02",1129,45,39,289,98,1600
"Hammersmith and Fulham","13:00:00","2021-11-02",1150,58,39,295,114,1656
"Hammersmith and Fulham","14:00:00","2021-11-02",1016,53,33,241,70,1413
"Hammersmith and Fulham","15:00:00","2021-11-02",1270,48,51,273,62,1704
"Hammersmith and Fulham","16:00:00","2021-11-02",1224,68,45,248,43,1628
"Hammersmith and Fulham","17:00:00","2021-11-02",1412,83,50,187,32,1764
"Hammersmith and Fulham","18:00:00","2021-11-02",1296,82,62,98,21,1559
"Richmond upon Thames","07:00:00","2021-11-04",227,7,48,33,6,321
"Richmond upon Thames","08:00:00","2021-11-04",390,12,47,42,8,499
"Richmond upon Thames","09:00:00","2021-11-04",184,11,46,54,8,303
"Richmond upon Thames","10:00:00","2021-11-04",171,9,45,53,14,292
"Richmond upon Thames","11:00:00","2021-11-04",146,7,43,52,4,252
"Richmond upon Thames","12:00:00","2021-11-04",198,18,40,44,12,312
"Richmond upon Thames","13:00:00","2021-11-04",190,25,42,47,9,313
"Richmond upon Thames","14:00:00","2021-11-04",160,9,41,45,3,258
"Richmond upon Thames","15:00:00","2021-11-04",271,22,44,38,6,381
"Richmond upon Thames","16:00:00","2021-11-04",336,10,45,27,9,427
"Richmond upon Thames","17:00:00","2021-11-04",218,13,40,17,3,291
"Richmond upon Thames","18:00:00","2021-11-04",210,32,37,10,3,292
